방면명,date,직진,좌회전,우회전,합계,빨간날
교대→연산교차로,2023.5.1 00:00,126,0,138,264,0
부산시청→연산교차로,2023.5.1 00:00,241,160,101,502,0
사직운동장→연산교차로,2023.5.1 00:00,65,202,49,316,0
신리→연산교차로,2023.5.1 00:00,162,98,15,275,0
안락→연산교차로,2023.5.1 00:00,216,0,45,261,0
연산터널→연산교차로,2023.5.1 00:00,98,137,31,266,0
교대→연산교차로,2023.5.1 01:00,104,0,112,216,0
부산시청→연산교차로,2023.5.1 01:00,202,135,81,418,0
사직운동장→연산교차로,2023.5.1 01:00,57,156,55,268,0
신리→연산교차로,2023.5.1 01:00,125,65,18,208,0
안락→연산교차로,2023.5.1 01:00,180,0,34,214,0
연산터널→연산교차로,2023.5.1 01:00,88,131,35,254,0
교대→연산교차로,2023.5.1 02:00,77,0,100,177,0
부산시청→연산교차로,2023.5.1 02:00,190,110,67,367,0
사직운동장→연산교차로,2023.5.1 02:00,41,126,47,214,0
신리→연산교차로,2023.5.1 02:00,107,66,10,183,0
안락→연산교차로,2023.5.1 02:00,148,0,33,181,0
연산터널→연산교차로,2023.5.1 02:00,93,114,25,232,0
교대→연산교차로,2023.5.1 03:00,63,0,90,153,0
부산시청→연산교차로,2023.5.1 03:00,167,87,51,305,0
사직운동장→연산교차로,2023.5.1 03:00,29,112,42,183,0
신리→연산교차로,2023.5.1 03:00,77,55,7,139,0
안락→연산교차로,2023.5.1 03:00,132,0,32,164,0
연산터널→연산교차로,2023.5.1 03:00,83,100,19,202,0
교대→연산교차로,2023.5.1 04:00,57,0,62,119,0
부산시청→연산교차로,2023.5.1 04:00,179,70,47,296,0
사직운동장→연산교차로,2023.5.1 04:00,34,90,33,157,0
신리→연산교차로,2023.5.1 04:00,85,47,8,140,0
안락→연산교차로,2023.5.1 04:00,174,0,27,201,0
연산터널→연산교차로,2023.5.1 04:00,70,85,29,184,0
교대→연산교차로,2023.5.1 05:00,70,0,107,177,0
부산시청→연산교차로,2023.5.1 05:00,187,110,52,349,0
사직운동장→연산교차로,2023.5.1 05:00,50,115,30,195,0
신리→연산교차로,2023.5.1 05:00,136,65,8,209,0
안락→연산교차로,2023.5.1 05:00,236,0,46,282,0
연산터널→연산교차로,2023.5.1 05:00,83,98,29,210,0
교대→연산교차로,2023.5.1 06:00,136,0,187,323,0
부산시청→연산교차로,2023.5.1 06:00,314,201,91,606,0
사직운동장→연산교차로,2023.5.1 06:00,66,221,37,324,0
신리→연산교차로,2023.5.1 06:00,258,104,16,378,0
안락→연산교차로,2023.5.1 06:00,349,0,59,408,0
연산터널→연산교차로,2023.5.1 06:00,165,186,30,381,0
교대→연산교차로,2023.5.1 07:00,198,0,335,533,0
부산시청→연산교차로,2023.5.1 07:00,396,264,191,851,0
사직운동장→연산교차로,2023.5.1 07:00,156,344,50,550,0
신리→연산교차로,2023.5.1 07:00,349,178,35,562,0
안락→연산교차로,2023.5.1 07:00,475,0,82,557,0
연산터널→연산교차로,2023.5.1 07:00,195,244,30,469,0
교대→연산교차로,2023.5.1 08:00,238,0,371,609,0
부산시청→연산교차로,2023.5.1 08:00,451,317,251,1019,0
사직운동장→연산교차로,2023.5.1 08:00,172,464,36,672,0
신리→연산교차로,2023.5.1 08:00,414,237,53,704,0
안락→연산교차로,2023.5.1 08:00,534,0,79,613,0
연산터널→연산교차로,2023.5.1 08:00,256,317,32,605,0
교대→연산교차로,2023.5.1 09:00,253,0,417,670,0
부산시청→연산교차로,2023.5.1 09:00,513,357,246,1116,0
사직운동장→연산교차로,2023.5.1 09:00,191,507,58,756,0
신리→연산교차로,2023.5.1 09:00,452,250,63,765,0
안락→연산교차로,2023.5.1 09:00,527,0,102,629,0
연산터널→연산교차로,2023.5.1 09:00,254,330,50,634,0
교대→연산교차로,2023.5.1 10:00,292,0,435,727,0
부산시청→연산교차로,2023.5.1 10:00,564,385,238,1187,0
사직운동장→연산교차로,2023.5.1 10:00,221,578,68,867,0
신리→연산교차로,2023.5.1 10:00,465,235,45,745,0
안락→연산교차로,2023.5.1 10:00,537,0,130,667,0
연산터널→연산교차로,2023.5.1 10:00,287,344,49,680,0
교대→연산교차로,2023.5.1 11:00,287,0,395,682,0
부산시청→연산교차로,2023.5.1 11:00,626,392,261,1279,0
사직운동장→연산교차로,2023.5.1 11:00,214,580,63,857,0
신리→연산교차로,2023.5.1 11:00,488,261,69,818,0
안락→연산교차로,2023.5.1 11:00,544,0,143,687,0
연산터널→연산교차로,2023.5.1 11:00,272,294,60,626,0
교대→연산교차로,2023.5.1 12:00,293,0,426,719,0
부산시청→연산교차로,2023.5.1 12:00,601,394,236,1231,0
사직운동장→연산교차로,2023.5.1 12:00,209,585,50,844,0
신리→연산교차로,2023.5.1 12:00,482,230,60,772,0
안락→연산교차로,2023.5.1 12:00,530,0,122,652,0
연산터널→연산교차로,2023.5.1 12:00,300,337,42,679,0
교대→연산교차로,2023.5.1 13:00,336,0,453,789,0
부산시청→연산교차로,2023.5.1 13:00,613,479,274,1366,0
사직운동장→연산교차로,2023.5.1 13:00,266,558,32,856,0
신리→연산교차로,2023.5.1 13:00,442,278,58,778,0
안락→연산교차로,2023.5.1 13:00,435,0,123,558,0
연산터널→연산교차로,2023.5.1 13:00,218,296,22,536,0
교대→연산교차로,2023.5.1 14:00,364,0,497,861,0
부산시청→연산교차로,2023.5.1 14:00,609,496,273,1378,0
사직운동장→연산교차로,2023.5.1 14:00,228,575,54,857,0
신리→연산교차로,2023.5.1 14:00,509,218,54,781,0
안락→연산교차로,2023.5.1 14:00,438,0,101,539,0
연산터널→연산교차로,2023.5.1 14:00,222,293,46,561,0
교대→연산교차로,2023.5.1 15:00,358,0,511,869,0
부산시청→연산교차로,2023.5.1 15:00,645,521,265,1431,0
사직운동장→연산교차로,2023.5.1 15:00,259,605,83,947,0
신리→연산교차로,2023.5.1 15:00,515,237,55,807,0
안락→연산교차로,2023.5.1 15:00,442,0,81,523,0
연산터널→연산교차로,2023.5.1 15:00,208,322,33,563,0
교대→연산교차로,2023.5.1 16:00,343,0,467,810,0
부산시청→연산교차로,2023.5.1 16:00,648,545,282,1475,0
사직운동장→연산교차로,2023.5.1 16:00,232,520,92,844,0
신리→연산교차로,2023.5.1 16:00,490,262,55,807,0
안락→연산교차로,2023.5.1 16:00,458,0,76,534,0
연산터널→연산교차로,2023.5.1 16:00,232,293,46,571,0
교대→연산교차로,2023.5.1 17:00,359,0,531,890,0
부산시청→연산교차로,2023.5.1 17:00,623,543,291,1457,0
사직운동장→연산교차로,2023.5.1 17:00,247,549,86,882,0
신리→연산교차로,2023.5.1 17:00,494,240,56,790,0
안락→연산교차로,2023.5.1 17:00,436,0,82,518,0
연산터널→연산교차로,2023.5.1 17:00,213,278,41,532,0
교대→연산교차로,2023.5.1 18:00,343,0,465,808,0
부산시청→연산교차로,2023.5.1 18:00,582,482,279,1343,0
사직운동장→연산교차로,2023.5.1 18:00,234,497,57,788,0
신리→연산교차로,2023.5.1 18:00,409,244,47,700,0
안락→연산교차로,2023.5.1 18:00,439,0,78,517,0
연산터널→연산교차로,2023.5.1 18:00,220,281,45,546,0
교대→연산교차로,2023.5.1 19:00,289,0,301,590,0
부산시청→연산교차로,2023.5.1 19:00,466,358,195,1019,0
사직운동장→연산교차로,2023.5.1 19:00,147,458,60,665,0
신리→연산교차로,2023.5.1 19:00,350,182,26,558,0
안락→연산교차로,2023.5.1 19:00,380,0,101,481,0
연산터널→연산교차로,2023.5.1 19:00,194,279,44,517,0
교대→연산교차로,2023.5.1 20:00,291,0,285,576,0
부산시청→연산교차로,2023.5.1 20:00,466,331,212,1009,0
사직운동장→연산교차로,2023.5.1 20:00,167,392,75,634,0
신리→연산교차로,2023.5.1 20:00,322,179,28,529,0
안락→연산교차로,2023.5.1 20:00,377,0,100,477,0
연산터널→연산교차로,2023.5.1 20:00,197,220,45,462,0
교대→연산교차로,2023.5.1 21:00,261,0,237,498,0
부산시청→연산교차로,2023.5.1 21:00,448,315,192,955,0
사직운동장→연산교차로,2023.5.1 21:00,152,368,53,573,0
신리→연산교차로,2023.5.1 21:00,266,170,35,471,0
안락→연산교차로,2023.5.1 21:00,390,0,90,480,0
연산터널→연산교차로,2023.5.1 21:00,186,201,45,432,0
교대→연산교차로,2023.5.1 22:00,189,0,175,364,0
부산시청→연산교차로,2023.5.1 22:00,346,238,162,746,0
사직운동장→연산교차로,2023.5.1 22:00,122,302,63,487,0
신리→연산교차로,2023.5.1 22:00,223,125,14,362,0
안락→연산교차로,2023.5.1 22:00,316,0,80,396,0
연산터널→연산교차로,2023.5.1 22:00,165,190,48,403,0
교대→연산교차로,2023.5.1 23:00,153,0,123,276,0
부산시청→연산교차로,2023.5.1 23:00,285,153,98,536,0
사직운동장→연산교차로,2023.5.1 23:00,91,238,46,375,0
신리→연산교차로,2023.5.1 23:00,187,90,19,296,0
안락→연산교차로,2023.5.1 23:00,243,0,45,288,0
연산터널→연산교차로,2023.5.1 23:00,129,139,41,309,0
교대→연산교차로,2023.5.2 00:00,115,0,125,240,0
부산시청→연산교차로,2023.5.2 00:00,219,123,103,445,0
사직운동장→연산교차로,2023.5.2 00:00,52,178,51,281,0
신리→연산교차로,2023.5.2 00:00,124,66,11,201,0
안락→연산교차로,2023.5.2 00:00,188,0,58,246,0
연산터널→연산교차로,2023.5.2 00:00,122,167,54,343,0
교대→연산교차로,2023.5.2 01:00,87,0,111,198,0
부산시청→연산교차로,2023.5.2 01:00,175,114,72,361,0
사직운동장→연산교차로,2023.5.2 01:00,50,130,35,215,0
신리→연산교차로,2023.5.2 01:00,98,67,11,176,0
안락→연산교차로,2023.5.2 01:00,156,0,29,185,0
연산터널→연산교차로,2023.5.2 01:00,75,103,24,202,0
교대→연산교차로,2023.5.2 02:00,65,0,80,145,0
부산시청→연산교차로,2023.5.2 02:00,146,75,48,269,0
사직운동장→연산교차로,2023.5.2 02:00,33,114,40,187,0
신리→연산교차로,2023.5.2 02:00,83,48,12,143,0
안락→연산교차로,2023.5.2 02:00,134,0,34,168,0
연산터널→연산교차로,2023.5.2 02:00,91,75,38,204,0
교대→연산교차로,2023.5.2 03:00,48,0,55,103,0
부산시청→연산교차로,2023.5.2 03:00,133,59,47,239,0
사직운동장→연산교차로,2023.5.2 03:00,25,114,38,177,0
신리→연산교차로,2023.5.2 03:00,65,30,16,111,0
안락→연산교차로,2023.5.2 03:00,109,0,20,129,0
연산터널→연산교차로,2023.5.2 03:00,66,88,48,202,0
교대→연산교차로,2023.5.2 04:00,46,0,65,111,0
부산시청→연산교차로,2023.5.2 04:00,151,80,38,269,0
사직운동장→연산교차로,2023.5.2 04:00,29,98,25,152,0
신리→연산교차로,2023.5.2 04:00,90,44,9,143,0
안락→연산교차로,2023.5.2 04:00,163,0,37,200,0
연산터널→연산교차로,2023.5.2 04:00,72,82,19,173,0
교대→연산교차로,2023.5.2 05:00,104,0,118,222,0
부산시청→연산교차로,2023.5.2 05:00,244,179,81,504,0
사직운동장→연산교차로,2023.5.2 05:00,47,172,26,245,0
신리→연산교차로,2023.5.2 05:00,236,79,11,326,0
안락→연산교차로,2023.5.2 05:00,327,0,40,367,0
연산터널→연산교차로,2023.5.2 05:00,148,144,32,324,0
교대→연산교차로,2023.5.2 06:00,196,0,281,477,0
부산시청→연산교차로,2023.5.2 06:00,411,288,132,831,0
사직운동장→연산교차로,2023.5.2 06:00,110,281,39,430,0
신리→연산교차로,2023.5.2 06:00,365,153,24,542,0
안락→연산교차로,2023.5.2 06:00,531,0,80,611,0
연산터널→연산교차로,2023.5.2 06:00,244,256,49,549,0
교대→연산교차로,2023.5.2 07:00,258,0,441,699,0
부산시청→연산교차로,2023.5.2 07:00,556,376,246,1178,0
사직운동장→연산교차로,2023.5.2 07:00,194,470,47,711,0
신리→연산교차로,2023.5.2 07:00,501,268,31,800,0
안락→연산교차로,2023.5.2 07:00,636,0,75,711,0
연산터널→연산교차로,2023.5.2 07:00,285,378,42,705,0
교대→연산교차로,2023.5.2 08:00,321,0,464,785,0
부산시청→연산교차로,2023.5.2 08:00,571,424,326,1321,0
사직운동장→연산교차로,2023.5.2 08:00,213,641,41,895,0
신리→연산교차로,2023.5.2 08:00,540,361,21,922,0
안락→연산교차로,2023.5.2 08:00,565,0,99,664,0
연산터널→연산교차로,2023.5.2 08:00,335,351,32,718,0
교대→연산교차로,2023.5.2 09:00,304,0,509,813,0
부산시청→연산교차로,2023.5.2 09:00,501,381,283,1165,0
사직운동장→연산교차로,2023.5.2 09:00,210,515,56,781,0
신리→연산교차로,2023.5.2 09:00,455,339,47,841,0
안락→연산교차로,2023.5.2 09:00,555,0,96,651,0
연산터널→연산교차로,2023.5.2 09:00,297,354,32,683,0
교대→연산교차로,2023.5.2 10:00,295,0,449,744,0
부산시청→연산교차로,2023.5.2 10:00,541,368,276,1185,0
사직운동장→연산교차로,2023.5.2 10:00,233,521,57,811,0
신리→연산교차로,2023.5.2 10:00,464,294,57,815,0
안락→연산교차로,2023.5.2 10:00,515,0,121,636,0
연산터널→연산교차로,2023.5.2 10:00,277,318,49,644,0
교대→연산교차로,2023.5.2 11:00,294,0,437,731,0
부산시청→연산교차로,2023.5.2 11:00,538,368,259,1165,0
사직운동장→연산교차로,2023.5.2 11:00,241,548,48,837,0
신리→연산교차로,2023.5.2 11:00,415,276,62,753,0
안락→연산교차로,2023.5.2 11:00,488,0,159,647,0
연산터널→연산교차로,2023.5.2 11:00,265,300,57,622,0
교대→연산교차로,2023.5.2 12:00,264,0,355,619,0
부산시청→연산교차로,2023.5.2 12:00,535,364,240,1139,0
사직운동장→연산교차로,2023.5.2 12:00,182,516,56,754,0
신리→연산교차로,2023.5.2 12:00,413,223,49,685,0
안락→연산교차로,2023.5.2 12:00,471,0,127,598,0
연산터널→연산교차로,2023.5.2 12:00,243,286,47,576,0
교대→연산교차로,2023.5.2 13:00,325,0,437,762,0
부산시청→연산교차로,2023.5.2 13:00,524,413,263,1200,0
사직운동장→연산교차로,2023.5.2 13:00,247,570,52,869,0
신리→연산교차로,2023.5.2 13:00,432,268,53,753,0
안락→연산교차로,2023.5.2 13:00,428,0,132,560,0
연산터널→연산교차로,2023.5.2 13:00,226,234,39,499,0
교대→연산교차로,2023.5.2 14:00,349,0,474,823,0
부산시청→연산교차로,2023.5.2 14:00,509,405,252,1166,0
사직운동장→연산교차로,2023.5.2 14:00,244,581,48,873,0
신리→연산교차로,2023.5.2 14:00,467,244,61,772,0
안락→연산교차로,2023.5.2 14:00,441,0,110,551,0
연산터널→연산교차로,2023.5.2 14:00,230,270,43,543,0
교대→연산교차로,2023.5.2 15:00,338,0,471,809,0
부산시청→연산교차로,2023.5.2 15:00,573,473,314,1360,0
사직운동장→연산교차로,2023.5.2 15:00,240,612,74,926,0
신리→연산교차로,2023.5.2 15:00,456,269,57,782,0
안락→연산교차로,2023.5.2 15:00,438,0,104,542,0
연산터널→연산교차로,2023.5.2 15:00,227,278,43,548,0
교대→연산교차로,2023.5.2 16:00,356,0,509,865,0
부산시청→연산교차로,2023.5.2 16:00,611,538,316,1465,0
사직운동장→연산교차로,2023.5.2 16:00,220,634,62,916,0
신리→연산교차로,2023.5.2 16:00,522,268,57,847,0
안락→연산교차로,2023.5.2 16:00,435,0,104,539,0
연산터널→연산교차로,2023.5.2 16:00,236,288,42,566,0
교대→연산교차로,2023.5.2 17:00,347,0,539,886,0
부산시청→연산교차로,2023.5.2 17:00,605,550,338,1493,0
사직운동장→연산교차로,2023.5.2 17:00,253,664,57,974,0
신리→연산교차로,2023.5.2 17:00,520,290,72,882,0
안락→연산교차로,2023.5.2 17:00,452,0,113,565,0
연산터널→연산교차로,2023.5.2 17:00,242,260,40,542,0
교대→연산교차로,2023.5.2 18:00,358,0,537,895,0
부산시청→연산교차로,2023.5.2 18:00,617,574,346,1537,0
사직운동장→연산교차로,2023.5.2 18:00,266,656,71,993,0
신리→연산교차로,2023.5.2 18:00,495,274,48,817,0
안락→연산교차로,2023.5.2 18:00,466,0,83,549,0
연산터널→연산교차로,2023.5.2 18:00,226,284,42,552,0
교대→연산교차로,2023.5.2 19:00,341,0,385,726,0
부산시청→연산교차로,2023.5.2 19:00,526,385,273,1184,0
사직운동장→연산교차로,2023.5.2 19:00,178,579,78,835,0
신리→연산교차로,2023.5.2 19:00,397,214,51,662,0
안락→연산교차로,2023.5.2 19:00,426,0,92,518,0
연산터널→연산교차로,2023.5.2 19:00,198,245,54,497,0
교대→연산교차로,2023.5.2 20:00,313,0,294,607,0
부산시청→연산교차로,2023.5.2 20:00,464,354,257,1075,0
사직운동장→연산교차로,2023.5.2 20:00,174,468,79,721,0
신리→연산교차로,2023.5.2 20:00,323,185,27,535,0
안락→연산교차로,2023.5.2 20:00,400,0,98,498,0
연산터널→연산교차로,2023.5.2 20:00,198,262,71,531,0
교대→연산교차로,2023.5.2 21:00,272,0,283,555,0
부산시청→연산교차로,2023.5.2 21:00,524,343,215,1082,0
사직운동장→연산교차로,2023.5.2 21:00,155,423,91,669,0
신리→연산교차로,2023.5.2 21:00,276,180,31,487,0
안락→연산교차로,2023.5.2 21:00,430,0,97,527,0
연산터널→연산교차로,2023.5.2 21:00,224,252,65,541,0
교대→연산교차로,2023.5.2 22:00,254,0,223,477,0
부산시청→연산교차로,2023.5.2 22:00,421,293,158,872,0
사직운동장→연산교차로,2023.5.2 22:00,139,339,77,555,0
신리→연산교차로,2023.5.2 22:00,239,163,27,429,0
안락→연산교차로,2023.5.2 22:00,355,0,84,439,0
연산터널→연산교차로,2023.5.2 22:00,190,240,55,485,0
교대→연산교차로,2023.5.2 23:00,166,0,208,374,0
부산시청→연산교차로,2023.5.2 23:00,315,182,133,630,0
사직운동장→연산교차로,2023.5.2 23:00,109,258,104,471,0
신리→연산교차로,2023.5.2 23:00,184,106,16,306,0
안락→연산교차로,2023.5.2 23:00,256,0,76,332,0
연산터널→연산교차로,2023.5.2 23:00,133,176,50,359,0
교대→연산교차로,2023.5.3 00:00,133,0,150,283,0
부산시청→연산교차로,2023.5.3 00:00,222,167,112,501,0
사직운동장→연산교차로,2023.5.3 00:00,82,223,62,367,0
신리→연산교차로,2023.5.3 00:00,159,82,16,257,0
안락→연산교차로,2023.5.3 00:00,204,0,59,263,0
연산터널→연산교차로,2023.5.3 00:00,129,167,80,376,0
교대→연산교차로,2023.5.3 01:00,96,0,128,224,0
부산시청→연산교차로,2023.5.3 01:00,199,119,93,411,0
사직운동장→연산교차로,2023.5.3 01:00,60,190,45,295,0
신리→연산교차로,2023.5.3 01:00,104,67,17,188,0
안락→연산교차로,2023.5.3 01:00,150,0,28,178,0
연산터널→연산교차로,2023.5.3 01:00,118,140,48,306,0
교대→연산교차로,2023.5.3 02:00,76,0,86,162,0
부산시청→연산교차로,2023.5.3 02:00,149,93,58,300,0
사직운동장→연산교차로,2023.5.3 02:00,47,131,35,213,0
신리→연산교차로,2023.5.3 02:00,83,42,18,143,0
안락→연산교차로,2023.5.3 02:00,134,0,24,158,0
연산터널→연산교차로,2023.5.3 02:00,99,124,56,279,0
교대→연산교차로,2023.5.3 03:00,47,0,92,139,0
부산시청→연산교차로,2023.5.3 03:00,140,74,48,262,0
사직운동장→연산교차로,2023.5.3 03:00,40,114,36,190,0
신리→연산교차로,2023.5.3 03:00,69,34,11,114,0
안락→연산교차로,2023.5.3 03:00,92,0,28,120,0
연산터널→연산교차로,2023.5.3 03:00,71,73,42,186,0
교대→연산교차로,2023.5.3 04:00,58,0,65,123,0
부산시청→연산교차로,2023.5.3 04:00,141,70,66,277,0
사직운동장→연산교차로,2023.5.3 04:00,29,115,19,163,0
신리→연산교차로,2023.5.3 04:00,77,39,9,125,0
안락→연산교차로,2023.5.3 04:00,176,0,37,213,0
연산터널→연산교차로,2023.5.3 04:00,76,84,31,191,0
교대→연산교차로,2023.5.3 05:00,104,0,133,237,0
부산시청→연산교차로,2023.5.3 05:00,227,162,67,456,0
사직운동장→연산교차로,2023.5.3 05:00,55,163,40,258,0
신리→연산교차로,2023.5.3 05:00,234,89,22,345,0
안락→연산교차로,2023.5.3 05:00,358,0,47,405,0
연산터널→연산교차로,2023.5.3 05:00,141,153,36,330,0
교대→연산교차로,2023.5.3 06:00,185,0,247,432,0
부산시청→연산교차로,2023.5.3 06:00,390,273,116,779,0
사직운동장→연산교차로,2023.5.3 06:00,96,292,31,419,0
신리→연산교차로,2023.5.3 06:00,356,158,27,541,0
안락→연산교차로,2023.5.3 06:00,543,0,82,625,0
연산터널→연산교차로,2023.5.3 06:00,217,247,38,502,0
교대→연산교차로,2023.5.3 07:00,275,0,420,695,0
부산시청→연산교차로,2023.5.3 07:00,549,365,230,1144,0
사직운동장→연산교차로,2023.5.3 07:00,179,448,38,665,0
신리→연산교차로,2023.5.3 07:00,502,272,32,806,0
안락→연산교차로,2023.5.3 07:00,604,0,87,691,0
연산터널→연산교차로,2023.5.3 07:00,267,385,42,694,0
교대→연산교차로,2023.5.3 08:00,309,0,491,800,0
부산시청→연산교차로,2023.5.3 08:00,570,411,336,1317,0
사직운동장→연산교차로,2023.5.3 08:00,216,607,56,879,0
신리→연산교차로,2023.5.3 08:00,527,348,26,901,0
안락→연산교차로,2023.5.3 08:00,608,0,94,702,0
연산터널→연산교차로,2023.5.3 08:00,319,371,38,728,0
교대→연산교차로,2023.5.3 09:00,299,0,498,797,0
부산시청→연산교차로,2023.5.3 09:00,487,382,291,1160,0
사직운동장→연산교차로,2023.5.3 09:00,201,553,68,822,0
신리→연산교차로,2023.5.3 09:00,482,329,42,853,0
안락→연산교차로,2023.5.3 09:00,591,0,103,694,0
연산터널→연산교차로,2023.5.3 09:00,280,376,42,698,0
교대→연산교차로,2023.5.3 10:00,277,0,457,734,0
부산시청→연산교차로,2023.5.3 10:00,561,348,312,1221,0
사직운동장→연산교차로,2023.5.3 10:00,193,552,68,813,0
신리→연산교차로,2023.5.3 10:00,487,268,59,814,0
안락→연산교차로,2023.5.3 10:00,532,0,118,650,0
연산터널→연산교차로,2023.5.3 10:00,291,321,50,662,0
교대→연산교차로,2023.5.3 11:00,288,0,435,723,0
부산시청→연산교차로,2023.5.3 11:00,556,371,268,1195,0
사직운동장→연산교차로,2023.5.3 11:00,210,563,83,856,0
신리→연산교차로,2023.5.3 11:00,479,261,56,796,0
안락→연산교차로,2023.5.3 11:00,566,0,135,701,0
연산터널→연산교차로,2023.5.3 11:00,246,304,44,594,0
교대→연산교차로,2023.5.3 12:00,301,0,388,689,0
부산시청→연산교차로,2023.5.3 12:00,557,365,237,1159,0
사직운동장→연산교차로,2023.5.3 12:00,210,519,57,786,0
신리→연산교차로,2023.5.3 12:00,374,239,49,662,0
안락→연산교차로,2023.5.3 12:00,472,0,134,606,0
연산터널→연산교차로,2023.5.3 12:00,241,290,48,579,0
교대→연산교차로,2023.5.3 13:00,336,0,459,795,0
부산시청→연산교차로,2023.5.3 13:00,531,436,275,1242,0
사직운동장→연산교차로,2023.5.3 13:00,217,556,63,836,0
신리→연산교차로,2023.5.3 13:00,447,280,51,778,0
안락→연산교차로,2023.5.3 13:00,431,0,121,552,0
연산터널→연산교차로,2023.5.3 13:00,210,281,40,531,0
교대→연산교차로,2023.5.3 14:00,346,0,475,821,0
부산시청→연산교차로,2023.5.3 14:00,540,434,267,1241,0
사직운동장→연산교차로,2023.5.3 14:00,275,580,78,933,0
신리→연산교차로,2023.5.3 14:00,454,282,46,782,0
안락→연산교차로,2023.5.3 14:00,446,0,95,541,0
연산터널→연산교차로,2023.5.3 14:00,239,287,35,561,0
교대→연산교차로,2023.5.3 15:00,351,0,458,809,0
부산시청→연산교차로,2023.5.3 15:00,595,458,283,1336,0
사직운동장→연산교차로,2023.5.3 15:00,208,595,89,892,0
신리→연산교차로,2023.5.3 15:00,453,268,58,779,0
안락→연산교차로,2023.5.3 15:00,451,0,111,562,0
연산터널→연산교차로,2023.5.3 15:00,215,279,40,534,0
교대→연산교차로,2023.5.3 16:00,364,0,512,876,0
부산시청→연산교차로,2023.5.3 16:00,592,524,321,1437,0
사직운동장→연산교차로,2023.5.3 16:00,257,647,55,959,0
신리→연산교차로,2023.5.3 16:00,518,288,43,849,0
안락→연산교차로,2023.5.3 16:00,421,0,90,511,0
연산터널→연산교차로,2023.5.3 16:00,252,270,44,566,0
교대→연산교차로,2023.5.3 17:00,376,0,527,903,0
부산시청→연산교차로,2023.5.3 17:00,645,553,309,1507,0
사직운동장→연산교차로,2023.5.3 17:00,238,693,55,986,0
신리→연산교차로,2023.5.3 17:00,507,276,51,834,0
안락→연산교차로,2023.5.3 17:00,479,0,77,556,0
연산터널→연산교차로,2023.5.3 17:00,224,291,47,562,0
교대→연산교차로,2023.5.3 18:00,378,0,541,919,0
부산시청→연산교차로,2023.5.3 18:00,620,560,314,1494,0
사직운동장→연산교차로,2023.5.3 18:00,233,666,55,954,0
신리→연산교차로,2023.5.3 18:00,543,243,51,837,0
안락→연산교차로,2023.5.3 18:00,464,0,103,567,0
연산터널→연산교차로,2023.5.3 18:00,232,283,49,564,0
교대→연산교차로,2023.5.3 19:00,334,0,406,740,0
부산시청→연산교차로,2023.5.3 19:00,513,400,250,1163,0
사직운동장→연산교차로,2023.5.3 19:00,172,513,69,754,0
신리→연산교차로,2023.5.3 19:00,394,219,50,663,0
안락→연산교차로,2023.5.3 19:00,439,0,91,530,0
연산터널→연산교차로,2023.5.3 19:00,223,268,41,532,0
교대→연산교차로,2023.5.3 20:00,312,0,324,636,0
부산시청→연산교차로,2023.5.3 20:00,490,377,247,1114,0
사직운동장→연산교차로,2023.5.3 20:00,188,472,86,746,0
신리→연산교차로,2023.5.3 20:00,331,188,31,550,0
안락→연산교차로,2023.5.3 20:00,431,0,93,524,0
연산터널→연산교차로,2023.5.3 20:00,196,291,55,542,0
교대→연산교차로,2023.5.3 21:00,281,0,297,578,0
부산시청→연산교차로,2023.5.3 21:00,518,333,189,1040,0
사직운동장→연산교차로,2023.5.3 21:00,185,412,105,702,0
신리→연산교차로,2023.5.3 21:00,280,189,35,504,0
안락→연산교차로,2023.5.3 21:00,392,0,100,492,0
연산터널→연산교차로,2023.5.3 21:00,227,257,66,550,0
교대→연산교차로,2023.5.3 22:00,248,0,253,501,0
부산시청→연산교차로,2023.5.3 22:00,422,268,164,854,0
사직운동장→연산교차로,2023.5.3 22:00,149,379,94,622,0
신리→연산교차로,2023.5.3 22:00,279,176,16,471,0
안락→연산교차로,2023.5.3 22:00,383,0,85,468,0
연산터널→연산교차로,2023.5.3 22:00,197,232,72,501,0
교대→연산교차로,2023.5.3 23:00,181,0,165,346,0
부산시청→연산교차로,2023.5.3 23:00,316,182,132,630,0
사직운동장→연산교차로,2023.5.3 23:00,129,301,80,510,0
신리→연산교차로,2023.5.3 23:00,204,122,25,351,0
안락→연산교차로,2023.5.3 23:00,281,0,68,349,0
연산터널→연산교차로,2023.5.3 23:00,151,204,54,409,0
교대→연산교차로,2023.5.4 00:00,143,0,162,305,0
부산시청→연산교차로,2023.5.4 00:00,265,173,107,545,0
사직운동장→연산교차로,2023.5.4 00:00,93,216,78,387,0
신리→연산교차로,2023.5.4 00:00,166,106,22,294,0
안락→연산교차로,2023.5.4 00:00,225,0,52,277,0
연산터널→연산교차로,2023.5.4 00:00,126,164,54,344,0
교대→연산교차로,2023.5.4 01:00,99,0,136,235,0
부산시청→연산교차로,2023.5.4 01:00,210,135,78,423,0
사직운동장→연산교차로,2023.5.4 01:00,62,193,42,297,0
신리→연산교차로,2023.5.4 01:00,128,62,20,210,0
안락→연산교차로,2023.5.4 01:00,184,0,40,224,0
연산터널→연산교차로,2023.5.4 01:00,128,146,63,337,0
교대→연산교차로,2023.5.4 02:00,73,0,93,166,0
부산시청→연산교차로,2023.5.4 02:00,172,88,75,335,0
사직운동장→연산교차로,2023.5.4 02:00,46,145,35,226,0
신리→연산교차로,2023.5.4 02:00,86,55,10,151,0
안락→연산교차로,2023.5.4 02:00,152,0,36,188,0
연산터널→연산교차로,2023.5.4 02:00,98,110,42,250,0
교대→연산교차로,2023.5.4 03:00,56,0,69,125,0
부산시청→연산교차로,2023.5.4 03:00,156,81,48,285,0
사직운동장→연산교차로,2023.5.4 03:00,46,125,32,203,0
신리→연산교차로,2023.5.4 03:00,64,39,8,111,0
안락→연산교차로,2023.5.4 03:00,118,0,32,150,0
연산터널→연산교차로,2023.5.4 03:00,93,97,41,231,0
교대→연산교차로,2023.5.4 04:00,67,0,78,145,0
부산시청→연산교차로,2023.5.4 04:00,157,95,56,308,0
사직운동장→연산교차로,2023.5.4 04:00,35,98,35,168,0
신리→연산교차로,2023.5.4 04:00,90,52,10,152,0
안락→연산교차로,2023.5.4 04:00,173,0,29,202,0
연산터널→연산교차로,2023.5.4 04:00,91,91,36,218,0
교대→연산교차로,2023.5.4 05:00,106,0,136,242,0
부산시청→연산교차로,2023.5.4 05:00,208,152,78,438,0
사직운동장→연산교차로,2023.5.4 05:00,70,157,30,257,0
신리→연산교차로,2023.5.4 05:00,217,92,14,323,0
안락→연산교차로,2023.5.4 05:00,322,0,47,369,0
연산터널→연산교차로,2023.5.4 05:00,129,144,39,312,0
교대→연산교차로,2023.5.4 06:00,184,0,257,441,0
부산시청→연산교차로,2023.5.4 06:00,374,250,119,743,0
사직운동장→연산교차로,2023.5.4 06:00,96,271,36,403,0
신리→연산교차로,2023.5.4 06:00,319,148,24,491,0
안락→연산교차로,2023.5.4 06:00,540,0,85,625,0
연산터널→연산교차로,2023.5.4 06:00,217,240,45,502,0
교대→연산교차로,2023.5.4 07:00,262,0,404,666,0
부산시청→연산교차로,2023.5.4 07:00,582,347,241,1170,0
사직운동장→연산교차로,2023.5.4 07:00,184,440,41,665,0
신리→연산교차로,2023.5.4 07:00,447,259,31,737,0
안락→연산교차로,2023.5.4 07:00,620,0,79,699,0
연산터널→연산교차로,2023.5.4 07:00,283,377,43,703,0
교대→연산교차로,2023.5.4 08:00,314,0,470,784,0
부산시청→연산교차로,2023.5.4 08:00,587,436,335,1358,0
사직운동장→연산교차로,2023.5.4 08:00,211,632,42,885,0
신리→연산교차로,2023.5.4 08:00,521,344,21,886,0
안락→연산교차로,2023.5.4 08:00,598,0,97,695,0
연산터널→연산교차로,2023.5.4 08:00,327,367,37,731,0
교대→연산교차로,2023.5.4 09:00,296,0,501,797,0
부산시청→연산교차로,2023.5.4 09:00,557,388,290,1235,0
사직운동장→연산교차로,2023.5.4 09:00,240,545,59,844,0
신리→연산교차로,2023.5.4 09:00,457,328,54,839,0
안락→연산교차로,2023.5.4 09:00,582,0,100,682,0
연산터널→연산교차로,2023.5.4 09:00,299,365,47,711,0
교대→연산교차로,2023.5.4 10:00,294,0,457,751,0
부산시청→연산교차로,2023.5.4 10:00,531,361,267,1159,0
사직운동장→연산교차로,2023.5.4 10:00,226,547,75,848,0
신리→연산교차로,2023.5.4 10:00,476,249,45,770,0
안락→연산교차로,2023.5.4 10:00,572,0,141,713,0
연산터널→연산교차로,2023.5.4 10:00,258,338,47,643,0
교대→연산교차로,2023.5.4 11:00,297,0,432,729,0
부산시청→연산교차로,2023.5.4 11:00,564,369,273,1206,0
사직운동장→연산교차로,2023.5.4 11:00,244,574,34,852,0
신리→연산교차로,2023.5.4 11:00,432,268,62,762,0
안락→연산교차로,2023.5.4 11:00,568,0,101,669,0
연산터널→연산교차로,2023.5.4 11:00,299,326,52,677,0
교대→연산교차로,2023.5.4 12:00,291,0,373,664,0
부산시청→연산교차로,2023.5.4 12:00,588,371,254,1213,0
사직운동장→연산교차로,2023.5.4 12:00,201,550,63,814,0
신리→연산교차로,2023.5.4 12:00,439,254,53,746,0
안락→연산교차로,2023.5.4 12:00,517,0,135,652,0
연산터널→연산교차로,2023.5.4 12:00,269,294,49,612,0
교대→연산교차로,2023.5.4 13:00,346,0,455,801,0
부산시청→연산교차로,2023.5.4 13:00,587,442,279,1308,0
사직운동장→연산교차로,2023.5.4 13:00,244,591,59,894,0
신리→연산교차로,2023.5.4 13:00,447,272,49,768,0
안락→연산교차로,2023.5.4 13:00,444,0,123,567,0
연산터널→연산교차로,2023.5.4 13:00,217,285,37,539,0
교대→연산교차로,2023.5.4 14:00,343,0,530,873,0
부산시청→연산교차로,2023.5.4 14:00,574,449,334,1357,0
사직운동장→연산교차로,2023.5.4 14:00,259,593,69,921,0
신리→연산교차로,2023.5.4 14:00,469,252,56,777,0
안락→연산교차로,2023.5.4 14:00,413,0,112,525,0
연산터널→연산교차로,2023.5.4 14:00,217,262,38,517,0
교대→연산교차로,2023.5.4 15:00,364,0,503,867,0
부산시청→연산교차로,2023.5.4 15:00,614,472,291,1377,0
사직운동장→연산교차로,2023.5.4 15:00,249,628,84,961,0
신리→연산교차로,2023.5.4 15:00,484,269,52,805,0
안락→연산교차로,2023.5.4 15:00,418,0,99,517,0
연산터널→연산교차로,2023.5.4 15:00,244,271,45,560,0
교대→연산교차로,2023.5.4 16:00,352,0,537,889,0
부산시청→연산교차로,2023.5.4 16:00,618,533,306,1457,0
사직운동장→연산교차로,2023.5.4 16:00,247,672,64,983,0
신리→연산교차로,2023.5.4 16:00,521,304,53,878,0
안락→연산교차로,2023.5.4 16:00,447,0,125,572,0
연산터널→연산교차로,2023.5.4 16:00,253,278,37,568,0
교대→연산교차로,2023.5.4 17:00,354,0,548,902,0
부산시청→연산교차로,2023.5.4 17:00,582,509,308,1399,0
사직운동장→연산교차로,2023.5.4 17:00,284,665,47,996,0
신리→연산교차로,2023.5.4 17:00,531,272,50,853,0
안락→연산교차로,2023.5.4 17:00,435,0,98,533,0
연산터널→연산교차로,2023.5.4 17:00,235,294,33,562,0
교대→연산교차로,2023.5.4 18:00,347,0,519,866,0
부산시청→연산교차로,2023.5.4 18:00,566,507,299,1372,0
사직운동장→연산교차로,2023.5.4 18:00,254,683,36,973,0
신리→연산교차로,2023.5.4 18:00,519,273,61,853,0
안락→연산교차로,2023.5.4 18:00,455,0,94,549,0
연산터널→연산교차로,2023.5.4 18:00,238,285,47,570,0
교대→연산교차로,2023.5.4 19:00,340,0,380,720,0
부산시청→연산교차로,2023.5.4 19:00,580,434,320,1334,0
사직운동장→연산교차로,2023.5.4 19:00,189,542,55,786,0
신리→연산교차로,2023.5.4 19:00,406,237,26,669,0
안락→연산교차로,2023.5.4 19:00,431,0,104,535,0
연산터널→연산교차로,2023.5.4 19:00,217,258,64,539,0
교대→연산교차로,2023.5.4 20:00,335,0,388,723,0
부산시청→연산교차로,2023.5.4 20:00,540,403,240,1183,0
사직운동장→연산교차로,2023.5.4 20:00,189,478,63,730,0
신리→연산교차로,2023.5.4 20:00,350,195,31,576,0
안락→연산교차로,2023.5.4 20:00,436,0,87,523,0
연산터널→연산교차로,2023.5.4 20:00,217,279,47,543,0
교대→연산교차로,2023.5.4 21:00,309,0,298,607,0
부산시청→연산교차로,2023.5.4 21:00,518,375,238,1131,0
사직운동장→연산교차로,2023.5.4 21:00,174,423,45,642,0
신리→연산교차로,2023.5.4 21:00,329,190,22,541,0
안락→연산교차로,2023.5.4 21:00,479,0,121,600,0
연산터널→연산교차로,2023.5.4 21:00,227,264,49,540,0
교대→연산교차로,2023.5.4 22:00,282,0,242,524,0
부산시청→연산교차로,2023.5.4 22:00,460,268,176,904,0
사직운동장→연산교차로,2023.5.4 22:00,156,393,41,590,0
신리→연산교차로,2023.5.4 22:00,260,163,18,441,0
안락→연산교차로,2023.5.4 22:00,442,0,101,543,0
연산터널→연산교차로,2023.5.4 22:00,202,237,45,484,0
교대→연산교차로,2023.5.4 23:00,220,0,126,346,0
부산시청→연산교차로,2023.5.4 23:00,333,217,136,686,0
사직운동장→연산교차로,2023.5.4 23:00,124,269,11,404,0
신리→연산교차로,2023.5.4 23:00,193,107,15,315,0
안락→연산교차로,2023.5.4 23:00,290,0,72,362,0
연산터널→연산교차로,2023.5.4 23:00,172,180,24,376,0
교대→연산교차로,2023.5.5 00:00,171,0,121,292,1
부산시청→연산교차로,2023.5.5 00:00,161,111,95,367,1
사직운동장→연산교차로,2023.5.5 00:00,94,191,3,288,1
신리→연산교차로,2023.5.5 00:00,93,68,5,166,1
안락→연산교차로,2023.5.5 00:00,233,0,56,289,1
연산터널→연산교차로,2023.5.5 00:00,60,118,2,180,1
교대→연산교차로,2023.5.5 01:00,145,0,130,275,1
부산시청→연산교차로,2023.5.5 01:00,221,128,105,454,1
사직운동장→연산교차로,2023.5.5 01:00,61,175,0,236,1
신리→연산교차로,2023.5.5 01:00,103,55,10,168,1
안락→연산교차로,2023.5.5 01:00,169,0,35,204,1
연산터널→연산교차로,2023.5.5 01:00,89,126,7,222,1
교대→연산교차로,2023.5.5 02:00,89,0,102,191,1
부산시청→연산교차로,2023.5.5 02:00,186,90,73,349,1
사직운동장→연산교차로,2023.5.5 02:00,59,137,0,196,1
신리→연산교차로,2023.5.5 02:00,55,44,9,108,1
안락→연산교차로,2023.5.5 02:00,146,0,36,182,1
연산터널→연산교차로,2023.5.5 02:00,110,121,2,233,1
교대→연산교차로,2023.5.5 03:00,72,0,93,165,1
부산시청→연산교차로,2023.5.5 03:00,187,122,59,368,1
사직운동장→연산교차로,2023.5.5 03:00,48,137,0,185,1
신리→연산교차로,2023.5.5 03:00,43,34,2,79,1
안락→연산교차로,2023.5.5 03:00,116,0,13,129,1
연산터널→연산교차로,2023.5.5 03:00,86,119,4,209,1
교대→연산교차로,2023.5.5 04:00,61,0,70,131,1
부산시청→연산교차로,2023.5.5 04:00,144,91,50,285,1
사직운동장→연산교차로,2023.5.5 04:00,47,104,0,151,1
신리→연산교차로,2023.5.5 04:00,80,50,4,134,1
안락→연산교차로,2023.5.5 04:00,141,0,26,167,1
연산터널→연산교차로,2023.5.5 04:00,77,101,3,181,1
교대→연산교차로,2023.5.5 05:00,74,0,99,173,1
부산시청→연산교차로,2023.5.5 05:00,177,117,62,356,1
사직운동장→연산교차로,2023.5.5 05:00,45,121,9,175,1
신리→연산교차로,2023.5.5 05:00,106,66,6,178,1
안락→연산교차로,2023.5.5 05:00,191,0,37,228,1
연산터널→연산교차로,2023.5.5 05:00,89,120,12,221,1
교대→연산교차로,2023.5.5 06:00,123,0,153,276,1
부산시청→연산교차로,2023.5.5 06:00,253,170,74,497,1
사직운동장→연산교차로,2023.5.5 06:00,73,173,31,277,1
신리→연산교차로,2023.5.5 06:00,171,99,15,285,1
안락→연산교차로,2023.5.5 06:00,338,0,55,393,1
연산터널→연산교차로,2023.5.5 06:00,144,145,26,315,1
교대→연산교차로,2023.5.5 07:00,156,0,132,288,1
부산시청→연산교차로,2023.5.5 07:00,324,189,111,624,1
사직운동장→연산교차로,2023.5.5 07:00,87,224,41,352,1
신리→연산교차로,2023.5.5 07:00,200,113,18,331,1
안락→연산교차로,2023.5.5 07:00,342,0,50,392,1
연산터널→연산교차로,2023.5.5 07:00,136,146,30,312,1
교대→연산교차로,2023.5.5 08:00,173,0,173,346,1
부산시청→연산교차로,2023.5.5 08:00,335,216,147,698,1
사직운동장→연산교차로,2023.5.5 08:00,103,349,29,481,1
신리→연산교차로,2023.5.5 08:00,259,164,22,445,1
안락→연산교차로,2023.5.5 08:00,333,0,74,407,1
연산터널→연산교차로,2023.5.5 08:00,194,193,40,427,1
교대→연산교차로,2023.5.5 09:00,215,0,206,421,1
부산시청→연산교차로,2023.5.5 09:00,397,294,155,846,1
사직운동장→연산교차로,2023.5.5 09:00,162,408,43,613,1
신리→연산교차로,2023.5.5 09:00,354,208,25,587,1
안락→연산교차로,2023.5.5 09:00,388,0,95,483,1
연산터널→연산교차로,2023.5.5 09:00,201,229,45,475,1
교대→연산교차로,2023.5.5 10:00,272,0,306,578,1
부산시청→연산교차로,2023.5.5 10:00,482,326,214,1022,1
사직운동장→연산교차로,2023.5.5 10:00,195,519,43,757,1
신리→연산교차로,2023.5.5 10:00,435,230,39,704,1
안락→연산교차로,2023.5.5 10:00,479,0,104,583,1
연산터널→연산교차로,2023.5.5 10:00,212,260,59,531,1
교대→연산교차로,2023.5.5 11:00,291,0,319,610,1
부산시청→연산교차로,2023.5.5 11:00,553,349,226,1128,1
사직운동장→연산교차로,2023.5.5 11:00,193,557,44,794,1
신리→연산교차로,2023.5.5 11:00,413,221,36,670,1
안락→연산교차로,2023.5.5 11:00,543,0,111,654,1
연산터널→연산교차로,2023.5.5 11:00,291,326,48,665,1
교대→연산교차로,2023.5.5 12:00,305,0,322,627,1
부산시청→연산교차로,2023.5.5 12:00,516,366,237,1119,1
사직운동장→연산교차로,2023.5.5 12:00,222,570,46,838,1
신리→연산교차로,2023.5.5 12:00,403,213,45,661,1
안락→연산교차로,2023.5.5 12:00,549,0,140,689,1
연산터널→연산교차로,2023.5.5 12:00,269,324,53,646,1
교대→연산교차로,2023.5.5 13:00,291,0,351,642,1
부산시청→연산교차로,2023.5.5 13:00,531,349,251,1131,1
사직운동장→연산교차로,2023.5.5 13:00,249,551,34,834,1
신리→연산교차로,2023.5.5 13:00,429,199,51,679,1
안락→연산교차로,2023.5.5 13:00,487,0,135,622,1
연산터널→연산교차로,2023.5.5 13:00,243,319,58,620,1
교대→연산교차로,2023.5.5 14:00,296,0,307,603,1
부산시청→연산교차로,2023.5.5 14:00,557,352,253,1162,1
사직운동장→연산교차로,2023.5.5 14:00,249,538,43,830,1
신리→연산교차로,2023.5.5 14:00,387,215,49,651,1
안락→연산교차로,2023.5.5 14:00,517,0,115,632,1
연산터널→연산교차로,2023.5.5 14:00,248,281,48,577,1
교대→연산교차로,2023.5.5 15:00,290,0,381,671,1
부산시청→연산교차로,2023.5.5 15:00,568,361,244,1173,1
사직운동장→연산교차로,2023.5.5 15:00,275,543,33,851,1
신리→연산교차로,2023.5.5 15:00,413,194,40,647,1
안락→연산교차로,2023.5.5 15:00,544,0,131,675,1
연산터널→연산교차로,2023.5.5 15:00,256,278,48,582,1
교대→연산교차로,2023.5.5 16:00,300,0,340,640,1
부산시청→연산교차로,2023.5.5 16:00,589,362,257,1208,1
사직운동장→연산교차로,2023.5.5 16:00,221,556,42,819,1
신리→연산교차로,2023.5.5 16:00,444,209,52,705,1
안락→연산교차로,2023.5.5 16:00,532,0,141,673,1
연산터널→연산교차로,2023.5.5 16:00,251,284,49,584,1
교대→연산교차로,2023.5.5 17:00,288,0,338,626,1
부산시청→연산교차로,2023.5.5 17:00,570,372,206,1148,1
사직운동장→연산교차로,2023.5.5 17:00,212,569,38,819,1
신리→연산교차로,2023.5.5 17:00,423,234,49,706,1
안락→연산교차로,2023.5.5 17:00,505,0,130,635,1
연산터널→연산교차로,2023.5.5 17:00,257,273,66,596,1
교대→연산교차로,2023.5.5 18:00,285,0,321,606,1
부산시청→연산교차로,2023.5.5 18:00,514,340,216,1070,1
사직운동장→연산교차로,2023.5.5 18:00,218,466,38,722,1
신리→연산교차로,2023.5.5 18:00,322,220,28,570,1
안락→연산교차로,2023.5.5 18:00,483,0,111,594,1
연산터널→연산교차로,2023.5.5 18:00,225,285,64,574,1
교대→연산교차로,2023.5.5 19:00,258,0,217,475,1
부산시청→연산교차로,2023.5.5 19:00,461,324,166,951,1
사직운동장→연산교차로,2023.5.5 19:00,153,407,8,568,1
신리→연산교차로,2023.5.5 19:00,298,161,14,473,1
안락→연산교차로,2023.5.5 19:00,380,0,88,468,1
연산터널→연산교차로,2023.5.5 19:00,223,276,32,531,1
교대→연산교차로,2023.5.5 20:00,246,0,221,467,1
부산시청→연산교차로,2023.5.5 20:00,437,310,191,938,1
사직운동장→연산교차로,2023.5.5 20:00,134,422,8,564,1
신리→연산교차로,2023.5.5 20:00,321,164,13,498,1
안락→연산교차로,2023.5.5 20:00,382,0,85,467,1
연산터널→연산교차로,2023.5.5 20:00,195,268,27,490,1
교대→연산교차로,2023.5.5 21:00,245,0,181,426,1
부산시청→연산교차로,2023.5.5 21:00,409,283,144,836,1
사직운동장→연산교차로,2023.5.5 21:00,149,393,7,549,1
신리→연산교차로,2023.5.5 21:00,264,165,11,440,1
안락→연산교차로,2023.5.5 21:00,349,0,95,444,1
연산터널→연산교차로,2023.5.5 21:00,226,236,29,491,1
교대→연산교차로,2023.5.5 22:00,187,0,163,350,1
부산시청→연산교차로,2023.5.5 22:00,348,230,127,705,1
사직운동장→연산교차로,2023.5.5 22:00,120,326,16,462,1
신리→연산교차로,2023.5.5 22:00,220,167,13,400,1
안락→연산교차로,2023.5.5 22:00,301,0,76,377,1
연산터널→연산교차로,2023.5.5 22:00,178,180,48,406,1
교대→연산교차로,2023.5.5 23:00,143,0,123,266,1
부산시청→연산교차로,2023.5.5 23:00,259,166,97,522,1
사직운동장→연산교차로,2023.5.5 23:00,108,231,20,359,1
신리→연산교차로,2023.5.5 23:00,166,101,10,277,1
안락→연산교차로,2023.5.5 23:00,213,0,48,261,1
연산터널→연산교차로,2023.5.5 23:00,122,165,30,317,1
교대→연산교차로,2023.5.6 00:00,129,0,124,253,0
부산시청→연산교차로,2023.5.6 00:00,229,128,96,453,0
사직운동장→연산교차로,2023.5.6 00:00,85,252,6,343,0
신리→연산교차로,2023.5.6 00:00,144,94,9,247,0
안락→연산교차로,2023.5.6 00:00,169,0,53,222,0
연산터널→연산교차로,2023.5.6 00:00,134,165,5,304,0
교대→연산교차로,2023.5.6 01:00,60,0,91,151,0
부산시청→연산교차로,2023.5.6 01:00,147,107,71,325,0
사직운동장→연산교차로,2023.5.6 01:00,72,191,1,264,0
신리→연산교차로,2023.5.6 01:00,57,51,0,108,0
안락→연산교차로,2023.5.6 01:00,80,0,14,94,0
연산터널→연산교차로,2023.5.6 01:00,61,116,0,177,0
교대→연산교차로,2023.5.6 02:00,38,0,62,100,0
부산시청→연산교차로,2023.5.6 02:00,126,84,40,250,0
사직운동장→연산교차로,2023.5.6 02:00,55,111,0,166,0
신리→연산교차로,2023.5.6 02:00,39,35,0,74,0
안락→연산교차로,2023.5.6 02:00,62,0,14,76,0
연산터널→연산교차로,2023.5.6 02:00,53,93,0,146,0
교대→연산교차로,2023.5.6 03:00,66,0,72,138,0
부산시청→연산교차로,2023.5.6 03:00,119,58,51,228,0
사직운동장→연산교차로,2023.5.6 03:00,28,79,2,109,0
신리→연산교차로,2023.5.6 03:00,40,30,0,70,0
안락→연산교차로,2023.5.6 03:00,86,0,14,100,0
연산터널→연산교차로,2023.5.6 03:00,40,81,0,121,0
교대→연산교차로,2023.5.6 04:00,33,0,72,105,0
부산시청→연산교차로,2023.5.6 04:00,113,54,30,197,0
사직운동장→연산교차로,2023.5.6 04:00,33,80,0,113,0
신리→연산교차로,2023.5.6 04:00,18,17,1,36,0
안락→연산교차로,2023.5.6 04:00,68,0,8,76,0
연산터널→연산교차로,2023.5.6 04:00,25,55,0,80,0
교대→연산교차로,2023.5.6 05:00,59,0,103,162,0
부산시청→연산교차로,2023.5.6 05:00,125,94,42,261,0
사직운동장→연산교차로,2023.5.6 05:00,33,97,14,144,0
신리→연산교차로,2023.5.6 05:00,63,27,5,95,0
안락→연산교차로,2023.5.6 05:00,143,0,29,172,0
연산터널→연산교차로,2023.5.6 05:00,58,78,2,138,0
교대→연산교차로,2023.5.6 06:00,125,0,145,270,0
부산시청→연산교차로,2023.5.6 06:00,240,184,71,495,0
사직운동장→연산교차로,2023.5.6 06:00,65,165,27,257,0
신리→연산교차로,2023.5.6 06:00,163,95,9,267,0
안락→연산교차로,2023.5.6 06:00,315,0,55,370,0
연산터널→연산교차로,2023.5.6 06:00,144,113,26,283,0
교대→연산교차로,2023.5.6 07:00,171,0,180,351,0
부산시청→연산교차로,2023.5.6 07:00,329,212,111,652,0
사직운동장→연산교차로,2023.5.6 07:00,96,272,23,391,0
신리→연산교차로,2023.5.6 07:00,230,125,19,374,0
안락→연산교차로,2023.5.6 07:00,316,0,60,376,0
연산터널→연산교차로,2023.5.6 07:00,166,165,40,371,0
교대→연산교차로,2023.5.6 08:00,252,0,288,540,0
부산시청→연산교차로,2023.5.6 08:00,396,283,221,900,0
사직운동장→연산교차로,2023.5.6 08:00,153,420,37,610,0
신리→연산교차로,2023.5.6 08:00,335,195,34,564,0
안락→연산교차로,2023.5.6 08:00,483,0,110,593,0
연산터널→연산교차로,2023.5.6 08:00,220,272,55,547,0
교대→연산교차로,2023.5.6 09:00,281,0,358,639,0
부산시청→연산교차로,2023.5.6 09:00,466,320,204,990,0
사직운동장→연산교차로,2023.5.6 09:00,183,509,45,737,0
신리→연산교차로,2023.5.6 09:00,438,273,69,780,0
안락→연산교차로,2023.5.6 09:00,520,0,130,650,0
연산터널→연산교차로,2023.5.6 09:00,273,277,57,607,0
교대→연산교차로,2023.5.6 10:00,291,0,414,705,0
부산시청→연산교차로,2023.5.6 10:00,552,363,274,1189,0
사직운동장→연산교차로,2023.5.6 10:00,192,564,49,805,0
신리→연산교차로,2023.5.6 10:00,463,288,84,835,0
안락→연산교차로,2023.5.6 10:00,548,0,139,687,0
연산터널→연산교차로,2023.5.6 10:00,279,311,65,655,0
교대→연산교차로,2023.5.6 11:00,308,0,482,790,0
부산시청→연산교차로,2023.5.6 11:00,580,365,289,1234,0
사직운동장→연산교차로,2023.5.6 11:00,199,602,43,844,0
신리→연산교차로,2023.5.6 11:00,493,290,81,864,0
안락→연산교차로,2023.5.6 11:00,563,0,118,681,0
연산터널→연산교차로,2023.5.6 11:00,299,334,55,688,0
교대→연산교차로,2023.5.6 12:00,311,0,471,782,0
부산시청→연산교차로,2023.5.6 12:00,586,385,283,1254,0
사직운동장→연산교차로,2023.5.6 12:00,215,614,26,855,0
신리→연산교차로,2023.5.6 12:00,493,291,67,851,0
안락→연산교차로,2023.5.6 12:00,564,0,164,728,0
연산터널→연산교차로,2023.5.6 12:00,309,334,50,693,0
교대→연산교차로,2023.5.6 13:00,333,0,457,790,0
부산시청→연산교차로,2023.5.6 13:00,569,475,316,1360,0
사직운동장→연산교차로,2023.5.6 13:00,241,626,45,912,0
신리→연산교차로,2023.5.6 13:00,465,297,75,837,0
안락→연산교차로,2023.5.6 13:00,448,0,117,565,0
연산터널→연산교차로,2023.5.6 13:00,262,253,41,556,0
교대→연산교차로,2023.5.6 14:00,349,0,438,787,0
부산시청→연산교차로,2023.5.6 14:00,553,454,361,1368,0
사직운동장→연산교차로,2023.5.6 14:00,249,616,55,920,0
신리→연산교차로,2023.5.6 14:00,442,285,61,788,0
안락→연산교차로,2023.5.6 14:00,437,0,115,552,0
연산터널→연산교차로,2023.5.6 14:00,236,269,51,556,0
교대→연산교차로,2023.5.6 15:00,340,0,456,796,0
부산시청→연산교차로,2023.5.6 15:00,581,493,297,1371,0
사직운동장→연산교차로,2023.5.6 15:00,259,634,45,938,0
신리→연산교차로,2023.5.6 15:00,428,314,43,785,0
안락→연산교차로,2023.5.6 15:00,456,0,82,538,0
연산터널→연산교차로,2023.5.6 15:00,237,272,50,559,0
교대→연산교차로,2023.5.6 16:00,370,0,450,820,0
부산시청→연산교차로,2023.5.6 16:00,595,520,321,1436,0
사직운동장→연산교차로,2023.5.6 16:00,259,639,38,936,0
신리→연산교차로,2023.5.6 16:00,449,273,48,770,0
안락→연산교차로,2023.5.6 16:00,464,0,77,541,0
연산터널→연산교차로,2023.5.6 16:00,221,311,38,570,0
교대→연산교차로,2023.5.6 17:00,350,0,366,716,0
부산시청→연산교차로,2023.5.6 17:00,626,509,295,1430,0
사직운동장→연산교차로,2023.5.6 17:00,254,641,53,948,0
신리→연산교차로,2023.5.6 17:00,486,254,23,763,0
안락→연산교차로,2023.5.6 17:00,477,0,89,566,0
연산터널→연산교차로,2023.5.6 17:00,230,282,45,557,0
교대→연산교차로,2023.5.6 18:00,347,0,391,738,0
부산시청→연산교차로,2023.5.6 18:00,543,433,265,1241,0
사직운동장→연산교차로,2023.5.6 18:00,217,578,51,846,0
신리→연산교차로,2023.5.6 18:00,435,242,48,725,0
안락→연산교차로,2023.5.6 18:00,466,0,88,554,0
연산터널→연산교차로,2023.5.6 18:00,204,294,60,558,0
교대→연산교차로,2023.5.6 19:00,305,0,290,595,0
부산시청→연산교차로,2023.5.6 19:00,500,346,219,1065,0
사직운동장→연산교차로,2023.5.6 19:00,206,478,70,754,0
신리→연산교차로,2023.5.6 19:00,373,219,31,623,0
안락→연산교차로,2023.5.6 19:00,436,0,121,557,0
연산터널→연산교차로,2023.5.6 19:00,226,263,63,552,0
교대→연산교차로,2023.5.6 20:00,284,0,256,540,0
부산시청→연산교차로,2023.5.6 20:00,537,343,220,1100,0
사직운동장→연산교차로,2023.5.6 20:00,197,489,51,737,0
신리→연산교차로,2023.5.6 20:00,399,208,29,636,0
안락→연산교차로,2023.5.6 20:00,441,0,95,536,0
연산터널→연산교차로,2023.5.6 20:00,219,255,67,541,0
교대→연산교차로,2023.5.6 21:00,289,0,262,551,0
부산시청→연산교차로,2023.5.6 21:00,486,363,201,1050,0
사직운동장→연산교차로,2023.5.6 21:00,174,421,63,658,0
신리→연산교차로,2023.5.6 21:00,373,215,23,611,0
안락→연산교차로,2023.5.6 21:00,461,0,118,579,0
연산터널→연산교차로,2023.5.6 21:00,232,261,54,547,0
교대→연산교차로,2023.5.6 22:00,247,0,222,469,0
부산시청→연산교차로,2023.5.6 22:00,427,277,157,861,0
사직운동장→연산교차로,2023.5.6 22:00,144,352,72,568,0
신리→연산교차로,2023.5.6 22:00,281,136,28,445,0
안락→연산교차로,2023.5.6 22:00,410,0,106,516,0
연산터널→연산교차로,2023.5.6 22:00,207,206,62,475,0
교대→연산교차로,2023.5.6 23:00,159,0,147,306,0
부산시청→연산교차로,2023.5.6 23:00,372,213,127,712,0
사직운동장→연산교차로,2023.5.6 23:00,106,269,50,425,0
신리→연산교차로,2023.5.6 23:00,224,128,29,381,0
안락→연산교차로,2023.5.6 23:00,295,0,60,355,0
연산터널→연산교차로,2023.5.6 23:00,155,194,45,394,0
교대→연산교차로,2023.5.7 00:00,157,0,151,308,1
부산시청→연산교차로,2023.5.7 00:00,296,174,108,578,1
사직운동장→연산교차로,2023.5.7 00:00,78,245,43,366,1
신리→연산교차로,2023.5.7 00:00,191,107,19,317,1
안락→연산교차로,2023.5.7 00:00,252,0,57,309,1
연산터널→연산교차로,2023.5.7 00:00,140,177,38,355,1
교대→연산교차로,2023.5.7 01:00,132,0,104,236,1
부산시청→연산교차로,2023.5.7 01:00,265,150,102,517,1
사직운동장→연산교차로,2023.5.7 01:00,67,172,33,272,1
신리→연산교차로,2023.5.7 01:00,162,72,13,247,1
안락→연산교차로,2023.5.7 01:00,175,0,47,222,1
연산터널→연산교차로,2023.5.7 01:00,98,164,46,308,1
교대→연산교차로,2023.5.7 02:00,89,0,127,216,1
부산시청→연산교차로,2023.5.7 02:00,207,119,93,419,1
사직운동장→연산교차로,2023.5.7 02:00,49,137,23,209,1
신리→연산교차로,2023.5.7 02:00,136,63,11,210,1
안락→연산교차로,2023.5.7 02:00,178,0,30,208,1
연산터널→연산교차로,2023.5.7 02:00,101,132,32,265,1
교대→연산교차로,2023.5.7 03:00,77,0,110,187,1
부산시청→연산교차로,2023.5.7 03:00,189,83,76,348,1
사직운동장→연산교차로,2023.5.7 03:00,53,137,39,229,1
신리→연산교차로,2023.5.7 03:00,92,51,12,155,1
안락→연산교차로,2023.5.7 03:00,150,0,28,178,1
연산터널→연산교차로,2023.5.7 03:00,90,129,19,238,1
교대→연산교차로,2023.5.7 04:00,67,0,80,147,1
부산시청→연산교차로,2023.5.7 04:00,162,90,41,293,1
사직운동장→연산교차로,2023.5.7 04:00,37,103,16,156,1
신리→연산교차로,2023.5.7 04:00,83,59,7,149,1
안락→연산교차로,2023.5.7 04:00,113,0,35,148,1
연산터널→연산교차로,2023.5.7 04:00,77,86,14,177,1
교대→연산교차로,2023.5.7 05:00,56,0,96,152,1
부산시청→연산교차로,2023.5.7 05:00,171,99,59,329,1
사직운동장→연산교차로,2023.5.7 05:00,48,103,28,179,1
신리→연산교차로,2023.5.7 05:00,123,60,7,190,1
안락→연산교차로,2023.5.7 05:00,166,0,29,195,1
연산터널→연산교차로,2023.5.7 05:00,87,91,19,197,1
교대→연산교차로,2023.5.7 06:00,104,0,108,212,1
부산시청→연산교차로,2023.5.7 06:00,216,146,59,421,1
사직운동장→연산교차로,2023.5.7 06:00,52,148,36,236,1
신리→연산교차로,2023.5.7 06:00,154,66,14,234,1
안락→연산교차로,2023.5.7 06:00,222,0,44,266,1
연산터널→연산교차로,2023.5.7 06:00,125,118,30,273,1
교대→연산교차로,2023.5.7 07:00,130,0,138,268,1
부산시청→연산교차로,2023.5.7 07:00,257,177,109,543,1
사직운동장→연산교차로,2023.5.7 07:00,76,184,41,301,1
신리→연산교차로,2023.5.7 07:00,215,82,23,320,1
안락→연산교차로,2023.5.7 07:00,244,0,55,299,1
연산터널→연산교차로,2023.5.7 07:00,118,121,38,277,1
교대→연산교차로,2023.5.7 08:00,168,0,181,349,1
부산시청→연산교차로,2023.5.7 08:00,285,238,110,633,1
사직운동장→연산교차로,2023.5.7 08:00,115,287,43,445,1
신리→연산교차로,2023.5.7 08:00,233,156,28,417,1
안락→연산교차로,2023.5.7 08:00,283,0,71,354,1
연산터널→연산교차로,2023.5.7 08:00,181,165,37,383,1
교대→연산교차로,2023.5.7 09:00,228,0,234,462,1
부산시청→연산교차로,2023.5.7 09:00,358,305,167,830,1
사직운동장→연산교차로,2023.5.7 09:00,140,357,29,526,1
신리→연산교차로,2023.5.7 09:00,390,210,24,624,1
안락→연산교차로,2023.5.7 09:00,395,0,111,506,1
연산터널→연산교차로,2023.5.7 09:00,266,236,38,540,1
교대→연산교차로,2023.5.7 10:00,277,0,327,604,1
부산시청→연산교차로,2023.5.7 10:00,510,342,194,1046,1
사직운동장→연산교차로,2023.5.7 10:00,182,570,52,804,1
신리→연산교차로,2023.5.7 10:00,466,231,40,737,1
안락→연산교차로,2023.5.7 10:00,495,0,137,632,1
연산터널→연산교차로,2023.5.7 10:00,270,284,46,600,1
교대→연산교차로,2023.5.7 11:00,281,0,366,647,1
부산시청→연산교차로,2023.5.7 11:00,604,340,243,1187,1
사직운동장→연산교차로,2023.5.7 11:00,206,570,41,817,1
신리→연산교차로,2023.5.7 11:00,479,284,36,799,1
안락→연산교차로,2023.5.7 11:00,544,0,142,686,1
연산터널→연산교차로,2023.5.7 11:00,306,287,50,643,1
교대→연산교차로,2023.5.7 12:00,304,0,375,679,1
부산시청→연산교차로,2023.5.7 12:00,607,363,199,1169,1
사직운동장→연산교차로,2023.5.7 12:00,226,561,31,818,1
신리→연산교차로,2023.5.7 12:00,462,276,41,779,1
안락→연산교차로,2023.5.7 12:00,593,0,117,710,1
연산터널→연산교차로,2023.5.7 12:00,286,338,57,681,1
교대→연산교차로,2023.5.7 13:00,300,0,440,740,1
부산시청→연산교차로,2023.5.7 13:00,564,371,220,1155,1
사직운동장→연산교차로,2023.5.7 13:00,213,602,41,856,1
신리→연산교차로,2023.5.7 13:00,463,262,48,773,1
안락→연산교차로,2023.5.7 13:00,570,0,113,683,1
연산터널→연산교차로,2023.5.7 13:00,266,311,54,631,1
교대→연산교차로,2023.5.7 14:00,309,0,406,715,1
부산시청→연산교차로,2023.5.7 14:00,591,363,255,1209,1
사직운동장→연산교차로,2023.5.7 14:00,224,576,39,839,1
신리→연산교차로,2023.5.7 14:00,459,244,51,754,1
안락→연산교차로,2023.5.7 14:00,573,0,107,680,1
연산터널→연산교차로,2023.5.7 14:00,279,308,60,647,1
교대→연산교차로,2023.5.7 15:00,298,0,380,678,1
부산시청→연산교차로,2023.5.7 15:00,571,375,277,1223,1
사직운동장→연산교차로,2023.5.7 15:00,201,593,40,834,1
신리→연산교차로,2023.5.7 15:00,422,227,55,704,1
안락→연산교차로,2023.5.7 15:00,578,0,118,696,1
연산터널→연산교차로,2023.5.7 15:00,276,289,66,631,1
교대→연산교차로,2023.5.7 16:00,307,0,339,646,1
부산시청→연산교차로,2023.5.7 16:00,577,379,236,1192,1
사직운동장→연산교차로,2023.5.7 16:00,207,576,25,808,1
신리→연산교차로,2023.5.7 16:00,460,237,38,735,1
안락→연산교차로,2023.5.7 16:00,568,0,135,703,1
연산터널→연산교차로,2023.5.7 16:00,276,314,49,639,1
교대→연산교차로,2023.5.7 17:00,302,0,375,677,1
부산시청→연산교차로,2023.5.7 17:00,582,368,259,1209,1
사직운동장→연산교차로,2023.5.7 17:00,221,569,34,824,1
신리→연산교차로,2023.5.7 17:00,416,221,40,677,1
안락→연산교차로,2023.5.7 17:00,584,0,117,701,1
연산터널→연산교차로,2023.5.7 17:00,312,300,60,672,1
교대→연산교차로,2023.5.7 18:00,319,0,358,677,1
부산시청→연산교차로,2023.5.7 18:00,481,325,228,1034,1
사직운동장→연산교차로,2023.5.7 18:00,232,499,61,792,1
신리→연산교차로,2023.5.7 18:00,366,212,37,615,1
안락→연산교차로,2023.5.7 18:00,541,0,119,660,1
연산터널→연산교차로,2023.5.7 18:00,219,264,58,541,1
교대→연산교차로,2023.5.7 19:00,291,0,265,556,1
부산시청→연산교차로,2023.5.7 19:00,444,290,211,945,1
사직운동장→연산교차로,2023.5.7 19:00,164,469,42,675,1
신리→연산교차로,2023.5.7 19:00,349,168,33,550,1
안락→연산교차로,2023.5.7 19:00,470,0,117,587,1
연산터널→연산교차로,2023.5.7 19:00,246,230,49,525,1
교대→연산교차로,2023.5.7 20:00,295,0,228,523,1
부산시청→연산교차로,2023.5.7 20:00,444,288,195,927,1
사직운동장→연산교차로,2023.5.7 20:00,154,431,33,618,1
신리→연산교차로,2023.5.7 20:00,335,166,15,516,1
안락→연산교차로,2023.5.7 20:00,422,0,82,504,1
연산터널→연산교차로,2023.5.7 20:00,244,267,34,545,1
교대→연산교차로,2023.5.7 21:00,277,0,185,462,1
부산시청→연산교차로,2023.5.7 21:00,394,287,167,848,1
사직운동장→연산교차로,2023.5.7 21:00,142,364,49,555,1
신리→연산교차로,2023.5.7 21:00,316,161,22,499,1
안락→연산교차로,2023.5.7 21:00,374,0,99,473,1
연산터널→연산교차로,2023.5.7 21:00,201,238,38,477,1
교대→연산교차로,2023.5.7 22:00,201,0,154,355,1
부산시청→연산교차로,2023.5.7 22:00,302,214,123,639,1
사직운동장→연산교차로,2023.5.7 22:00,90,267,60,417,1
신리→연산교차로,2023.5.7 22:00,242,99,14,355,1
안락→연산교차로,2023.5.7 22:00,336,0,71,407,1
연산터널→연산교차로,2023.5.7 22:00,167,158,44,369,1
교대→연산교차로,2023.5.7 23:00,130,0,114,244,1
부산시청→연산교차로,2023.5.7 23:00,268,176,71,515,1
사직운동장→연산교차로,2023.5.7 23:00,88,218,44,350,1
신리→연산교차로,2023.5.7 23:00,180,88,17,285,1
안락→연산교차로,2023.5.7 23:00,206,0,50,256,1
연산터널→연산교차로,2023.5.7 23:00,125,148,52,325,1
교대→연산교차로,2023.5.8 00:00,98,0,89,187,0
부산시청→연산교차로,2023.5.8 00:00,200,139,79,418,0
사직운동장→연산교차로,2023.5.8 00:00,60,181,30,271,0
신리→연산교차로,2023.5.8 00:00,128,67,17,212,0
안락→연산교차로,2023.5.8 00:00,168,0,31,199,0
연산터널→연산교차로,2023.5.8 00:00,100,136,56,292,0
교대→연산교차로,2023.5.8 01:00,71,0,79,150,0
부산시청→연산교차로,2023.5.8 01:00,145,105,65,315,0
사직운동장→연산교차로,2023.5.8 01:00,50,118,14,182,0
신리→연산교차로,2023.5.8 01:00,78,47,9,134,0
안락→연산교차로,2023.5.8 01:00,130,0,24,154,0
연산터널→연산교차로,2023.5.8 01:00,91,98,45,234,0
교대→연산교차로,2023.5.8 02:00,44,0,63,107,0
부산시청→연산교차로,2023.5.8 02:00,98,65,52,215,0
사직운동장→연산교차로,2023.5.8 02:00,45,96,17,158,0
신리→연산교차로,2023.5.8 02:00,67,33,7,107,0
안락→연산교차로,2023.5.8 02:00,135,0,25,160,0
연산터널→연산교차로,2023.5.8 02:00,67,74,36,177,0
교대→연산교차로,2023.5.8 03:00,43,0,50,93,0
부산시청→연산교차로,2023.5.8 03:00,119,47,35,201,0
사직운동장→연산교차로,2023.5.8 03:00,19,89,19,127,0
신리→연산교차로,2023.5.8 03:00,67,14,12,93,0
안락→연산교차로,2023.5.8 03:00,78,0,19,97,0
연산터널→연산교차로,2023.5.8 03:00,59,78,33,170,0
교대→연산교차로,2023.5.8 04:00,41,0,67,108,0
부산시청→연산교차로,2023.5.8 04:00,133,59,31,223,0
사직운동장→연산교차로,2023.5.8 04:00,22,79,13,114,0
신리→연산교차로,2023.5.8 04:00,78,31,6,115,0
안락→연산교차로,2023.5.8 04:00,146,0,16,162,0
연산터널→연산교차로,2023.5.8 04:00,52,72,17,141,0
교대→연산교차로,2023.5.8 05:00,94,0,119,213,0
부산시청→연산교차로,2023.5.8 05:00,238,151,65,454,0
사직운동장→연산교차로,2023.5.8 05:00,45,161,28,234,0
신리→연산교차로,2023.5.8 05:00,234,94,17,345,0
안락→연산교차로,2023.5.8 05:00,368,0,53,421,0
연산터널→연산교차로,2023.5.8 05:00,121,144,25,290,0
교대→연산교차로,2023.5.8 06:00,183,0,239,422,0
부산시청→연산교차로,2023.5.8 06:00,407,280,129,816,0
사직운동장→연산교차로,2023.5.8 06:00,100,260,29,389,0
신리→연산교차로,2023.5.8 06:00,365,143,29,537,0
안락→연산교차로,2023.5.8 06:00,547,0,72,619,0
연산터널→연산교차로,2023.5.8 06:00,218,267,33,518,0
교대→연산교차로,2023.5.8 07:00,277,0,435,712,0
부산시청→연산교차로,2023.5.8 07:00,558,380,235,1173,0
사직운동장→연산교차로,2023.5.8 07:00,203,491,51,745,0
신리→연산교차로,2023.5.8 07:00,498,256,29,783,0
안락→연산교차로,2023.5.8 07:00,635,0,63,698,0
연산터널→연산교차로,2023.5.8 07:00,286,363,39,688,0
교대→연산교차로,2023.5.8 08:00,321,0,487,808,0
부산시청→연산교차로,2023.5.8 08:00,555,438,336,1329,0
사직운동장→연산교차로,2023.5.8 08:00,213,625,49,887,0
신리→연산교차로,2023.5.8 08:00,491,346,35,872,0
안락→연산교차로,2023.5.8 08:00,624,0,83,707,0
연산터널→연산교차로,2023.5.8 08:00,323,374,29,726,0
교대→연산교차로,2023.5.8 09:00,291,0,539,830,0
부산시청→연산교차로,2023.5.8 09:00,526,374,279,1179,0
사직운동장→연산교차로,2023.5.8 09:00,189,529,68,786,0
신리→연산교차로,2023.5.8 09:00,466,328,52,846,0
안락→연산교차로,2023.5.8 09:00,589,0,99,688,0
연산터널→연산교차로,2023.5.8 09:00,291,374,43,708,0
교대→연산교차로,2023.5.8 10:00,297,0,467,764,0
부산시청→연산교차로,2023.5.8 10:00,568,363,276,1207,0
사직운동장→연산교차로,2023.5.8 10:00,214,584,59,857,0
신리→연산교차로,2023.5.8 10:00,439,273,62,774,0
안락→연산교차로,2023.5.8 10:00,558,0,109,667,0
연산터널→연산교차로,2023.5.8 10:00,290,322,42,654,0
교대→연산교차로,2023.5.8 11:00,293,0,439,732,0
부산시청→연산교차로,2023.5.8 11:00,594,382,283,1259,0
사직운동장→연산교차로,2023.5.8 11:00,246,556,55,857,0
신리→연산교차로,2023.5.8 11:00,443,278,60,781,0
안락→연산교차로,2023.5.8 11:00,513,0,147,660,0
연산터널→연산교차로,2023.5.8 11:00,286,337,52,675,0
교대→연산교차로,2023.5.8 12:00,292,0,431,723,0
부산시청→연산교차로,2023.5.8 12:00,585,366,268,1219,0
사직운동장→연산교차로,2023.5.8 12:00,236,554,45,835,0
신리→연산교차로,2023.5.8 12:00,445,263,47,755,0
안락→연산교차로,2023.5.8 12:00,489,0,155,644,0
연산터널→연산교차로,2023.5.8 12:00,288,309,46,643,0
교대→연산교차로,2023.5.8 13:00,331,0,455,786,0
부산시청→연산교차로,2023.5.8 13:00,612,466,287,1365,0
사직운동장→연산교차로,2023.5.8 13:00,232,582,52,866,0
신리→연산교차로,2023.5.8 13:00,437,282,56,775,0
안락→연산교차로,2023.5.8 13:00,423,0,115,538,0
연산터널→연산교차로,2023.5.8 13:00,241,250,34,525,0
교대→연산교차로,2023.5.8 14:00,344,0,513,857,0
부산시청→연산교차로,2023.5.8 14:00,577,475,305,1357,0
사직운동장→연산교차로,2023.5.8 14:00,254,622,69,945,0
신리→연산교차로,2023.5.8 14:00,464,275,58,797,0
안락→연산교차로,2023.5.8 14:00,430,0,122,552,0
연산터널→연산교차로,2023.5.8 14:00,227,277,47,551,0
교대→연산교차로,2023.5.8 15:00,344,0,443,787,0
부산시청→연산교차로,2023.5.8 15:00,612,474,287,1373,0
사직운동장→연산교차로,2023.5.8 15:00,257,631,92,980,0
신리→연산교차로,2023.5.8 15:00,490,293,55,838,0
안락→연산교차로,2023.5.8 15:00,444,0,107,551,0
연산터널→연산교차로,2023.5.8 15:00,221,286,58,565,0
교대→연산교차로,2023.5.8 16:00,353,0,505,858,0
부산시청→연산교차로,2023.5.8 16:00,613,529,309,1451,0
사직운동장→연산교차로,2023.5.8 16:00,252,641,70,963,0
신리→연산교차로,2023.5.8 16:00,526,276,61,863,0
안락→연산교차로,2023.5.8 16:00,419,0,94,513,0
연산터널→연산교차로,2023.5.8 16:00,218,292,39,549,0
교대→연산교차로,2023.5.8 17:00,354,0,521,875,0
부산시청→연산교차로,2023.5.8 17:00,653,566,297,1516,0
사직운동장→연산교차로,2023.5.8 17:00,262,682,43,987,0
신리→연산교차로,2023.5.8 17:00,553,282,45,880,0
안락→연산교차로,2023.5.8 17:00,452,0,75,527,0
연산터널→연산교차로,2023.5.8 17:00,220,288,45,553,0
교대→연산교차로,2023.5.8 18:00,357,0,541,898,0
부산시청→연산교차로,2023.5.8 18:00,604,568,366,1538,0
사직운동장→연산교차로,2023.5.8 18:00,228,704,67,999,0
신리→연산교차로,2023.5.8 18:00,548,265,45,858,0
안락→연산교차로,2023.5.8 18:00,466,0,99,565,0
연산터널→연산교차로,2023.5.8 18:00,200,286,49,535,0
교대→연산교차로,2023.5.8 19:00,356,0,439,795,0
부산시청→연산교차로,2023.5.8 19:00,562,452,317,1331,0
사직운동장→연산교차로,2023.5.8 19:00,193,554,65,812,0
신리→연산교차로,2023.5.8 19:00,402,224,37,663,0
안락→연산교차로,2023.5.8 19:00,448,0,91,539,0
연산터널→연산교차로,2023.5.8 19:00,218,252,51,521,0
교대→연산교차로,2023.5.8 20:00,324,0,305,629,0
부산시청→연산교차로,2023.5.8 20:00,495,379,222,1096,0
사직운동장→연산교차로,2023.5.8 20:00,189,486,64,739,0
신리→연산교차로,2023.5.8 20:00,351,229,30,610,0
안락→연산교차로,2023.5.8 20:00,419,0,88,507,0
연산터널→연산교차로,2023.5.8 20:00,208,250,61,519,0
교대→연산교차로,2023.5.8 21:00,279,0,259,538,0
부산시청→연산교차로,2023.5.8 21:00,498,361,249,1108,0
사직운동장→연산교차로,2023.5.8 21:00,169,419,76,664,0
신리→연산교차로,2023.5.8 21:00,281,192,29,502,0
안락→연산교차로,2023.5.8 21:00,493,0,107,600,0
연산터널→연산교차로,2023.5.8 21:00,203,259,62,524,0
교대→연산교차로,2023.5.8 22:00,222,0,194,416,0
부산시청→연산교차로,2023.5.8 22:00,401,273,172,846,0
사직운동장→연산교차로,2023.5.8 22:00,129,354,74,557,0
신리→연산교차로,2023.5.8 22:00,241,151,23,415,0
안락→연산교차로,2023.5.8 22:00,338,0,81,419,0
연산터널→연산교차로,2023.5.8 22:00,199,228,73,500,0
교대→연산교차로,2023.5.8 23:00,189,0,153,342,0
부산시청→연산교차로,2023.5.8 23:00,305,164,125,594,0
사직운동장→연산교차로,2023.5.8 23:00,113,245,61,419,0
신리→연산교차로,2023.5.8 23:00,182,90,21,293,0
안락→연산교차로,2023.5.8 23:00,239,0,57,296,0
연산터널→연산교차로,2023.5.8 23:00,126,194,53,373,0
교대→연산교차로,2023.5.9 00:00,117,0,112,229,0
부산시청→연산교차로,2023.5.9 00:00,217,137,95,449,0
사직운동장→연산교차로,2023.5.9 00:00,64,214,58,336,0
신리→연산교차로,2023.5.9 00:00,135,75,19,229,0
안락→연산교차로,2023.5.9 00:00,180,0,43,223,0
연산터널→연산교차로,2023.5.9 00:00,129,167,56,352,0
교대→연산교차로,2023.5.9 01:00,82,0,104,186,0
부산시청→연산교차로,2023.5.9 01:00,162,105,71,338,0
사직운동장→연산교차로,2023.5.9 01:00,60,153,37,250,0
신리→연산교차로,2023.5.9 01:00,90,45,16,151,0
안락→연산교차로,2023.5.9 01:00,157,0,44,201,0
연산터널→연산교차로,2023.5.9 01:00,100,125,44,269,0
교대→연산교차로,2023.5.9 02:00,64,0,73,137,0
부산시청→연산교차로,2023.5.9 02:00,152,76,63,291,0
사직운동장→연산교차로,2023.5.9 02:00,35,167,25,227,0
신리→연산교차로,2023.5.9 02:00,72,47,14,133,0
안락→연산교차로,2023.5.9 02:00,132,0,24,156,0
연산터널→연산교차로,2023.5.9 02:00,76,114,37,227,0
교대→연산교차로,2023.5.9 03:00,52,0,85,137,0
부산시청→연산교차로,2023.5.9 03:00,140,70,43,253,0
사직운동장→연산교차로,2023.5.9 03:00,38,106,30,174,0
신리→연산교차로,2023.5.9 03:00,66,43,12,121,0
안락→연산교차로,2023.5.9 03:00,103,0,20,123,0
연산터널→연산교차로,2023.5.9 03:00,68,82,40,190,0
교대→연산교차로,2023.5.9 04:00,53,0,64,117,0
부산시청→연산교차로,2023.5.9 04:00,147,53,50,250,0
사직운동장→연산교차로,2023.5.9 04:00,35,110,25,170,0
신리→연산교차로,2023.5.9 04:00,92,42,3,137,0
안락→연산교차로,2023.5.9 04:00,181,0,33,214,0
연산터널→연산교차로,2023.5.9 04:00,75,81,29,185,0
교대→연산교차로,2023.5.9 05:00,98,0,135,233,0
부산시청→연산교차로,2023.5.9 05:00,240,165,74,479,0
사직운동장→연산교차로,2023.5.9 05:00,54,166,36,256,0
신리→연산교차로,2023.5.9 05:00,247,93,13,353,0
안락→연산교차로,2023.5.9 05:00,342,0,55,397,0
연산터널→연산교차로,2023.5.9 05:00,132,158,33,323,0
교대→연산교차로,2023.5.9 06:00,188,0,262,450,0
부산시청→연산교차로,2023.5.9 06:00,372,283,120,775,0
사직운동장→연산교차로,2023.5.9 06:00,90,273,35,398,0
신리→연산교차로,2023.5.9 06:00,349,153,23,525,0
안락→연산교차로,2023.5.9 06:00,521,0,81,602,0
연산터널→연산교차로,2023.5.9 06:00,217,241,33,491,0
교대→연산교차로,2023.5.9 07:00,260,0,398,658,0
부산시청→연산교차로,2023.5.9 07:00,544,370,243,1157,0
사직운동장→연산교차로,2023.5.9 07:00,182,489,38,709,0
신리→연산교차로,2023.5.9 07:00,523,254,32,809,0
안락→연산교차로,2023.5.9 07:00,594,0,76,670,0
연산터널→연산교차로,2023.5.9 07:00,275,362,29,666,0
교대→연산교차로,2023.5.9 08:00,296,0,502,798,0
부산시청→연산교차로,2023.5.9 08:00,572,435,314,1321,0
사직운동장→연산교차로,2023.5.9 08:00,205,632,43,880,0
신리→연산교차로,2023.5.9 08:00,512,338,26,876,0
안락→연산교차로,2023.5.9 08:00,624,0,87,711,0
연산터널→연산교차로,2023.5.9 08:00,315,372,32,719,0
교대→연산교차로,2023.5.9 09:00,284,0,546,830,0
부산시청→연산교차로,2023.5.9 09:00,519,395,290,1204,0
사직운동장→연산교차로,2023.5.9 09:00,191,559,59,809,0
신리→연산교차로,2023.5.9 09:00,456,337,37,830,0
안락→연산교차로,2023.5.9 09:00,571,0,94,665,0
연산터널→연산교차로,2023.5.9 09:00,303,364,47,714,0
교대→연산교차로,2023.5.9 10:00,296,0,436,732,0
부산시청→연산교차로,2023.5.9 10:00,570,371,261,1202,0
사직운동장→연산교차로,2023.5.9 10:00,231,545,52,828,0
신리→연산교차로,2023.5.9 10:00,488,270,65,823,0
안락→연산교차로,2023.5.9 10:00,560,0,106,666,0
연산터널→연산교차로,2023.5.9 10:00,285,354,53,692,0
교대→연산교차로,2023.5.9 11:00,308,0,463,771,0
부산시청→연산교차로,2023.5.9 11:00,529,358,209,1096,0
사직운동장→연산교차로,2023.5.9 11:00,205,533,64,802,0
신리→연산교차로,2023.5.9 11:00,452,257,54,763,0
안락→연산교차로,2023.5.9 11:00,489,0,130,619,0
연산터널→연산교차로,2023.5.9 11:00,283,274,56,613,0
교대→연산교차로,2023.5.9 12:00,293,0,384,677,0
부산시청→연산교차로,2023.5.9 12:00,561,375,247,1183,0
사직운동장→연산교차로,2023.5.9 12:00,203,550,64,817,0
신리→연산교차로,2023.5.9 12:00,411,213,60,684,0
안락→연산교차로,2023.5.9 12:00,454,0,135,589,0
연산터널→연산교차로,2023.5.9 12:00,287,257,48,592,0
교대→연산교차로,2023.5.9 13:00,328,0,413,741,0
부산시청→연산교차로,2023.5.9 13:00,520,440,244,1204,0
사직운동장→연산교차로,2023.5.9 13:00,247,567,30,844,0
신리→연산교차로,2023.5.9 13:00,415,286,49,750,0
안락→연산교차로,2023.5.9 13:00,400,0,125,525,0
연산터널→연산교차로,2023.5.9 13:00,236,270,46,552,0
교대→연산교차로,2023.5.9 14:00,347,0,515,862,0
부산시청→연산교차로,2023.5.9 14:00,569,472,267,1308,0
사직운동장→연산교차로,2023.5.9 14:00,226,581,78,885,0
신리→연산교차로,2023.5.9 14:00,462,254,50,766,0
안락→연산교차로,2023.5.9 14:00,417,0,95,512,0
연산터널→연산교차로,2023.5.9 14:00,222,293,51,566,0
교대→연산교차로,2023.5.9 15:00,344,0,467,811,0
부산시청→연산교차로,2023.5.9 15:00,576,535,297,1408,0
사직운동장→연산교차로,2023.5.9 15:00,238,602,93,933,0
신리→연산교차로,2023.5.9 15:00,467,298,55,820,0
안락→연산교차로,2023.5.9 15:00,439,0,93,532,0
연산터널→연산교차로,2023.5.9 15:00,229,275,40,544,0
교대→연산교차로,2023.5.9 16:00,339,0,504,843,0
부산시청→연산교차로,2023.5.9 16:00,620,523,286,1429,0
사직운동장→연산교차로,2023.5.9 16:00,271,607,67,945,0
신리→연산교차로,2023.5.9 16:00,503,297,36,836,0
안락→연산교차로,2023.5.9 16:00,405,0,83,488,0
연산터널→연산교차로,2023.5.9 16:00,222,291,34,547,0
교대→연산교차로,2023.5.9 17:00,363,0,510,873,0
부산시청→연산교차로,2023.5.9 17:00,582,571,343,1496,0
사직운동장→연산교차로,2023.5.9 17:00,236,676,62,974,0
신리→연산교차로,2023.5.9 17:00,495,338,49,882,0
안락→연산교차로,2023.5.9 17:00,446,0,89,535,0
연산터널→연산교차로,2023.5.9 17:00,225,266,43,534,0
교대→연산교차로,2023.5.9 18:00,361,0,497,858,0
부산시청→연산교차로,2023.5.9 18:00,573,549,351,1473,0
사직운동장→연산교차로,2023.5.9 18:00,247,662,51,960,0
신리→연산교차로,2023.5.9 18:00,521,267,50,838,0
안락→연산교차로,2023.5.9 18:00,482,0,94,576,0
연산터널→연산교차로,2023.5.9 18:00,213,290,57,560,0
교대→연산교차로,2023.5.9 19:00,335,0,390,725,0
부산시청→연산교차로,2023.5.9 19:00,539,394,242,1175,0
사직운동장→연산교차로,2023.5.9 19:00,175,548,57,780,0
신리→연산교차로,2023.5.9 19:00,331,227,37,595,0
안락→연산교차로,2023.5.9 19:00,424,0,96,520,0
연산터널→연산교차로,2023.5.9 19:00,208,250,51,509,0
교대→연산교차로,2023.5.9 20:00,297,0,295,592,0
부산시청→연산교차로,2023.5.9 20:00,503,365,247,1115,0
사직운동장→연산교차로,2023.5.9 20:00,168,499,53,720,0
신리→연산교차로,2023.5.9 20:00,350,179,22,551,0
안락→연산교차로,2023.5.9 20:00,414,0,113,527,0
연산터널→연산교차로,2023.5.9 20:00,207,272,61,540,0
교대→연산교차로,2023.5.9 21:00,276,0,295,571,0
부산시청→연산교차로,2023.5.9 21:00,468,322,196,986,0
사직운동장→연산교차로,2023.5.9 21:00,224,462,38,724,0
신리→연산교차로,2023.5.9 21:00,300,184,29,513,0
안락→연산교차로,2023.5.9 21:00,392,0,115,507,0
연산터널→연산교차로,2023.5.9 21:00,221,255,54,530,0
교대→연산교차로,2023.5.9 22:00,264,0,248,512,0
부산시청→연산교차로,2023.5.9 22:00,456,287,163,906,0
사직운동장→연산교차로,2023.5.9 22:00,223,354,38,615,0
신리→연산교차로,2023.5.9 22:00,269,161,25,455,0
안락→연산교차로,2023.5.9 22:00,364,0,87,451,0
연산터널→연산교차로,2023.5.9 22:00,200,220,46,466,0
교대→연산교차로,2023.5.9 23:00,190,0,145,335,0
부산시청→연산교차로,2023.5.9 23:00,341,212,128,681,0
사직운동장→연산교차로,2023.5.9 23:00,116,272,25,413,0
신리→연산교차로,2023.5.9 23:00,196,116,22,334,0
안락→연산교차로,2023.5.9 23:00,311,0,75,386,0
연산터널→연산교차로,2023.5.9 23:00,164,183,51,398,0
교대→연산교차로,2023.5.10 00:00,132,0,163,295,0
부산시청→연산교차로,2023.5.10 00:00,270,176,107,553,0
사직운동장→연산교차로,2023.5.10 00:00,90,244,11,345,0
신리→연산교차로,2023.5.10 00:00,158,93,15,266,0
안락→연산교차로,2023.5.10 00:00,221,0,68,289,0
연산터널→연산교차로,2023.5.10 00:00,123,177,46,346,0
교대→연산교차로,2023.5.10 01:00,112,0,128,240,0
부산시청→연산교차로,2023.5.10 01:00,205,105,82,392,0
사직운동장→연산교차로,2023.5.10 01:00,88,152,13,253,0
신리→연산교차로,2023.5.10 01:00,114,64,16,194,0
안락→연산교차로,2023.5.10 01:00,167,0,39,206,0
연산터널→연산교차로,2023.5.10 01:00,111,132,50,293,0
교대→연산교차로,2023.5.10 02:00,90,0,105,195,0
부산시청→연산교차로,2023.5.10 02:00,166,79,68,313,0
사직운동장→연산교차로,2023.5.10 02:00,52,152,4,208,0
신리→연산교차로,2023.5.10 02:00,81,57,16,154,0
안락→연산교차로,2023.5.10 02:00,135,0,32,167,0
연산터널→연산교차로,2023.5.10 02:00,101,103,32,236,0
교대→연산교차로,2023.5.10 03:00,59,0,86,145,0
부산시청→연산교차로,2023.5.10 03:00,152,75,46,273,0
사직운동장→연산교차로,2023.5.10 03:00,35,122,1,158,0
신리→연산교차로,2023.5.10 03:00,72,30,11,113,0
안락→연산교차로,2023.5.10 03:00,112,0,29,141,0
연산터널→연산교차로,2023.5.10 03:00,86,108,29,223,0
교대→연산교차로,2023.5.10 04:00,62,0,78,140,0
부산시청→연산교차로,2023.5.10 04:00,142,80,51,273,0
사직운동장→연산교차로,2023.5.10 04:00,40,112,2,154,0
신리→연산교차로,2023.5.10 04:00,102,50,5,157,0
안락→연산교차로,2023.5.10 04:00,186,0,32,218,0
연산터널→연산교차로,2023.5.10 04:00,76,99,31,206,0
교대→연산교차로,2023.5.10 05:00,114,0,132,246,0
부산시청→연산교차로,2023.5.10 05:00,229,166,77,472,0
사직운동장→연산교차로,2023.5.10 05:00,57,167,31,255,0
신리→연산교차로,2023.5.10 05:00,225,89,21,335,0
안락→연산교차로,2023.5.10 05:00,325,0,60,385,0
연산터널→연산교차로,2023.5.10 05:00,136,139,31,306,0
교대→연산교차로,2023.5.10 06:00,190,0,241,431,0
부산시청→연산교차로,2023.5.10 06:00,368,245,97,710,0
사직운동장→연산교차로,2023.5.10 06:00,104,270,50,424,0
신리→연산교차로,2023.5.10 06:00,337,133,22,492,0
안락→연산교차로,2023.5.10 06:00,545,0,70,615,0
연산터널→연산교차로,2023.5.10 06:00,217,224,34,475,0
교대→연산교차로,2023.5.10 07:00,287,0,373,660,0
부산시청→연산교차로,2023.5.10 07:00,553,373,228,1154,0
사직운동장→연산교차로,2023.5.10 07:00,184,484,39,707,0
신리→연산교차로,2023.5.10 07:00,501,255,22,778,0
안락→연산교차로,2023.5.10 07:00,618,0,70,688,0
연산터널→연산교차로,2023.5.10 07:00,277,364,46,687,0
교대→연산교차로,2023.5.10 08:00,306,0,516,822,0
부산시청→연산교차로,2023.5.10 08:00,562,409,336,1307,0
사직운동장→연산교차로,2023.5.10 08:00,200,635,41,876,0
신리→연산교차로,2023.5.10 08:00,518,348,24,890,0
안락→연산교차로,2023.5.10 08:00,616,0,92,708,0
연산터널→연산교차로,2023.5.10 08:00,298,389,39,726,0
교대→연산교차로,2023.5.10 09:00,278,0,490,768,0
부산시청→연산교차로,2023.5.10 09:00,509,365,286,1160,0
사직운동장→연산교차로,2023.5.10 09:00,215,537,53,805,0
신리→연산교차로,2023.5.10 09:00,476,301,40,817,0
안락→연산교차로,2023.5.10 09:00,599,0,92,691,0
연산터널→연산교차로,2023.5.10 09:00,288,383,40,711,0
교대→연산교차로,2023.5.10 10:00,284,0,467,751,0
부산시청→연산교차로,2023.5.10 10:00,559,385,275,1219,0
사직운동장→연산교차로,2023.5.10 10:00,211,577,56,844,0
신리→연산교차로,2023.5.10 10:00,467,295,43,805,0
안락→연산교차로,2023.5.10 10:00,546,0,123,669,0
연산터널→연산교차로,2023.5.10 10:00,261,337,45,643,0
교대→연산교차로,2023.5.10 11:00,300,0,423,723,0
부산시청→연산교차로,2023.5.10 11:00,552,379,247,1178,0
사직운동장→연산교차로,2023.5.10 11:00,231,532,62,825,0
신리→연산교차로,2023.5.10 11:00,471,252,46,769,0
안락→연산교차로,2023.5.10 11:00,523,0,122,645,0
연산터널→연산교차로,2023.5.10 11:00,245,336,47,628,0
교대→연산교차로,2023.5.10 12:00,291,0,392,683,0
부산시청→연산교차로,2023.5.10 12:00,527,371,231,1129,0
사직운동장→연산교차로,2023.5.10 12:00,203,541,72,816,0
신리→연산교차로,2023.5.10 12:00,431,228,53,712,0
안락→연산교차로,2023.5.10 12:00,483,0,140,623,0
연산터널→연산교차로,2023.5.10 12:00,275,273,50,598,0
교대→연산교차로,2023.5.10 13:00,326,0,445,771,0
부산시청→연산교차로,2023.5.10 13:00,566,443,256,1265,0
사직운동장→연산교차로,2023.5.10 13:00,223,529,54,806,0
신리→연산교차로,2023.5.10 13:00,395,294,34,723,0
안락→연산교차로,2023.5.10 13:00,431,0,115,546,0
연산터널→연산교차로,2023.5.10 13:00,254,233,28,515,0
교대→연산교차로,2023.5.10 14:00,346,0,471,817,0
부산시청→연산교차로,2023.5.10 14:00,522,449,301,1272,0
사직운동장→연산교차로,2023.5.10 14:00,250,587,63,900,0
신리→연산교차로,2023.5.10 14:00,447,258,48,753,0
안락→연산교차로,2023.5.10 14:00,404,0,102,506,0
연산터널→연산교차로,2023.5.10 14:00,228,256,48,532,0
교대→연산교차로,2023.5.10 15:00,350,0,465,815,0
부산시청→연산교차로,2023.5.10 15:00,564,481,289,1334,0
사직운동장→연산교차로,2023.5.10 15:00,261,609,74,944,0
신리→연산교차로,2023.5.10 15:00,445,282,45,772,0
안락→연산교차로,2023.5.10 15:00,436,0,121,557,0
연산터널→연산교차로,2023.5.10 15:00,239,257,43,539,0
교대→연산교차로,2023.5.10 16:00,361,0,435,796,0
부산시청→연산교차로,2023.5.10 16:00,576,488,315,1379,0
사직운동장→연산교차로,2023.5.10 16:00,253,648,57,958,0
신리→연산교차로,2023.5.10 16:00,506,284,50,840,0
안락→연산교차로,2023.5.10 16:00,469,0,100,569,0
연산터널→연산교차로,2023.5.10 16:00,221,290,33,544,0
교대→연산교차로,2023.5.10 17:00,366,0,527,893,0
부산시청→연산교차로,2023.5.10 17:00,615,555,309,1479,0
사직운동장→연산교차로,2023.5.10 17:00,242,667,47,956,0
신리→연산교차로,2023.5.10 17:00,507,318,51,876,0
안락→연산교차로,2023.5.10 17:00,433,0,115,548,0
연산터널→연산교차로,2023.5.10 17:00,230,282,36,548,0
교대→연산교차로,2023.5.10 18:00,377,0,517,894,0
부산시청→연산교차로,2023.5.10 18:00,579,597,338,1514,0
사직운동장→연산교차로,2023.5.10 18:00,257,667,61,985,0
신리→연산교차로,2023.5.10 18:00,512,281,30,823,0
안락→연산교차로,2023.5.10 18:00,457,0,86,543,0
연산터널→연산교차로,2023.5.10 18:00,224,264,46,534,0
교대→연산교차로,2023.5.10 19:00,344,0,413,757,0
부산시청→연산교차로,2023.5.10 19:00,555,411,255,1221,0
사직운동장→연산교차로,2023.5.10 19:00,192,531,61,784,0
신리→연산교차로,2023.5.10 19:00,371,238,43,652,0
안락→연산교차로,2023.5.10 19:00,421,0,96,517,0
연산터널→연산교차로,2023.5.10 19:00,191,276,46,513,0
교대→연산교차로,2023.5.10 20:00,328,0,313,641,0
부산시청→연산교차로,2023.5.10 20:00,495,353,216,1064,0
사직운동장→연산교차로,2023.5.10 20:00,183,494,37,714,0
신리→연산교차로,2023.5.10 20:00,302,204,20,526,0
안락→연산교차로,2023.5.10 20:00,409,0,87,496,0
연산터널→연산교차로,2023.5.10 20:00,229,267,61,557,0
교대→연산교차로,2023.5.10 21:00,303,0,267,570,0
부산시청→연산교차로,2023.5.10 21:00,491,372,209,1072,0
사직운동장→연산교차로,2023.5.10 21:00,259,463,30,752,0
신리→연산교차로,2023.5.10 21:00,303,196,29,528,0
안락→연산교차로,2023.5.10 21:00,424,0,107,531,0
연산터널→연산교차로,2023.5.10 21:00,228,268,58,554,0
교대→연산교차로,2023.5.10 22:00,264,0,226,490,0
부산시청→연산교차로,2023.5.10 22:00,417,270,165,852,0
사직운동장→연산교차로,2023.5.10 22:00,169,356,40,565,0
신리→연산교차로,2023.5.10 22:00,251,154,25,430,0
안락→연산교차로,2023.5.10 22:00,386,0,87,473,0
연산터널→연산교차로,2023.5.10 22:00,189,242,37,468,0
교대→연산교차로,2023.5.10 23:00,206,0,158,364,0
부산시청→연산교차로,2023.5.10 23:00,309,204,138,651,0
사직운동장→연산교차로,2023.5.10 23:00,118,247,18,383,0
신리→연산교차로,2023.5.10 23:00,192,124,19,335,0
안락→연산교차로,2023.5.10 23:00,259,0,69,328,0
연산터널→연산교차로,2023.5.10 23:00,148,183,45,376,0
교대→연산교차로,2023.5.11 00:00,154,0,163,317,0
부산시청→연산교차로,2023.5.11 00:00,267,159,103,529,0
사직운동장→연산교차로,2023.5.11 00:00,106,206,7,319,0
신리→연산교차로,2023.5.11 00:00,148,80,17,245,0
안락→연산교차로,2023.5.11 00:00,244,0,58,302,0
연산터널→연산교차로,2023.5.11 00:00,120,183,55,358,0
교대→연산교차로,2023.5.11 01:00,109,0,155,264,0
부산시청→연산교차로,2023.5.11 01:00,232,132,69,433,0
사직운동장→연산교차로,2023.5.11 01:00,75,160,4,239,0
신리→연산교차로,2023.5.11 01:00,121,64,13,198,0
안락→연산교차로,2023.5.11 01:00,167,0,48,215,0
연산터널→연산교차로,2023.5.11 01:00,115,163,43,321,0
교대→연산교차로,2023.5.11 02:00,72,0,121,193,0
부산시청→연산교차로,2023.5.11 02:00,166,109,56,331,0
사직운동장→연산교차로,2023.5.11 02:00,46,155,2,203,0
신리→연산교차로,2023.5.11 02:00,82,48,8,138,0
안락→연산교차로,2023.5.11 02:00,151,0,37,188,0
연산터널→연산교차로,2023.5.11 02:00,99,123,30,252,0
교대→연산교차로,2023.5.11 03:00,56,0,102,158,0
부산시청→연산교차로,2023.5.11 03:00,154,73,42,269,0
사직운동장→연산교차로,2023.5.11 03:00,49,119,6,174,0
신리→연산교차로,2023.5.11 03:00,71,43,10,124,0
안락→연산교차로,2023.5.11 03:00,106,0,30,136,0
연산터널→연산교차로,2023.5.11 03:00,75,97,44,216,0
교대→연산교차로,2023.5.11 04:00,63,0,81,144,0
부산시청→연산교차로,2023.5.11 04:00,158,74,42,274,0
사직운동장→연산교차로,2023.5.11 04:00,32,105,3,140,0
신리→연산교차로,2023.5.11 04:00,78,38,9,125,0
안락→연산교차로,2023.5.11 04:00,192,0,34,226,0
연산터널→연산교차로,2023.5.11 04:00,70,108,31,209,0
교대→연산교차로,2023.5.11 05:00,99,0,144,243,0
부산시청→연산교차로,2023.5.11 05:00,232,151,83,466,0
사직운동장→연산교차로,2023.5.11 05:00,57,153,31,241,0
신리→연산교차로,2023.5.11 05:00,226,90,14,330,0
안락→연산교차로,2023.5.11 05:00,333,0,61,394,0
연산터널→연산교차로,2023.5.11 05:00,145,146,35,326,0
교대→연산교차로,2023.5.11 06:00,166,0,258,424,0
부산시청→연산교차로,2023.5.11 06:00,379,272,121,772,0
사직운동장→연산교차로,2023.5.11 06:00,99,267,32,398,0
신리→연산교차로,2023.5.11 06:00,321,139,25,485,0
안락→연산교차로,2023.5.11 06:00,498,0,95,593,0
연산터널→연산교차로,2023.5.11 06:00,205,225,47,477,0
교대→연산교차로,2023.5.11 07:00,278,0,382,660,0
부산시청→연산교차로,2023.5.11 07:00,533,360,216,1109,0
사직운동장→연산교차로,2023.5.11 07:00,196,459,36,691,0
신리→연산교차로,2023.5.11 07:00,506,266,32,804,0
안락→연산교차로,2023.5.11 07:00,629,0,63,692,0
연산터널→연산교차로,2023.5.11 07:00,280,369,29,678,0
교대→연산교차로,2023.5.11 08:00,316,0,504,820,0
부산시청→연산교차로,2023.5.11 08:00,577,433,345,1355,0
사직운동장→연산교차로,2023.5.11 08:00,188,626,43,857,0
신리→연산교차로,2023.5.11 08:00,521,327,23,871,0
안락→연산교차로,2023.5.11 08:00,604,0,90,694,0
연산터널→연산교차로,2023.5.11 08:00,315,393,31,739,0
교대→연산교차로,2023.5.11 09:00,279,0,484,763,0
부산시청→연산교차로,2023.5.11 09:00,511,364,304,1179,0
사직운동장→연산교차로,2023.5.11 09:00,208,491,36,735,0
신리→연산교차로,2023.5.11 09:00,441,311,39,791,0
안락→연산교차로,2023.5.11 09:00,558,0,90,648,0
연산터널→연산교차로,2023.5.11 09:00,291,352,46,689,0
교대→연산교차로,2023.5.11 10:00,278,0,403,681,0
부산시청→연산교차로,2023.5.11 10:00,512,369,268,1149,0
사직운동장→연산교차로,2023.5.11 10:00,210,554,54,818,0
신리→연산교차로,2023.5.11 10:00,498,274,51,823,0
안락→연산교차로,2023.5.11 10:00,532,0,124,656,0
연산터널→연산교차로,2023.5.11 10:00,282,329,46,657,0
교대→연산교차로,2023.5.11 11:00,291,0,432,723,0
부산시청→연산교차로,2023.5.11 11:00,531,380,262,1173,0
사직운동장→연산교차로,2023.5.11 11:00,205,535,51,791,0
신리→연산교차로,2023.5.11 11:00,432,236,51,719,0
안락→연산교차로,2023.5.11 11:00,503,0,134,637,0
연산터널→연산교차로,2023.5.11 11:00,248,251,56,555,0
교대→연산교차로,2023.5.11 12:00,246,0,430,676,0
부산시청→연산교차로,2023.5.11 12:00,543,347,216,1106,0
사직운동장→연산교차로,2023.5.11 12:00,217,549,55,821,0
신리→연산교차로,2023.5.11 12:00,390,245,40,675,0
안락→연산교차로,2023.5.11 12:00,501,0,128,629,0
연산터널→연산교차로,2023.5.11 12:00,282,251,40,573,0
교대→연산교차로,2023.5.11 13:00,329,0,386,715,0
부산시청→연산교차로,2023.5.11 13:00,563,431,248,1242,0
사직운동장→연산교차로,2023.5.11 13:00,251,565,40,856,0
신리→연산교차로,2023.5.11 13:00,410,257,53,720,0
안락→연산교차로,2023.5.11 13:00,437,0,106,543,0
연산터널→연산교차로,2023.5.11 13:00,235,271,32,538,0
교대→연산교차로,2023.5.11 14:00,350,0,466,816,0
부산시청→연산교차로,2023.5.11 14:00,587,447,296,1330,0
사직운동장→연산교차로,2023.5.11 14:00,243,582,68,893,0
신리→연산교차로,2023.5.11 14:00,458,243,64,765,0
안락→연산교차로,2023.5.11 14:00,425,0,103,528,0
연산터널→연산교차로,2023.5.11 14:00,225,256,51,532,0
교대→연산교차로,2023.5.11 15:00,353,0,461,814,0
부산시청→연산교차로,2023.5.11 15:00,607,485,294,1386,0
사직운동장→연산교차로,2023.5.11 15:00,264,611,79,954,0
신리→연산교차로,2023.5.11 15:00,422,269,58,749,0
안락→연산교차로,2023.5.11 15:00,425,0,105,530,0
연산터널→연산교차로,2023.5.11 15:00,250,250,39,539,0
교대→연산교차로,2023.5.11 16:00,356,0,481,837,0
부산시청→연산교차로,2023.5.11 16:00,609,523,280,1412,0
사직운동장→연산교차로,2023.5.11 16:00,259,618,63,940,0
신리→연산교차로,2023.5.11 16:00,498,273,48,819,0
안락→연산교차로,2023.5.11 16:00,444,0,108,552,0
연산터널→연산교차로,2023.5.11 16:00,231,268,26,525,0
교대→연산교차로,2023.5.11 17:00,368,0,539,907,0
부산시청→연산교차로,2023.5.11 17:00,587,549,313,1449,0
사직운동장→연산교차로,2023.5.11 17:00,228,681,59,968,0
신리→연산교차로,2023.5.11 17:00,474,313,49,836,0
안락→연산교차로,2023.5.11 17:00,451,0,100,551,0
연산터널→연산교차로,2023.5.11 17:00,231,294,37,562,0
교대→연산교차로,2023.5.11 18:00,369,0,491,860,0
부산시청→연산교차로,2023.5.11 18:00,607,573,328,1508,0
사직운동장→연산교차로,2023.5.11 18:00,265,672,46,983,0
신리→연산교차로,2023.5.11 18:00,522,302,50,874,0
안락→연산교차로,2023.5.11 18:00,466,0,91,557,0
연산터널→연산교차로,2023.5.11 18:00,235,286,34,555,0
교대→연산교차로,2023.5.11 19:00,330,0,396,726,0
부산시청→연산교차로,2023.5.11 19:00,533,431,247,1211,0
사직운동장→연산교차로,2023.5.11 19:00,199,563,59,821,0
신리→연산교차로,2023.5.11 19:00,373,201,39,613,0
안락→연산교차로,2023.5.11 19:00,423,0,96,519,0
연산터널→연산교차로,2023.5.11 19:00,224,232,54,510,0
교대→연산교차로,2023.5.11 20:00,343,0,278,621,0
부산시청→연산교차로,2023.5.11 20:00,516,410,230,1156,0
사직운동장→연산교차로,2023.5.11 20:00,178,490,60,728,0
신리→연산교차로,2023.5.11 20:00,320,190,30,540,0
안락→연산교차로,2023.5.11 20:00,425,0,106,531,0
연산터널→연산교차로,2023.5.11 20:00,203,239,48,490,0
교대→연산교차로,2023.5.11 21:00,304,0,269,573,0
부산시청→연산교차로,2023.5.11 21:00,508,343,205,1056,0
사직운동장→연산교차로,2023.5.11 21:00,203,443,41,687,0
신리→연산교차로,2023.5.11 21:00,309,187,26,522,0
안락→연산교차로,2023.5.11 21:00,416,0,101,517,0
연산터널→연산교차로,2023.5.11 21:00,214,259,53,526,0
교대→연산교차로,2023.5.11 22:00,263,0,188,451,0
부산시청→연산교차로,2023.5.11 22:00,433,299,167,899,0
사직운동장→연산교차로,2023.5.11 22:00,205,404,16,625,0
신리→연산교차로,2023.5.11 22:00,241,145,25,411,0
안락→연산교차로,2023.5.11 22:00,358,0,92,450,0
연산터널→연산교차로,2023.5.11 22:00,207,237,44,488,0
교대→연산교차로,2023.5.11 23:00,211,0,137,348,0
부산시청→연산교차로,2023.5.11 23:00,351,201,119,671,0
사직운동장→연산교차로,2023.5.11 23:00,194,321,13,528,0
신리→연산교차로,2023.5.11 23:00,237,142,13,392,0
안락→연산교차로,2023.5.11 23:00,282,0,63,345,0
연산터널→연산교차로,2023.5.11 23:00,137,172,43,352,0
교대→연산교차로,2023.5.12 00:00,157,0,163,320,0
부산시청→연산교차로,2023.5.12 00:00,283,163,111,557,0
사직운동장→연산교차로,2023.5.12 00:00,98,195,7,300,0
신리→연산교차로,2023.5.12 00:00,161,95,24,280,0
안락→연산교차로,2023.5.12 00:00,233,0,58,291,0
연산터널→연산교차로,2023.5.12 00:00,139,181,29,349,0
교대→연산교차로,2023.5.12 01:00,94,0,151,245,0
부산시청→연산교차로,2023.5.12 01:00,228,121,88,437,0
사직운동장→연산교차로,2023.5.12 01:00,68,164,10,242,0
신리→연산교차로,2023.5.12 01:00,105,69,18,192,0
안락→연산교차로,2023.5.12 01:00,162,0,42,204,0
연산터널→연산교차로,2023.5.12 01:00,118,161,46,325,0
교대→연산교차로,2023.5.12 02:00,83,0,120,203,0
부산시청→연산교차로,2023.5.12 02:00,181,97,57,335,0
사직운동장→연산교차로,2023.5.12 02:00,55,139,9,203,0
신리→연산교차로,2023.5.12 02:00,96,42,19,157,0
안락→연산교차로,2023.5.12 02:00,124,0,46,170,0
연산터널→연산교차로,2023.5.12 02:00,97,134,47,278,0
교대→연산교차로,2023.5.12 03:00,69,0,74,143,0
부산시청→연산교차로,2023.5.12 03:00,158,74,61,293,0
사직운동장→연산교차로,2023.5.12 03:00,56,120,3,179,0
신리→연산교차로,2023.5.12 03:00,57,37,12,106,0
안락→연산교차로,2023.5.12 03:00,135,0,22,157,0
연산터널→연산교차로,2023.5.12 03:00,75,112,52,239,0
교대→연산교차로,2023.5.12 04:00,76,0,91,167,0
부산시청→연산교차로,2023.5.12 04:00,142,76,45,263,0
사직운동장→연산교차로,2023.5.12 04:00,34,115,2,151,0
신리→연산교차로,2023.5.12 04:00,101,47,6,154,0
안락→연산교차로,2023.5.12 04:00,166,0,34,200,0
연산터널→연산교차로,2023.5.12 04:00,79,92,23,194,0
교대→연산교차로,2023.5.12 05:00,76,0,99,175,0
부산시청→연산교차로,2023.5.12 05:00,178,99,50,327,0
사직운동장→연산교차로,2023.5.12 05:00,36,129,24,189,0
신리→연산교차로,2023.5.12 05:00,174,67,14,255,0
안락→연산교차로,2023.5.12 05:00,258,0,44,302,0
연산터널→연산교차로,2023.5.12 05:00,102,127,28,257,0
교대→연산교차로,2023.5.12 06:00,188,0,234,422,0
부산시청→연산교차로,2023.5.12 06:00,361,274,104,739,0
사직운동장→연산교차로,2023.5.12 06:00,80,289,50,419,0
신리→연산교차로,2023.5.12 06:00,328,140,24,492,0
안락→연산교차로,2023.5.12 06:00,510,0,81,591,0
연산터널→연산교차로,2023.5.12 06:00,210,234,37,481,0
교대→연산교차로,2023.5.12 07:00,270,0,411,681,0
부산시청→연산교차로,2023.5.12 07:00,536,368,222,1126,0
사직운동장→연산교차로,2023.5.12 07:00,206,496,42,744,0
신리→연산교차로,2023.5.12 07:00,470,273,31,774,0
안락→연산교차로,2023.5.12 07:00,616,0,69,685,0
연산터널→연산교차로,2023.5.12 07:00,268,363,49,680,0
교대→연산교차로,2023.5.12 08:00,308,0,466,774,0
부산시청→연산교차로,2023.5.12 08:00,586,418,330,1334,0
사직운동장→연산교차로,2023.5.12 08:00,196,608,48,852,0
신리→연산교차로,2023.5.12 08:00,521,336,23,880,0
안락→연산교차로,2023.5.12 08:00,622,0,78,700,0
연산터널→연산교차로,2023.5.12 08:00,331,349,32,712,0
교대→연산교차로,2023.5.12 09:00,312,0,507,819,0
부산시청→연산교차로,2023.5.12 09:00,530,385,278,1193,0
사직운동장→연산교차로,2023.5.12 09:00,197,554,61,812,0
신리→연산교차로,2023.5.12 09:00,459,333,32,824,0
안락→연산교차로,2023.5.12 09:00,569,0,99,668,0
연산터널→연산교차로,2023.5.12 09:00,308,340,45,693,0
교대→연산교차로,2023.5.12 10:00,291,0,433,724,0
부산시청→연산교차로,2023.5.12 10:00,558,382,253,1193,0
사직운동장→연산교차로,2023.5.12 10:00,237,530,57,824,0
신리→연산교차로,2023.5.12 10:00,490,271,46,807,0
안락→연산교차로,2023.5.12 10:00,527,0,134,661,0
연산터널→연산교차로,2023.5.12 10:00,287,339,60,686,0
교대→연산교차로,2023.5.12 11:00,283,0,464,747,0
부산시청→연산교차로,2023.5.12 11:00,578,387,269,1234,0
사직운동장→연산교차로,2023.5.12 11:00,240,546,59,845,0
신리→연산교차로,2023.5.12 11:00,457,252,55,764,0
안락→연산교차로,2023.5.12 11:00,524,0,136,660,0
연산터널→연산교차로,2023.5.12 11:00,271,320,49,640,0
교대→연산교차로,2023.5.12 12:00,298,0,362,660,0
부산시청→연산교차로,2023.5.12 12:00,596,357,241,1194,0
사직운동장→연산교차로,2023.5.12 12:00,242,529,60,831,0
신리→연산교차로,2023.5.12 12:00,433,254,37,724,0
안락→연산교차로,2023.5.12 12:00,513,0,106,619,0
연산터널→연산교차로,2023.5.12 12:00,263,287,54,604,0
교대→연산교차로,2023.5.12 13:00,326,0,474,800,0
부산시청→연산교차로,2023.5.12 13:00,560,437,269,1266,0
사직운동장→연산교차로,2023.5.12 13:00,256,567,74,897,0
신리→연산교차로,2023.5.12 13:00,412,268,53,733,0
안락→연산교차로,2023.5.12 13:00,440,0,124,564,0
연산터널→연산교차로,2023.5.12 13:00,248,256,37,541,0
교대→연산교차로,2023.5.12 14:00,336,0,481,817,0
부산시청→연산교차로,2023.5.12 14:00,562,470,276,1308,0
사직운동장→연산교차로,2023.5.12 14:00,230,622,60,912,0
신리→연산교차로,2023.5.12 14:00,440,261,70,771,0
안락→연산교차로,2023.5.12 14:00,416,0,94,510,0
연산터널→연산교차로,2023.5.12 14:00,242,271,44,557,0
교대→연산교차로,2023.5.12 15:00,341,0,445,786,0
부산시청→연산교차로,2023.5.12 15:00,586,478,285,1349,0
사직운동장→연산교차로,2023.5.12 15:00,257,616,65,938,0
신리→연산교차로,2023.5.12 15:00,449,259,51,759,0
안락→연산교차로,2023.5.12 15:00,401,0,92,493,0
연산터널→연산교차로,2023.5.12 15:00,241,277,57,575,0
교대→연산교차로,2023.5.12 16:00,357,0,516,873,0
부산시청→연산교차로,2023.5.12 16:00,604,514,277,1395,0
사직운동장→연산교차로,2023.5.12 16:00,266,631,59,956,0
신리→연산교차로,2023.5.12 16:00,542,273,32,847,0
안락→연산교차로,2023.5.12 16:00,436,0,87,523,0
연산터널→연산교차로,2023.5.12 16:00,237,283,51,571,0
교대→연산교차로,2023.5.12 17:00,366,0,549,915,0
부산시청→연산교차로,2023.5.12 17:00,640,545,297,1482,0
사직운동장→연산교차로,2023.5.12 17:00,278,679,39,996,0
신리→연산교차로,2023.5.12 17:00,546,292,50,888,0
안락→연산교차로,2023.5.12 17:00,469,0,94,563,0
연산터널→연산교차로,2023.5.12 17:00,240,267,34,541,0
교대→연산교차로,2023.5.12 18:00,373,0,506,879,0
부산시청→연산교차로,2023.5.12 18:00,587,562,360,1509,0
사직운동장→연산교차로,2023.5.12 18:00,256,668,49,973,0
신리→연산교차로,2023.5.12 18:00,521,262,38,821,0
안락→연산교차로,2023.5.12 18:00,471,0,81,552,0
연산터널→연산교차로,2023.5.12 18:00,239,282,54,575,0
교대→연산교차로,2023.5.12 19:00,345,0,385,730,0
부산시청→연산교차로,2023.5.12 19:00,577,434,268,1279,0
사직운동장→연산교차로,2023.5.12 19:00,214,528,64,806,0
신리→연산교차로,2023.5.12 19:00,375,197,39,611,0
안락→연산교차로,2023.5.12 19:00,417,0,92,509,0
연산터널→연산교차로,2023.5.12 19:00,219,254,57,530,0
교대→연산교차로,2023.5.12 20:00,330,0,332,662,0
부산시청→연산교차로,2023.5.12 20:00,505,371,237,1113,0
사직운동장→연산교차로,2023.5.12 20:00,201,503,66,770,0
신리→연산교차로,2023.5.12 20:00,325,179,35,539,0
안락→연산교차로,2023.5.12 20:00,397,0,92,489,0
연산터널→연산교차로,2023.5.12 20:00,232,269,63,564,0
교대→연산교차로,2023.5.12 21:00,308,0,298,606,0
부산시청→연산교차로,2023.5.12 21:00,525,356,235,1116,0
사직운동장→연산교차로,2023.5.12 21:00,208,483,45,736,0
신리→연산교차로,2023.5.12 21:00,337,210,24,571,0
안락→연산교차로,2023.5.12 21:00,449,0,114,563,0
연산터널→연산교차로,2023.5.12 21:00,242,250,52,544,0
교대→연산교차로,2023.5.12 22:00,273,0,249,522,0
부산시청→연산교차로,2023.5.12 22:00,476,338,190,1004,0
사직운동장→연산교차로,2023.5.12 22:00,142,396,41,579,0
신리→연산교차로,2023.5.12 22:00,330,209,24,563,0
안락→연산교차로,2023.5.12 22:00,427,0,99,526,0
연산터널→연산교차로,2023.5.12 22:00,212,263,43,518,0
교대→연산교차로,2023.5.12 23:00,227,0,177,404,0
부산시청→연산교차로,2023.5.12 23:00,398,228,126,752,0
사직운동장→연산교차로,2023.5.12 23:00,160,304,9,473,0
신리→연산교차로,2023.5.12 23:00,244,161,26,431,0
안락→연산교차로,2023.5.12 23:00,340,0,83,423,0
연산터널→연산교차로,2023.5.12 23:00,144,191,44,379,0
교대→연산교차로,2023.5.13 00:00,206,0,192,398,0
부산시청→연산교차로,2023.5.13 00:00,293,214,118,625,0
사직운동장→연산교차로,2023.5.13 00:00,112,257,12,381,0
신리→연산교차로,2023.5.13 00:00,210,121,13,344,0
안락→연산교차로,2023.5.13 00:00,278,0,76,354,0
연산터널→연산교차로,2023.5.13 00:00,140,188,27,355,0
교대→연산교차로,2023.5.13 01:00,161,0,181,342,0
부산시청→연산교차로,2023.5.13 01:00,262,182,92,536,0
사직운동장→연산교차로,2023.5.13 01:00,101,202,9,312,0
신리→연산교차로,2023.5.13 01:00,190,98,22,310,0
안락→연산교차로,2023.5.13 01:00,227,0,30,257,0
연산터널→연산교차로,2023.5.13 01:00,124,163,28,315,0
교대→연산교차로,2023.5.13 02:00,131,0,170,301,0
부산시청→연산교차로,2023.5.13 02:00,208,147,68,423,0
사직운동장→연산교차로,2023.5.13 02:00,54,155,6,215,0
신리→연산교차로,2023.5.13 02:00,135,67,18,220,0
안락→연산교차로,2023.5.13 02:00,175,0,71,246,0
연산터널→연산교차로,2023.5.13 02:00,113,139,33,285,0
교대→연산교차로,2023.5.13 03:00,93,0,143,236,0
부산시청→연산교차로,2023.5.13 03:00,202,103,80,385,0
사직운동장→연산교차로,2023.5.13 03:00,62,158,2,222,0
신리→연산교차로,2023.5.13 03:00,86,68,11,165,0
안락→연산교차로,2023.5.13 03:00,125,0,46,171,0
연산터널→연산교차로,2023.5.13 03:00,86,128,23,237,0
교대→연산교차로,2023.5.13 04:00,71,0,104,175,0
부산시청→연산교차로,2023.5.13 04:00,167,103,57,327,0
사직운동장→연산교차로,2023.5.13 04:00,31,104,6,141,0
신리→연산교차로,2023.5.13 04:00,79,59,10,148,0
안락→연산교차로,2023.5.13 04:00,184,0,39,223,0
연산터널→연산교차로,2023.5.13 04:00,76,106,13,195,0
교대→연산교차로,2023.5.13 05:00,89,0,112,201,0
부산시청→연산교차로,2023.5.13 05:00,198,139,72,409,0
사직운동장→연산교차로,2023.5.13 05:00,46,134,33,213,0
신리→연산교차로,2023.5.13 05:00,164,60,4,228,0
안락→연산교차로,2023.5.13 05:00,261,0,37,298,0
연산터널→연산교차로,2023.5.13 05:00,112,113,18,243,0
교대→연산교차로,2023.5.13 06:00,149,0,168,317,0
부산시청→연산교차로,2023.5.13 06:00,291,228,80,599,0
사직운동장→연산교차로,2023.5.13 06:00,101,216,32,349,0
신리→연산교차로,2023.5.13 06:00,230,114,19,363,0
안락→연산교차로,2023.5.13 06:00,352,0,59,411,0
연산터널→연산교차로,2023.5.13 06:00,181,162,27,370,0
교대→연산교차로,2023.5.13 07:00,169,0,205,374,0
부산시청→연산교차로,2023.5.13 07:00,384,261,125,770,0
사직운동장→연산교차로,2023.5.13 07:00,120,296,29,445,0
신리→연산교차로,2023.5.13 07:00,314,154,18,486,0
안락→연산교차로,2023.5.13 07:00,431,0,95,526,0
연산터널→연산교차로,2023.5.13 07:00,177,196,41,414,0
교대→연산교차로,2023.5.13 08:00,272,0,370,642,0
부산시청→연산교차로,2023.5.13 08:00,486,352,235,1073,0
사직운동장→연산교차로,2023.5.13 08:00,209,535,40,784,0
신리→연산교차로,2023.5.13 08:00,438,263,39,740,0
안락→연산교차로,2023.5.13 08:00,502,0,103,605,0
연산터널→연산교차로,2023.5.13 08:00,287,306,33,626,0
교대→연산교차로,2023.5.13 09:00,284,0,377,661,0
부산시청→연산교차로,2023.5.13 09:00,507,353,254,1114,0
사직운동장→연산교차로,2023.5.13 09:00,203,589,58,850,0
신리→연산교차로,2023.5.13 09:00,461,299,51,811,0
안락→연산교차로,2023.5.13 09:00,560,0,117,677,0
연산터널→연산교차로,2023.5.13 09:00,332,327,51,710,0
교대→연산교차로,2023.5.13 10:00,284,0,404,688,0
부산시청→연산교차로,2023.5.13 10:00,577,388,247,1212,0
사직운동장→연산교차로,2023.5.13 10:00,215,584,41,840,0
신리→연산교차로,2023.5.13 10:00,478,293,69,840,0
안락→연산교차로,2023.5.13 10:00,544,0,128,672,0
연산터널→연산교차로,2023.5.13 10:00,265,345,58,668,0
교대→연산교차로,2023.5.13 11:00,301,0,485,786,0
부산시청→연산교차로,2023.5.13 11:00,560,390,293,1243,0
사직운동장→연산교차로,2023.5.13 11:00,229,590,65,884,0
신리→연산교차로,2023.5.13 11:00,472,305,67,844,0
안락→연산교차로,2023.5.13 11:00,579,0,136,715,0
연산터널→연산교차로,2023.5.13 11:00,301,322,64,687,0
교대→연산교차로,2023.5.13 12:00,291,0,454,745,0
부산시청→연산교차로,2023.5.13 12:00,599,375,246,1220,0
사직운동장→연산교차로,2023.5.13 12:00,214,592,39,845,0
신리→연산교차로,2023.5.13 12:00,476,302,71,849,0
안락→연산교차로,2023.5.13 12:00,587,0,117,704,0
연산터널→연산교차로,2023.5.13 12:00,319,344,56,719,0
교대→연산교차로,2023.5.13 13:00,349,0,478,827,0
부산시청→연산교차로,2023.5.13 13:00,622,466,305,1393,0
사직운동장→연산교차로,2023.5.13 13:00,260,637,27,924,0
신리→연산교차로,2023.5.13 13:00,444,301,52,797,0
안락→연산교차로,2023.5.13 13:00,488,0,91,579,0
연산터널→연산교차로,2023.5.13 13:00,241,295,41,577,0
교대→연산교차로,2023.5.13 14:00,342,0,469,811,0
부산시청→연산교차로,2023.5.13 14:00,633,457,325,1415,0
사직운동장→연산교차로,2023.5.13 14:00,239,600,57,896,0
신리→연산교차로,2023.5.13 14:00,391,311,64,766,0
안락→연산교차로,2023.5.13 14:00,462,0,90,552,0
연산터널→연산교차로,2023.5.13 14:00,236,276,50,562,0
교대→연산교차로,2023.5.13 15:00,350,0,434,784,0
부산시청→연산교차로,2023.5.13 15:00,645,523,286,1454,0
사직운동장→연산교차로,2023.5.13 15:00,248,644,46,938,0
신리→연산교차로,2023.5.13 15:00,459,256,50,765,0
안락→연산교차로,2023.5.13 15:00,436,0,96,532,0
연산터널→연산교차로,2023.5.13 15:00,230,284,36,550,0
교대→연산교차로,2023.5.13 16:00,342,0,378,720,0
부산시청→연산교차로,2023.5.13 16:00,613,467,293,1373,0
사직운동장→연산교차로,2023.5.13 16:00,215,657,49,921,0
신리→연산교차로,2023.5.13 16:00,456,262,43,761,0
안락→연산교차로,2023.5.13 16:00,456,0,108,564,0
연산터널→연산교차로,2023.5.13 16:00,255,270,51,576,0
교대→연산교차로,2023.5.13 17:00,358,0,382,740,0
부산시청→연산교차로,2023.5.13 17:00,612,461,289,1362,0
사직운동장→연산교차로,2023.5.13 17:00,245,617,42,904,0
신리→연산교차로,2023.5.13 17:00,436,246,41,723,0
안락→연산교차로,2023.5.13 17:00,477,0,119,596,0
연산터널→연산교차로,2023.5.13 17:00,228,284,56,568,0
교대→연산교차로,2023.5.13 18:00,350,0,347,697,0
부산시청→연산교차로,2023.5.13 18:00,509,402,212,1123,0
사직운동장→연산교차로,2023.5.13 18:00,210,514,61,785,0
신리→연산교차로,2023.5.13 18:00,374,246,27,647,0
안락→연산교차로,2023.5.13 18:00,459,0,94,553,0
연산터널→연산교차로,2023.5.13 18:00,216,282,56,554,0
교대→연산교차로,2023.5.13 19:00,317,0,295,612,0
부산시청→연산교차로,2023.5.13 19:00,482,347,211,1040,0
사직운동장→연산교차로,2023.5.13 19:00,182,495,54,731,0
신리→연산교차로,2023.5.13 19:00,318,187,44,549,0
안락→연산교차로,2023.5.13 19:00,398,0,93,491,0
연산터널→연산교차로,2023.5.13 19:00,213,265,56,534,0
교대→연산교차로,2023.5.13 20:00,308,0,252,560,0
부산시청→연산교차로,2023.5.13 20:00,457,332,204,993,0
사직운동장→연산교차로,2023.5.13 20:00,196,440,31,667,0
신리→연산교차로,2023.5.13 20:00,358,177,37,572,0
안락→연산교차로,2023.5.13 20:00,433,0,79,512,0
연산터널→연산교차로,2023.5.13 20:00,211,233,54,498,0
교대→연산교차로,2023.5.13 21:00,260,0,265,525,0
부산시청→연산교차로,2023.5.13 21:00,515,353,195,1063,0
사직운동장→연산교차로,2023.5.13 21:00,152,401,44,597,0
신리→연산교차로,2023.5.13 21:00,299,183,22,504,0
안락→연산교차로,2023.5.13 21:00,404,0,97,501,0
연산터널→연산교차로,2023.5.13 21:00,210,256,69,535,0
교대→연산교차로,2023.5.13 22:00,230,0,239,469,0
부산시청→연산교차로,2023.5.13 22:00,433,286,160,879,0
사직운동장→연산교차로,2023.5.13 22:00,152,357,41,550,0
신리→연산교차로,2023.5.13 22:00,280,129,25,434,0
안락→연산교차로,2023.5.13 22:00,363,0,100,463,0
연산터널→연산교차로,2023.5.13 22:00,226,239,45,510,0
교대→연산교차로,2023.5.13 23:00,223,0,176,399,0
부산시청→연산교차로,2023.5.13 23:00,362,213,130,705,0
사직운동장→연산교차로,2023.5.13 23:00,115,267,20,402,0
신리→연산교차로,2023.5.13 23:00,221,128,15,364,0
안락→연산교차로,2023.5.13 23:00,311,0,66,377,0
연산터널→연산교차로,2023.5.13 23:00,157,185,51,393,0
교대→연산교차로,2023.5.14 00:00,170,0,180,350,1
부산시청→연산교차로,2023.5.14 00:00,347,197,129,673,1
사직운동장→연산교차로,2023.5.14 00:00,84,234,8,326,1
신리→연산교차로,2023.5.14 00:00,224,117,24,365,1
안락→연산교차로,2023.5.14 00:00,270,0,58,328,1
연산터널→연산교차로,2023.5.14 00:00,132,179,33,344,1
교대→연산교차로,2023.5.14 01:00,148,0,189,337,1
부산시청→연산교차로,2023.5.14 01:00,256,170,98,524,1
사직운동장→연산교차로,2023.5.14 01:00,83,193,5,281,1
신리→연산교차로,2023.5.14 01:00,170,97,10,277,1
안락→연산교차로,2023.5.14 01:00,219,0,54,273,1
연산터널→연산교차로,2023.5.14 01:00,115,178,25,318,1
교대→연산교차로,2023.5.14 02:00,111,0,182,293,1
부산시청→연산교차로,2023.5.14 02:00,257,130,88,475,1
사직운동장→연산교차로,2023.5.14 02:00,71,181,5,257,1
신리→연산교차로,2023.5.14 02:00,150,82,12,244,1
안락→연산교차로,2023.5.14 02:00,188,0,51,239,1
연산터널→연산교차로,2023.5.14 02:00,106,122,42,270,1
교대→연산교차로,2023.5.14 03:00,94,0,142,236,1
부산시청→연산교차로,2023.5.14 03:00,201,119,85,405,1
사직운동장→연산교차로,2023.5.14 03:00,43,141,6,190,1
신리→연산교차로,2023.5.14 03:00,119,64,8,191,1
안락→연산교차로,2023.5.14 03:00,159,0,42,201,1
연산터널→연산교차로,2023.5.14 03:00,93,131,25,249,1
교대→연산교차로,2023.5.14 04:00,79,0,108,187,1
부산시청→연산교차로,2023.5.14 04:00,145,93,60,298,1
사직운동장→연산교차로,2023.5.14 04:00,40,125,4,169,1
신리→연산교차로,2023.5.14 04:00,85,51,8,144,1
안락→연산교차로,2023.5.14 04:00,113,0,29,142,1
연산터널→연산교차로,2023.5.14 04:00,74,110,23,207,1
교대→연산교차로,2023.5.14 05:00,72,0,104,176,1
부산시청→연산교차로,2023.5.14 05:00,161,95,77,333,1
사직운동장→연산교차로,2023.5.14 05:00,56,106,31,193,1
신리→연산교차로,2023.5.14 05:00,131,49,6,186,1
안락→연산교차로,2023.5.14 05:00,194,0,30,224,1
연산터널→연산교차로,2023.5.14 05:00,104,96,20,220,1
교대→연산교차로,2023.5.14 06:00,84,0,87,171,1
부산시청→연산교차로,2023.5.14 06:00,155,127,52,334,1
사직운동장→연산교차로,2023.5.14 06:00,40,124,15,179,1
신리→연산교차로,2023.5.14 06:00,150,69,5,224,1
안락→연산교차로,2023.5.14 06:00,188,0,34,222,1
연산터널→연산교차로,2023.5.14 06:00,101,75,33,209,1
교대→연산교차로,2023.5.14 07:00,137,0,164,301,1
부산시청→연산교차로,2023.5.14 07:00,251,183,97,531,1
사직운동장→연산교차로,2023.5.14 07:00,84,205,28,317,1
신리→연산교차로,2023.5.14 07:00,224,98,19,341,1
안락→연산교차로,2023.5.14 07:00,261,0,51,312,1
연산터널→연산교차로,2023.5.14 07:00,142,131,32,305,1
교대→연산교차로,2023.5.14 08:00,159,0,154,313,1
부산시청→연산교차로,2023.5.14 08:00,283,230,112,625,1
사직운동장→연산교차로,2023.5.14 08:00,126,289,36,451,1
신리→연산교차로,2023.5.14 08:00,266,153,17,436,1
안락→연산교차로,2023.5.14 08:00,340,0,66,406,1
연산터널→연산교차로,2023.5.14 08:00,190,159,28,377,1
교대→연산교차로,2023.5.14 09:00,229,0,244,473,1
부산시청→연산교차로,2023.5.14 09:00,449,310,152,911,1
사직운동장→연산교차로,2023.5.14 09:00,146,381,36,563,1
신리→연산교차로,2023.5.14 09:00,365,229,19,613,1
안락→연산교차로,2023.5.14 09:00,445,0,87,532,1
연산터널→연산교차로,2023.5.14 09:00,243,231,36,510,1
교대→연산교차로,2023.5.14 10:00,267,0,309,576,1
부산시청→연산교차로,2023.5.14 10:00,452,349,168,969,1
사직운동장→연산교차로,2023.5.14 10:00,187,533,45,765,1
신리→연산교차로,2023.5.14 10:00,474,226,26,726,1
안락→연산교차로,2023.5.14 10:00,494,0,93,587,1
연산터널→연산교차로,2023.5.14 10:00,262,253,45,560,1
교대→연산교차로,2023.5.14 11:00,278,0,328,606,1
부산시청→연산교차로,2023.5.14 11:00,520,380,180,1080,1
사직운동장→연산교차로,2023.5.14 11:00,168,512,52,732,1
신리→연산교차로,2023.5.14 11:00,495,221,38,754,1
안락→연산교차로,2023.5.14 11:00,521,0,126,647,1
연산터널→연산교차로,2023.5.14 11:00,240,212,47,499,1
교대→연산교차로,2023.5.14 12:00,280,0,357,637,1
부산시청→연산교차로,2023.5.14 12:00,546,368,188,1102,1
사직운동장→연산교차로,2023.5.14 12:00,216,575,61,852,1
신리→연산교차로,2023.5.14 12:00,480,226,31,737,1
안락→연산교차로,2023.5.14 12:00,522,0,132,654,1
연산터널→연산교차로,2023.5.14 12:00,238,262,47,547,1
교대→연산교차로,2023.5.14 13:00,304,0,355,659,1
부산시청→연산교차로,2023.5.14 13:00,558,355,198,1111,1
사직운동장→연산교차로,2023.5.14 13:00,246,503,45,794,1
신리→연산교차로,2023.5.14 13:00,385,246,36,667,1
안락→연산교차로,2023.5.14 13:00,534,0,116,650,1
연산터널→연산교차로,2023.5.14 13:00,232,246,61,539,1
교대→연산교차로,2023.5.14 14:00,308,0,307,615,1
부산시청→연산교차로,2023.5.14 14:00,562,397,195,1154,1
사직운동장→연산교차로,2023.5.14 14:00,192,546,49,787,1
신리→연산교차로,2023.5.14 14:00,393,200,35,628,1
안락→연산교차로,2023.5.14 14:00,563,0,123,686,1
연산터널→연산교차로,2023.5.14 14:00,220,254,45,519,1
교대→연산교차로,2023.5.14 15:00,301,0,305,606,1
부산시청→연산교차로,2023.5.14 15:00,540,331,183,1054,1
사직운동장→연산교차로,2023.5.14 15:00,204,527,42,773,1
신리→연산교차로,2023.5.14 15:00,379,192,28,599,1
안락→연산교차로,2023.5.14 15:00,548,0,120,668,1
연산터널→연산교차로,2023.5.14 15:00,232,210,26,468,1
교대→연산교차로,2023.5.14 16:00,312,0,320,632,1
부산시청→연산교차로,2023.5.14 16:00,520,345,198,1063,1
사직운동장→연산교차로,2023.5.14 16:00,194,502,60,756,1
신리→연산교차로,2023.5.14 16:00,384,206,34,624,1
안락→연산교차로,2023.5.14 16:00,546,0,139,685,1
연산터널→연산교차로,2023.5.14 16:00,229,254,51,534,1
교대→연산교차로,2023.5.14 17:00,313,0,329,642,1
부산시청→연산교차로,2023.5.14 17:00,492,336,201,1029,1
사직운동장→연산교차로,2023.5.14 17:00,209,495,61,765,1
신리→연산교차로,2023.5.14 17:00,396,181,32,609,1
안락→연산교차로,2023.5.14 17:00,571,0,117,688,1
연산터널→연산교차로,2023.5.14 17:00,222,252,47,521,1
교대→연산교차로,2023.5.14 18:00,276,0,290,566,1
부산시청→연산교차로,2023.5.14 18:00,515,302,189,1006,1
사직운동장→연산교차로,2023.5.14 18:00,189,469,54,712,1
신리→연산교차로,2023.5.14 18:00,415,190,40,645,1
안락→연산교차로,2023.5.14 18:00,559,0,114,673,1
연산터널→연산교차로,2023.5.14 18:00,212,254,71,537,1
교대→연산교차로,2023.5.14 19:00,275,0,263,538,1
부산시청→연산교차로,2023.5.14 19:00,441,276,167,884,1
사직운동장→연산교차로,2023.5.14 19:00,168,398,52,618,1
신리→연산교차로,2023.5.14 19:00,313,159,33,505,1
안락→연산교차로,2023.5.14 19:00,463,0,86,549,1
연산터널→연산교차로,2023.5.14 19:00,199,252,53,504,1
교대→연산교차로,2023.5.14 20:00,276,0,245,521,1
부산시청→연산교차로,2023.5.14 20:00,394,281,180,855,1
사직운동장→연산교차로,2023.5.14 20:00,169,403,37,609,1
신리→연산교차로,2023.5.14 20:00,298,140,22,460,1
안락→연산교차로,2023.5.14 20:00,410,0,108,518,1
연산터널→연산교차로,2023.5.14 20:00,191,207,43,441,1
교대→연산교차로,2023.5.14 21:00,255,0,197,452,1
부산시청→연산교차로,2023.5.14 21:00,346,297,153,796,1
사직운동장→연산교차로,2023.5.14 21:00,140,336,33,509,1
신리→연산교차로,2023.5.14 21:00,285,160,16,461,1
안락→연산교차로,2023.5.14 21:00,356,0,90,446,1
연산터널→연산교차로,2023.5.14 21:00,196,150,28,374,1
교대→연산교차로,2023.5.14 22:00,211,0,175,386,1
부산시청→연산교차로,2023.5.14 22:00,349,218,129,696,1
사직운동장→연산교차로,2023.5.14 22:00,108,277,26,411,1
신리→연산교차로,2023.5.14 22:00,261,117,23,401,1
안락→연산교차로,2023.5.14 22:00,311,0,75,386,1
연산터널→연산교차로,2023.5.14 22:00,129,168,44,341,1
교대→연산교차로,2023.5.14 23:00,135,0,133,268,1
부산시청→연산교차로,2023.5.14 23:00,271,161,88,520,1
사직운동장→연산교차로,2023.5.14 23:00,86,229,12,327,1
신리→연산교차로,2023.5.14 23:00,201,95,10,306,1
안락→연산교차로,2023.5.14 23:00,239,0,42,281,1
연산터널→연산교차로,2023.5.14 23:00,106,152,37,295,1
교대→연산교차로,2023.5.15 00:00,94,0,153,247,0
부산시청→연산교차로,2023.5.15 00:00,214,143,85,442,0
사직운동장→연산교차로,2023.5.15 00:00,79,208,8,295,0
신리→연산교차로,2023.5.15 00:00,143,86,22,251,0
안락→연산교차로,2023.5.15 00:00,159,0,31,190,0
연산터널→연산교차로,2023.5.15 00:00,99,147,45,291,0
교대→연산교차로,2023.5.15 01:00,92,0,94,186,0
부산시청→연산교차로,2023.5.15 01:00,171,87,62,320,0
사직운동장→연산교차로,2023.5.15 01:00,53,116,3,172,0
신리→연산교차로,2023.5.15 01:00,90,45,16,151,0
안락→연산교차로,2023.5.15 01:00,137,0,33,170,0
연산터널→연산교차로,2023.5.15 01:00,74,97,51,222,0
교대→연산교차로,2023.5.15 02:00,51,0,79,130,0
부산시청→연산교차로,2023.5.15 02:00,131,62,63,256,0
사직운동장→연산교차로,2023.5.15 02:00,39,94,3,136,0
신리→연산교차로,2023.5.15 02:00,78,32,11,121,0
안락→연산교차로,2023.5.15 02:00,125,0,25,150,0
연산터널→연산교차로,2023.5.15 02:00,65,100,37,202,0
교대→연산교차로,2023.5.15 03:00,47,0,64,111,0
부산시청→연산교차로,2023.5.15 03:00,137,69,47,253,0
사직운동장→연산교차로,2023.5.15 03:00,27,102,2,131,0
신리→연산교차로,2023.5.15 03:00,57,28,5,90,0
안락→연산교차로,2023.5.15 03:00,100,0,19,119,0
연산터널→연산교차로,2023.5.15 03:00,58,83,33,174,0
교대→연산교차로,2023.5.15 04:00,52,0,66,118,0
부산시청→연산교차로,2023.5.15 04:00,154,59,36,249,0
사직운동장→연산교차로,2023.5.15 04:00,20,87,2,109,0
신리→연산교차로,2023.5.15 04:00,86,46,6,138,0
안락→연산교차로,2023.5.15 04:00,164,0,28,192,0
연산터널→연산교차로,2023.5.15 04:00,68,90,16,174,0
교대→연산교차로,2023.5.15 05:00,94,0,125,219,0
부산시청→연산교차로,2023.5.15 05:00,243,170,69,482,0
사직운동장→연산교차로,2023.5.15 05:00,66,153,28,247,0
신리→연산교차로,2023.5.15 05:00,244,91,4,339,0
안락→연산교차로,2023.5.15 05:00,350,0,60,410,0
연산터널→연산교차로,2023.5.15 05:00,142,149,27,318,0
교대→연산교차로,2023.5.15 06:00,150,0,192,342,0
부산시청→연산교차로,2023.5.15 06:00,312,208,88,608,0
사직운동장→연산교차로,2023.5.15 06:00,56,211,15,282,0
신리→연산교차로,2023.5.15 06:00,265,122,12,399,0
안락→연산교차로,2023.5.15 06:00,449,0,58,507,0
연산터널→연산교차로,2023.5.15 06:00,171,193,26,390,0
교대→연산교차로,2023.5.15 07:00,252,0,428,680,0
부산시청→연산교차로,2023.5.15 07:00,572,404,238,1214,0
사직운동장→연산교차로,2023.5.15 07:00,200,482,30,712,0
신리→연산교차로,2023.5.15 07:00,510,266,29,805,0
안락→연산교차로,2023.5.15 07:00,618,0,80,698,0
연산터널→연산교차로,2023.5.15 07:00,281,369,38,688,0
교대→연산교차로,2023.5.15 08:00,322,0,499,821,0
부산시청→연산교차로,2023.5.15 08:00,574,430,318,1322,0
사직운동장→연산교차로,2023.5.15 08:00,199,630,53,882,0
신리→연산교차로,2023.5.15 08:00,490,346,22,858,0
안락→연산교차로,2023.5.15 08:00,622,0,87,709,0
연산터널→연산교차로,2023.5.15 08:00,312,377,33,722,0
교대→연산교차로,2023.5.15 09:00,292,0,531,823,0
부산시청→연산교차로,2023.5.15 09:00,479,359,286,1124,0
사직운동장→연산교차로,2023.5.15 09:00,219,531,52,802,0
신리→연산교차로,2023.5.15 09:00,445,321,48,814,0
안락→연산교차로,2023.5.15 09:00,584,0,104,688,0
연산터널→연산교차로,2023.5.15 09:00,297,360,49,706,0
교대→연산교차로,2023.5.15 10:00,285,0,445,730,0
부산시청→연산교차로,2023.5.15 10:00,544,353,224,1121,0
사직운동장→연산교차로,2023.5.15 10:00,217,552,58,827,0
신리→연산교차로,2023.5.15 10:00,454,272,48,774,0
안락→연산교차로,2023.5.15 10:00,539,0,137,676,0
연산터널→연산교차로,2023.5.15 10:00,311,340,44,695,0
교대→연산교차로,2023.5.15 11:00,292,0,431,723,0
부산시청→연산교차로,2023.5.15 11:00,590,392,257,1239,0
사직운동장→연산교차로,2023.5.15 11:00,244,542,59,845,0
신리→연산교차로,2023.5.15 11:00,423,267,58,748,0
안락→연산교차로,2023.5.15 11:00,507,0,129,636,0
연산터널→연산교차로,2023.5.15 11:00,262,283,59,604,0
교대→연산교차로,2023.5.15 12:00,287,0,427,714,0
부산시청→연산교차로,2023.5.15 12:00,527,362,239,1128,0
사직운동장→연산교차로,2023.5.15 12:00,187,526,56,769,0
신리→연산교차로,2023.5.15 12:00,382,229,55,666,0
안락→연산교차로,2023.5.15 12:00,509,0,131,640,0
연산터널→연산교차로,2023.5.15 12:00,253,282,58,593,0
교대→연산교차로,2023.5.15 13:00,316,0,416,732,0
부산시청→연산교차로,2023.5.15 13:00,548,450,246,1244,0
사직운동장→연산교차로,2023.5.15 13:00,266,562,49,877,0
신리→연산교차로,2023.5.15 13:00,442,242,44,728,0
안락→연산교차로,2023.5.15 13:00,415,0,109,524,0
연산터널→연산교차로,2023.5.15 13:00,228,274,40,542,0
교대→연산교차로,2023.5.15 14:00,318,0,492,810,0
부산시청→연산교차로,2023.5.15 14:00,541,436,300,1277,0
사직운동장→연산교차로,2023.5.15 14:00,254,542,48,844,0
신리→연산교차로,2023.5.15 14:00,487,282,44,813,0
안락→연산교차로,2023.5.15 14:00,393,0,121,514,0
연산터널→연산교차로,2023.5.15 14:00,238,266,38,542,0
교대→연산교차로,2023.5.15 15:00,339,0,500,839,0
부산시청→연산교차로,2023.5.15 15:00,604,502,306,1412,0
사직운동장→연산교차로,2023.5.15 15:00,241,591,67,899,0
신리→연산교차로,2023.5.15 15:00,455,290,51,796,0
안락→연산교차로,2023.5.15 15:00,452,0,89,541,0
연산터널→연산교차로,2023.5.15 15:00,244,271,59,574,0
교대→연산교차로,2023.5.15 16:00,363,0,465,828,0
부산시청→연산교차로,2023.5.15 16:00,617,496,287,1400,0
사직운동장→연산교차로,2023.5.15 16:00,233,662,80,975,0
신리→연산교차로,2023.5.15 16:00,497,293,39,829,0
안락→연산교차로,2023.5.15 16:00,445,0,88,533,0
연산터널→연산교차로,2023.5.15 16:00,227,268,44,539,0
교대→연산교차로,2023.5.15 17:00,364,0,541,905,0
부산시청→연산교차로,2023.5.15 17:00,623,549,305,1477,0
사직운동장→연산교차로,2023.5.15 17:00,244,690,46,980,0
신리→연산교차로,2023.5.15 17:00,479,284,39,802,0
안락→연산교차로,2023.5.15 17:00,449,0,97,546,0
연산터널→연산교차로,2023.5.15 17:00,213,280,42,535,0
교대→연산교차로,2023.5.15 18:00,346,0,554,900,0
부산시청→연산교차로,2023.5.15 18:00,617,561,368,1546,0
사직운동장→연산교차로,2023.5.15 18:00,242,688,62,992,0
신리→연산교차로,2023.5.15 18:00,502,246,42,790,0
안락→연산교차로,2023.5.15 18:00,459,0,101,560,0
연산터널→연산교차로,2023.5.15 18:00,210,279,52,541,0
교대→연산교차로,2023.5.15 19:00,326,0,388,714,0
부산시청→연산교차로,2023.5.15 19:00,515,416,266,1197,0
사직운동장→연산교차로,2023.5.15 19:00,170,535,66,771,0
신리→연산교차로,2023.5.15 19:00,355,193,31,579,0
안락→연산교차로,2023.5.15 19:00,398,0,97,495,0
연산터널→연산교차로,2023.5.15 19:00,194,249,52,495,0
교대→연산교차로,2023.5.15 20:00,314,0,285,599,0
부산시청→연산교차로,2023.5.15 20:00,507,313,216,1036,0
사직운동장→연산교차로,2023.5.15 20:00,176,447,44,667,0
신리→연산교차로,2023.5.15 20:00,332,188,26,546,0
안락→연산교차로,2023.5.15 20:00,403,0,93,496,0
연산터널→연산교차로,2023.5.15 20:00,195,235,70,500,0
교대→연산교차로,2023.5.15 21:00,268,0,258,526,0
부산시청→연산교차로,2023.5.15 21:00,493,325,204,1022,0
사직운동장→연산교차로,2023.5.15 21:00,179,411,56,646,0
신리→연산교차로,2023.5.15 21:00,298,167,31,496,0
안락→연산교차로,2023.5.15 21:00,425,0,87,512,0
연산터널→연산교차로,2023.5.15 21:00,211,249,52,512,0
교대→연산교차로,2023.5.15 22:00,237,0,200,437,0
부산시청→연산교차로,2023.5.15 22:00,395,236,146,777,0
사직운동장→연산교차로,2023.5.15 22:00,142,318,30,490,0
신리→연산교차로,2023.5.15 22:00,234,121,22,377,0
안락→연산교차로,2023.5.15 22:00,360,0,87,447,0
연산터널→연산교차로,2023.5.15 22:00,190,212,51,453,0
교대→연산교차로,2023.5.15 23:00,169,0,170,339,0
부산시청→연산교차로,2023.5.15 23:00,305,180,111,596,0
사직운동장→연산교차로,2023.5.15 23:00,116,264,28,408,0
신리→연산교차로,2023.5.15 23:00,169,114,17,300,0
안락→연산교차로,2023.5.15 23:00,239,0,63,302,0
연산터널→연산교차로,2023.5.15 23:00,136,182,48,366,0
교대→연산교차로,2023.5.16 00:00,122,0,162,284,0
부산시청→연산교차로,2023.5.16 00:00,243,132,112,487,0
사직운동장→연산교차로,2023.5.16 00:00,92,201,8,301,0
신리→연산교차로,2023.5.16 00:00,150,83,17,250,0
안락→연산교차로,2023.5.16 00:00,197,0,46,243,0
연산터널→연산교차로,2023.5.16 00:00,142,158,65,365,0
교대→연산교차로,2023.5.16 01:00,99,0,156,255,0
부산시청→연산교차로,2023.5.16 01:00,173,103,69,345,0
사직운동장→연산교차로,2023.5.16 01:00,62,179,7,248,0
신리→연산교차로,2023.5.16 01:00,82,65,7,154,0
안락→연산교차로,2023.5.16 01:00,168,0,37,205,0
연산터널→연산교차로,2023.5.16 01:00,110,114,50,274,0
교대→연산교차로,2023.5.16 02:00,65,0,114,179,0
부산시청→연산교차로,2023.5.16 02:00,159,92,57,308,0
사직운동장→연산교차로,2023.5.16 02:00,51,140,4,195,0
신리→연산교차로,2023.5.16 02:00,89,44,20,153,0
안락→연산교차로,2023.5.16 02:00,123,0,38,161,0
연산터널→연산교차로,2023.5.16 02:00,111,104,35,250,0
교대→연산교차로,2023.5.16 03:00,55,0,70,125,0
부산시청→연산교차로,2023.5.16 03:00,137,75,38,250,0
사직운동장→연산교차로,2023.5.16 03:00,36,120,2,158,0
신리→연산교차로,2023.5.16 03:00,71,34,6,111,0
안락→연산교차로,2023.5.16 03:00,104,0,29,133,0
연산터널→연산교차로,2023.5.16 03:00,83,87,39,209,0
교대→연산교차로,2023.5.16 04:00,49,0,64,113,0
부산시청→연산교차로,2023.5.16 04:00,159,73,37,269,0
사직운동장→연산교차로,2023.5.16 04:00,28,109,2,139,0
신리→연산교차로,2023.5.16 04:00,88,36,5,129,0
안락→연산교차로,2023.5.16 04:00,173,0,38,211,0
연산터널→연산교차로,2023.5.16 04:00,87,85,48,220,0
교대→연산교차로,2023.5.16 05:00,74,0,94,168,0
부산시청→연산교차로,2023.5.16 05:00,169,104,48,321,0
사직운동장→연산교차로,2023.5.16 05:00,43,114,27,184,0
신리→연산교차로,2023.5.16 05:00,160,78,10,248,0
안락→연산교차로,2023.5.16 05:00,245,0,34,279,0
연산터널→연산교차로,2023.5.16 05:00,101,111,24,236,0
교대→연산교차로,2023.5.16 06:00,182,0,240,422,0
부산시청→연산교차로,2023.5.16 06:00,393,253,127,773,0
사직운동장→연산교차로,2023.5.16 06:00,117,307,28,452,0
신리→연산교차로,2023.5.16 06:00,342,166,19,527,0
안락→연산교차로,2023.5.16 06:00,531,0,76,607,0
연산터널→연산교차로,2023.5.16 06:00,237,240,35,512,0
교대→연산교차로,2023.5.16 07:00,244,0,384,628,0
부산시청→연산교차로,2023.5.16 07:00,547,378,223,1148,0
사직운동장→연산교차로,2023.5.16 07:00,191,467,36,694,0
신리→연산교차로,2023.5.16 07:00,486,265,23,774,0
안락→연산교차로,2023.5.16 07:00,629,0,81,710,0
연산터널→연산교차로,2023.5.16 07:00,285,382,50,717,0
교대→연산교차로,2023.5.16 08:00,313,0,506,819,0
부산시청→연산교차로,2023.5.16 08:00,579,400,369,1348,0
사직운동장→연산교차로,2023.5.16 08:00,203,647,46,896,0
신리→연산교차로,2023.5.16 08:00,518,337,28,883,0
안락→연산교차로,2023.5.16 08:00,595,0,82,677,0
연산터널→연산교차로,2023.5.16 08:00,313,372,31,716,0
교대→연산교차로,2023.5.16 09:00,304,0,541,845,0
부산시청→연산교차로,2023.5.16 09:00,494,374,274,1142,0
사직운동장→연산교차로,2023.5.16 09:00,210,535,64,809,0
신리→연산교차로,2023.5.16 09:00,449,327,57,833,0
안락→연산교차로,2023.5.16 09:00,603,0,97,700,0
연산터널→연산교차로,2023.5.16 09:00,295,353,51,699,0
교대→연산교차로,2023.5.16 10:00,296,0,452,748,0
부산시청→연산교차로,2023.5.16 10:00,542,352,276,1170,0
사직운동장→연산교차로,2023.5.16 10:00,236,548,64,848,0
신리→연산교차로,2023.5.16 10:00,480,281,59,820,0
안락→연산교차로,2023.5.16 10:00,511,0,115,626,0
연산터널→연산교차로,2023.5.16 10:00,309,331,55,695,0
교대→연산교차로,2023.5.16 11:00,287,0,389,676,0
부산시청→연산교차로,2023.5.16 11:00,538,380,227,1145,0
사직운동장→연산교차로,2023.5.16 11:00,219,557,67,843,0
신리→연산교차로,2023.5.16 11:00,438,258,62,758,0
안락→연산교차로,2023.5.16 11:00,497,0,124,621,0
연산터널→연산교차로,2023.5.16 11:00,265,296,45,606,0
교대→연산교차로,2023.5.16 12:00,272,0,330,602,0
부산시청→연산교차로,2023.5.16 12:00,534,358,235,1127,0
사직운동장→연산교차로,2023.5.16 12:00,209,553,47,809,0
신리→연산교차로,2023.5.16 12:00,436,230,44,710,0
안락→연산교차로,2023.5.16 12:00,493,0,125,618,0
연산터널→연산교차로,2023.5.16 12:00,246,272,45,563,0
교대→연산교차로,2023.5.16 13:00,322,0,440,762,0
부산시청→연산교차로,2023.5.16 13:00,554,413,248,1215,0
사직운동장→연산교차로,2023.5.16 13:00,254,591,50,895,0
신리→연산교차로,2023.5.16 13:00,436,257,46,739,0
안락→연산교차로,2023.5.16 13:00,420,0,137,557,0
연산터널→연산교차로,2023.5.16 13:00,243,278,34,555,0
교대→연산교차로,2023.5.16 14:00,328,0,449,777,0
부산시청→연산교차로,2023.5.16 14:00,530,465,287,1282,0
사직운동장→연산교차로,2023.5.16 14:00,245,593,60,898,0
신리→연산교차로,2023.5.16 14:00,421,267,53,741,0
안락→연산교차로,2023.5.16 14:00,429,0,100,529,0
연산터널→연산교차로,2023.5.16 14:00,225,285,47,557,0
교대→연산교차로,2023.5.16 15:00,340,0,468,808,0
부산시청→연산교차로,2023.5.16 15:00,581,465,307,1353,0
사직운동장→연산교차로,2023.5.16 15:00,249,596,74,919,0
신리→연산교차로,2023.5.16 15:00,418,256,54,728,0
안락→연산교차로,2023.5.16 15:00,433,0,85,518,0
연산터널→연산교차로,2023.5.16 15:00,222,274,41,537,0
교대→연산교차로,2023.5.16 16:00,224,0,309,533,0
부산시청→연산교차로,2023.5.16 16:00,433,338,203,974,0
사직운동장→연산교차로,2023.5.16 16:00,149,409,28,586,0
신리→연산교차로,2023.5.16 16:00,359,194,26,579,0
안락→연산교차로,2023.5.16 16:00,301,0,84,385,0
연산터널→연산교차로,2023.5.16 16:00,152,185,26,363,0
교대→연산교차로,2023.5.16 17:00,86,0,113,199,0
부산시청→연산교차로,2023.5.16 17:00,191,132,76,399,0
사직운동장→연산교차로,2023.5.16 17:00,70,212,21,303,0
신리→연산교차로,2023.5.16 17:00,133,78,7,218,0
안락→연산교차로,2023.5.16 17:00,128,0,29,157,0
연산터널→연산교차로,2023.5.16 17:00,71,73,11,155,0
교대→연산교차로,2023.5.16 18:00,364,0,561,925,0
부산시청→연산교차로,2023.5.16 18:00,604,577,354,1535,0
사직운동장→연산교차로,2023.5.16 18:00,322,678,47,1047,0
신리→연산교차로,2023.5.16 18:00,523,276,52,851,0
안락→연산교차로,2023.5.16 18:00,468,0,103,571,0
연산터널→연산교차로,2023.5.16 18:00,233,279,51,563,0
교대→연산교차로,2023.5.16 19:00,345,0,410,755,0
부산시청→연산교차로,2023.5.16 19:00,492,361,258,1111,0
사직운동장→연산교차로,2023.5.16 19:00,200,562,72,834,0
신리→연산교차로,2023.5.16 19:00,369,207,42,618,0
안락→연산교차로,2023.5.16 19:00,428,0,92,520,0
연산터널→연산교차로,2023.5.16 19:00,199,276,56,531,0
교대→연산교차로,2023.5.16 20:00,307,0,306,613,0
부산시청→연산교차로,2023.5.16 20:00,481,361,254,1096,0
사직운동장→연산교차로,2023.5.16 20:00,182,536,68,786,0
신리→연산교차로,2023.5.16 20:00,329,173,36,538,0
안락→연산교차로,2023.5.16 20:00,396,0,106,502,0
연산터널→연산교차로,2023.5.16 20:00,211,266,54,531,0
교대→연산교차로,2023.5.16 21:00,285,0,320,605,0
부산시청→연산교차로,2023.5.16 21:00,474,332,224,1030,0
사직운동장→연산교차로,2023.5.16 21:00,174,432,66,672,0
신리→연산교차로,2023.5.16 21:00,291,172,44,507,0
안락→연산교차로,2023.5.16 21:00,413,0,88,501,0
연산터널→연산교차로,2023.5.16 21:00,225,284,62,571,0
교대→연산교차로,2023.5.16 22:00,214,0,249,463,0
부산시청→연산교차로,2023.5.16 22:00,450,277,176,903,0
사직운동장→연산교차로,2023.5.16 22:00,148,381,65,594,0
신리→연산교차로,2023.5.16 22:00,258,152,26,436,0
안락→연산교차로,2023.5.16 22:00,342,0,78,420,0
연산터널→연산교차로,2023.5.16 22:00,221,239,74,534,0
교대→연산교차로,2023.5.16 23:00,168,0,179,347,0
부산시청→연산교차로,2023.5.16 23:00,320,193,128,641,0
사직운동장→연산교차로,2023.5.16 23:00,144,251,44,439,0
신리→연산교차로,2023.5.16 23:00,221,115,29,365,0
안락→연산교차로,2023.5.16 23:00,242,0,63,305,0
연산터널→연산교차로,2023.5.16 23:00,146,183,55,384,0
교대→연산교차로,2023.5.17 00:00,141,0,196,337,0
부산시청→연산교차로,2023.5.17 00:00,252,145,125,522,0
사직운동장→연산교차로,2023.5.17 00:00,107,230,24,361,0
신리→연산교차로,2023.5.17 00:00,147,99,25,271,0
안락→연산교차로,2023.5.17 00:00,220,0,58,278,0
연산터널→연산교차로,2023.5.17 00:00,115,183,72,370,0
교대→연산교차로,2023.5.17 01:00,94,0,160,254,0
부산시청→연산교차로,2023.5.17 01:00,220,114,90,424,0
사직운동장→연산교차로,2023.5.17 01:00,93,160,21,274,0
신리→연산교차로,2023.5.17 01:00,130,61,16,207,0
안락→연산교차로,2023.5.17 01:00,169,0,42,211,0
연산터널→연산교차로,2023.5.17 01:00,112,129,63,304,0
교대→연산교차로,2023.5.17 02:00,74,0,151,225,0
부산시청→연산교차로,2023.5.17 02:00,164,89,70,323,0
사직운동장→연산교차로,2023.5.17 02:00,65,126,9,200,0
신리→연산교차로,2023.5.17 02:00,90,49,16,155,0
안락→연산교차로,2023.5.17 02:00,145,0,33,178,0
연산터널→연산교차로,2023.5.17 02:00,92,123,39,254,0
교대→연산교차로,2023.5.17 03:00,64,0,88,152,0
부산시청→연산교차로,2023.5.17 03:00,138,71,40,249,0
사직운동장→연산교차로,2023.5.17 03:00,44,114,5,163,0
신리→연산교차로,2023.5.17 03:00,67,32,11,110,0
안락→연산교차로,2023.5.17 03:00,111,0,16,127,0
연산터널→연산교차로,2023.5.17 03:00,69,91,50,210,0
교대→연산교차로,2023.5.17 04:00,51,0,68,119,0
부산시청→연산교차로,2023.5.17 04:00,138,64,42,244,0
사직운동장→연산교차로,2023.5.17 04:00,39,110,3,152,0
신리→연산교차로,2023.5.17 04:00,91,40,12,143,0
안락→연산교차로,2023.5.17 04:00,145,0,27,172,0
연산터널→연산교차로,2023.5.17 04:00,73,80,22,175,0
교대→연산교차로,2023.5.17 05:00,102,0,130,232,0
부산시청→연산교차로,2023.5.17 05:00,216,150,63,429,0
사직운동장→연산교차로,2023.5.17 05:00,55,150,36,241,0
신리→연산교차로,2023.5.17 05:00,219,94,11,324,0
안락→연산교차로,2023.5.17 05:00,313,0,54,367,0
연산터널→연산교차로,2023.5.17 05:00,127,135,31,293,0
교대→연산교차로,2023.5.17 06:00,187,0,229,416,0
부산시청→연산교차로,2023.5.17 06:00,376,256,141,773,0
사직운동장→연산교차로,2023.5.17 06:00,93,267,37,397,0
신리→연산교차로,2023.5.17 06:00,355,160,32,547,0
안락→연산교차로,2023.5.17 06:00,541,0,86,627,0
연산터널→연산교차로,2023.5.17 06:00,222,228,38,488,0
교대→연산교차로,2023.5.17 07:00,204,0,332,536,0
부산시청→연산교차로,2023.5.17 07:00,413,281,197,891,0
사직운동장→연산교차로,2023.5.17 07:00,178,389,43,610,0
신리→연산교차로,2023.5.17 07:00,404,220,27,651,0
안락→연산교차로,2023.5.17 07:00,485,0,58,543,0
연산터널→연산교차로,2023.5.17 07:00,216,285,38,539,0
교대→연산교차로,2023.5.17 08:00,310,0,468,778,0
부산시청→연산교차로,2023.5.17 08:00,598,415,369,1382,0
사직운동장→연산교차로,2023.5.17 08:00,221,649,78,948,0
신리→연산교차로,2023.5.17 08:00,507,350,26,883,0
안락→연산교차로,2023.5.17 08:00,653,0,89,742,0
연산터널→연산교차로,2023.5.17 08:00,326,380,44,750,0
교대→연산교차로,2023.5.17 09:00,312,0,561,873,0
부산시청→연산교차로,2023.5.17 09:00,498,360,269,1127,0
사직운동장→연산교차로,2023.5.17 09:00,244,570,82,896,0
신리→연산교차로,2023.5.17 09:00,437,330,52,819,0
안락→연산교차로,2023.5.17 09:00,610,0,101,711,0
연산터널→연산교차로,2023.5.17 09:00,305,388,35,728,0
교대→연산교차로,2023.5.17 10:00,221,0,355,576,0
부산시청→연산교차로,2023.5.17 10:00,400,282,196,878,0
사직운동장→연산교차로,2023.5.17 10:00,268,438,49,755,0
신리→연산교차로,2023.5.17 10:00,340,217,37,594,0
안락→연산교차로,2023.5.17 10:00,447,0,102,549,0
연산터널→연산교차로,2023.5.17 10:00,231,265,35,531,0
교대→연산교차로,2023.5.17 11:00,289,0,420,709,0
부산시청→연산교차로,2023.5.17 11:00,533,387,277,1197,0
사직운동장→연산교차로,2023.5.17 11:00,342,574,67,983,0
신리→연산교차로,2023.5.17 11:00,440,248,52,740,0
안락→연산교차로,2023.5.17 11:00,564,0,122,686,0
연산터널→연산교차로,2023.5.17 11:00,277,321,44,642,0
교대→연산교차로,2023.5.17 12:00,284,0,372,656,0
부산시청→연산교차로,2023.5.17 12:00,541,365,227,1133,0
사직운동장→연산교차로,2023.5.17 12:00,239,540,76,855,0
신리→연산교차로,2023.5.17 12:00,379,210,66,655,0
안락→연산교차로,2023.5.17 12:00,480,0,155,635,0
연산터널→연산교차로,2023.5.17 12:00,234,274,46,554,0
교대→연산교차로,2023.5.17 13:00,329,0,445,774,0
부산시청→연산교차로,2023.5.17 13:00,597,442,255,1294,0
사직운동장→연산교차로,2023.5.17 13:00,285,586,72,943,0
신리→연산교차로,2023.5.17 13:00,438,252,48,738,0
안락→연산교차로,2023.5.17 13:00,438,0,139,577,0
연산터널→연산교차로,2023.5.17 13:00,260,251,26,537,0
교대→연산교차로,2023.5.17 14:00,351,0,450,801,0
부산시청→연산교차로,2023.5.17 14:00,529,461,320,1310,0
사직운동장→연산교차로,2023.5.17 14:00,294,600,76,970,0
신리→연산교차로,2023.5.17 14:00,491,251,82,824,0
안락→연산교차로,2023.5.17 14:00,413,0,127,540,0
연산터널→연산교차로,2023.5.17 14:00,239,275,49,563,0
교대→연산교차로,2023.5.17 15:00,362,0,484,846,0
부산시청→연산교차로,2023.5.17 15:00,578,492,280,1350,0
사직운동장→연산교차로,2023.5.17 15:00,239,632,71,942,0
신리→연산교차로,2023.5.17 15:00,498,280,67,845,0
안락→연산교차로,2023.5.17 15:00,440,0,100,540,0
연산터널→연산교차로,2023.5.17 15:00,250,265,30,545,0
교대→연산교차로,2023.5.17 16:00,271,0,363,634,0
부산시청→연산교차로,2023.5.17 16:00,443,383,244,1070,0
사직운동장→연산교차로,2023.5.17 16:00,232,469,54,755,0
신리→연산교차로,2023.5.17 16:00,372,218,42,632,0
안락→연산교차로,2023.5.17 16:00,345,0,73,418,0
연산터널→연산교차로,2023.5.17 16:00,171,211,30,412,0
교대→연산교차로,2023.5.17 17:00,378,0,462,840,0
부산시청→연산교차로,2023.5.17 17:00,622,566,311,1499,0
사직운동장→연산교차로,2023.5.17 17:00,295,688,47,1030,0
신리→연산교차로,2023.5.17 17:00,529,279,51,859,0
안락→연산교차로,2023.5.17 17:00,475,0,86,561,0
연산터널→연산교차로,2023.5.17 17:00,234,283,39,556,0
교대→연산교차로,2023.5.17 18:00,285,0,376,661,0
부산시청→연산교차로,2023.5.17 18:00,440,434,245,1119,0
사직운동장→연산교차로,2023.5.17 18:00,240,491,28,759,0
신리→연산교차로,2023.5.17 18:00,362,191,32,585,0
안락→연산교차로,2023.5.17 18:00,360,0,85,445,0
연산터널→연산교차로,2023.5.17 18:00,185,210,32,427,0
교대→연산교차로,2023.5.17 19:00,328,0,407,735,0
부산시청→연산교차로,2023.5.17 19:00,536,424,249,1209,0
사직운동장→연산교차로,2023.5.17 19:00,212,508,68,788,0
신리→연산교차로,2023.5.17 19:00,365,207,32,604,0
안락→연산교차로,2023.5.17 19:00,451,0,89,540,0
연산터널→연산교차로,2023.5.17 19:00,185,269,69,523,0
교대→연산교차로,2023.5.17 20:00,297,0,290,587,0
부산시청→연산교차로,2023.5.17 20:00,475,349,230,1054,0
사직운동장→연산교차로,2023.5.17 20:00,172,436,58,666,0
신리→연산교차로,2023.5.17 20:00,349,199,31,579,0
안락→연산교차로,2023.5.17 20:00,360,0,97,457,0
연산터널→연산교차로,2023.5.17 20:00,204,275,50,529,0
교대→연산교차로,2023.5.17 21:00,292,0,309,601,0
부산시청→연산교차로,2023.5.17 21:00,525,362,254,1141,0
사직운동장→연산교차로,2023.5.17 21:00,178,443,73,694,0
신리→연산교차로,2023.5.17 21:00,276,168,31,475,0
안락→연산교차로,2023.5.17 21:00,452,0,92,544,0
연산터널→연산교차로,2023.5.17 21:00,230,248,49,527,0
교대→연산교차로,2023.5.17 22:00,243,0,273,516,0
부산시청→연산교차로,2023.5.17 22:00,448,315,166,929,0
사직운동장→연산교차로,2023.5.17 22:00,167,351,47,565,0
신리→연산교차로,2023.5.17 22:00,254,148,29,431,0
안락→연산교차로,2023.5.17 22:00,358,0,76,434,0
연산터널→연산교차로,2023.5.17 22:00,192,251,48,491,0
교대→연산교차로,2023.5.17 23:00,218,0,169,387,0
부산시청→연산교차로,2023.5.17 23:00,311,190,122,623,0
사직운동장→연산교차로,2023.5.17 23:00,120,248,51,419,0
신리→연산교차로,2023.5.17 23:00,195,124,12,331,0
안락→연산교차로,2023.5.17 23:00,269,0,72,341,0
연산터널→연산교차로,2023.5.17 23:00,144,198,57,399,0
교대→연산교차로,2023.5.18 00:00,138,0,186,324,0
부산시청→연산교차로,2023.5.18 00:00,260,157,87,504,0
사직운동장→연산교차로,2023.5.18 00:00,104,247,11,362,0
신리→연산교차로,2023.5.18 00:00,167,116,21,304,0
안락→연산교차로,2023.5.18 00:00,227,0,57,284,0
연산터널→연산교차로,2023.5.18 00:00,128,155,42,325,0
교대→연산교차로,2023.5.18 01:00,122,0,169,291,0
부산시청→연산교차로,2023.5.18 01:00,197,131,95,423,0
사직운동장→연산교차로,2023.5.18 01:00,68,198,18,284,0
신리→연산교차로,2023.5.18 01:00,144,64,18,226,0
안락→연산교차로,2023.5.18 01:00,172,0,40,212,0
연산터널→연산교차로,2023.5.18 01:00,133,137,54,324,0
교대→연산교차로,2023.5.18 02:00,85,0,145,230,0
부산시청→연산교차로,2023.5.18 02:00,159,86,61,306,0
사직운동장→연산교차로,2023.5.18 02:00,49,141,2,192,0
신리→연산교차로,2023.5.18 02:00,86,55,16,157,0
안락→연산교차로,2023.5.18 02:00,149,0,30,179,0
연산터널→연산교차로,2023.5.18 02:00,100,109,62,271,0
교대→연산교차로,2023.5.18 03:00,61,0,103,164,0
부산시청→연산교차로,2023.5.18 03:00,143,80,57,280,0
사직운동장→연산교차로,2023.5.18 03:00,45,125,4,174,0
신리→연산교차로,2023.5.18 03:00,81,47,8,136,0
안락→연산교차로,2023.5.18 03:00,117,0,27,144,0
연산터널→연산교차로,2023.5.18 03:00,87,98,47,232,0
교대→연산교차로,2023.5.18 04:00,61,0,84,145,0
부산시청→연산교차로,2023.5.18 04:00,147,78,55,280,0
사직운동장→연산교차로,2023.5.18 04:00,45,117,5,167,0
신리→연산교차로,2023.5.18 04:00,88,60,6,154,0
안락→연산교차로,2023.5.18 04:00,169,0,35,204,0
연산터널→연산교차로,2023.5.18 04:00,75,85,32,192,0
교대→연산교차로,2023.5.18 05:00,91,0,115,206,0
부산시청→연산교차로,2023.5.18 05:00,170,108,65,343,0
사직운동장→연산교차로,2023.5.18 05:00,46,114,37,197,0
신리→연산교차로,2023.5.18 05:00,169,78,14,261,0
안락→연산교차로,2023.5.18 05:00,252,0,44,296,0
연산터널→연산교차로,2023.5.18 05:00,117,124,30,271,0
교대→연산교차로,2023.5.18 06:00,178,0,242,420,0
부산시청→연산교차로,2023.5.18 06:00,350,247,103,700,0
사직운동장→연산교차로,2023.5.18 06:00,112,301,43,456,0
신리→연산교차로,2023.5.18 06:00,338,135,13,486,0
안락→연산교차로,2023.5.18 06:00,511,0,70,581,0
연산터널→연산교차로,2023.5.18 06:00,213,218,44,475,0
교대→연산교차로,2023.5.18 07:00,259,0,392,651,0
부산시청→연산교차로,2023.5.18 07:00,537,379,233,1149,0
사직운동장→연산교차로,2023.5.18 07:00,211,461,54,726,0
신리→연산교차로,2023.5.18 07:00,489,251,27,767,0
안락→연산교차로,2023.5.18 07:00,610,0,86,696,0
연산터널→연산교차로,2023.5.18 07:00,270,370,49,689,0
교대→연산교차로,2023.5.18 08:00,309,0,486,795,0
부산시청→연산교차로,2023.5.18 08:00,547,411,320,1278,0
사직운동장→연산교차로,2023.5.18 08:00,239,654,54,947,0
신리→연산교차로,2023.5.18 08:00,513,340,17,870,0
안락→연산교차로,2023.5.18 08:00,598,0,105,703,0
연산터널→연산교차로,2023.5.18 08:00,298,381,41,720,0
교대→연산교차로,2023.5.18 09:00,279,0,517,796,0
부산시청→연산교차로,2023.5.18 09:00,525,379,316,1220,0
사직운동장→연산교차로,2023.5.18 09:00,255,554,78,887,0
신리→연산교차로,2023.5.18 09:00,438,336,41,815,0
안락→연산교차로,2023.5.18 09:00,568,0,107,675,0
연산터널→연산교차로,2023.5.18 09:00,283,348,47,678,0
교대→연산교차로,2023.5.18 10:00,281,0,461,742,0
부산시청→연산교차로,2023.5.18 10:00,565,371,255,1191,0
사직운동장→연산교차로,2023.5.18 10:00,293,550,78,921,0
신리→연산교차로,2023.5.18 10:00,464,269,39,772,0
안락→연산교차로,2023.5.18 10:00,544,0,145,689,0
연산터널→연산교차로,2023.5.18 10:00,265,344,38,647,0
교대→연산교차로,2023.5.18 11:00,281,0,417,698,0
부산시청→연산교차로,2023.5.18 11:00,527,363,236,1126,0
사직운동장→연산교차로,2023.5.18 11:00,271,518,84,873,0
신리→연산교차로,2023.5.18 11:00,451,224,47,722,0
안락→연산교차로,2023.5.18 11:00,544,0,139,683,0
연산터널→연산교차로,2023.5.18 11:00,269,337,43,649,0
교대→연산교차로,2023.5.18 12:00,290,0,393,683,0
부산시청→연산교차로,2023.5.18 12:00,571,365,245,1181,0
사직운동장→연산교차로,2023.5.18 12:00,380,567,57,1004,0
신리→연산교차로,2023.5.18 12:00,388,250,48,686,0
안락→연산교차로,2023.5.18 12:00,524,0,133,657,0
연산터널→연산교차로,2023.5.18 12:00,253,311,37,601,0
교대→연산교차로,2023.5.18 13:00,324,0,463,787,0
부산시청→연산교차로,2023.5.18 13:00,577,451,273,1301,0
사직운동장→연산교차로,2023.5.18 13:00,252,546,112,910,0
신리→연산교차로,2023.5.18 13:00,416,265,44,725,0
안락→연산교차로,2023.5.18 13:00,447,0,115,562,0
연산터널→연산교차로,2023.5.18 13:00,247,263,39,549,0
교대→연산교차로,2023.5.18 14:00,329,0,492,821,0
부산시청→연산교차로,2023.5.18 14:00,542,430,273,1245,0
사직운동장→연산교차로,2023.5.18 14:00,317,565,80,962,0
신리→연산교차로,2023.5.18 14:00,415,279,63,757,0
안락→연산교차로,2023.5.18 14:00,427,0,107,534,0
연산터널→연산교차로,2023.5.18 14:00,231,273,39,543,0
교대→연산교차로,2023.5.18 15:00,340,0,537,877,0
부산시청→연산교차로,2023.5.18 15:00,563,463,290,1316,0
사직운동장→연산교차로,2023.5.18 15:00,348,577,50,975,0
신리→연산교차로,2023.5.18 15:00,462,270,38,770,0
안락→연산교차로,2023.5.18 15:00,454,0,98,552,0
연산터널→연산교차로,2023.5.18 15:00,217,284,40,541,0
교대→연산교차로,2023.5.18 16:00,269,0,391,660,0
부산시청→연산교차로,2023.5.18 16:00,431,384,223,1038,0
사직운동장→연산교차로,2023.5.18 16:00,235,471,57,763,0
신리→연산교차로,2023.5.18 16:00,398,191,36,625,0
안락→연산교차로,2023.5.18 16:00,334,0,85,419,0
연산터널→연산교차로,2023.5.18 16:00,166,221,31,418,0
교대→연산교차로,2023.5.18 17:00,353,0,523,876,0
부산시청→연산교차로,2023.5.18 17:00,580,532,320,1432,0
사직운동장→연산교차로,2023.5.18 17:00,338,626,45,1009,0
신리→연산교차로,2023.5.18 17:00,463,308,43,814,0
안락→연산교차로,2023.5.18 17:00,453,0,90,543,0
연산터널→연산교차로,2023.5.18 17:00,232,275,39,546,0
교대→연산교차로,2023.5.18 18:00,331,0,499,830,0
부산시청→연산교차로,2023.5.18 18:00,543,568,344,1455,0
사직운동장→연산교차로,2023.5.18 18:00,276,643,25,944,0
신리→연산교차로,2023.5.18 18:00,530,271,47,848,0
안락→연산교차로,2023.5.18 18:00,461,0,84,545,0
연산터널→연산교차로,2023.5.18 18:00,207,282,56,545,0
교대→연산교차로,2023.5.18 19:00,312,0,365,677,0
부산시청→연산교차로,2023.5.18 19:00,491,452,262,1205,0
사직운동장→연산교차로,2023.5.18 19:00,205,536,23,764,0
신리→연산교차로,2023.5.18 19:00,342,243,22,607,0
안락→연산교차로,2023.5.18 19:00,423,0,72,495,0
연산터널→연산교차로,2023.5.18 19:00,209,253,35,497,0
교대→연산교차로,2023.5.18 20:00,292,0,221,513,0
부산시청→연산교차로,2023.5.18 20:00,460,389,231,1080,0
사직운동장→연산교차로,2023.5.18 20:00,184,462,5,651,0
신리→연산교차로,2023.5.18 20:00,294,188,18,500,0
안락→연산교차로,2023.5.18 20:00,374,0,72,446,0
연산터널→연산교차로,2023.5.18 20:00,185,242,4,431,0
교대→연산교차로,2023.5.18 21:00,255,0,250,505,0
부산시청→연산교차로,2023.5.18 21:00,437,375,213,1025,0
사직운동장→연산교차로,2023.5.18 21:00,175,400,12,587,0
신리→연산교차로,2023.5.18 21:00,301,150,22,473,0
안락→연산교차로,2023.5.18 21:00,373,0,104,477,0
연산터널→연산교차로,2023.5.18 21:00,230,249,30,509,0
교대→연산교차로,2023.5.18 22:00,212,0,158,370,0
부산시청→연산교차로,2023.5.18 22:00,395,300,146,841,0
사직운동장→연산교차로,2023.5.18 22:00,149,326,9,484,0
신리→연산교차로,2023.5.18 22:00,233,160,21,414,0
안락→연산교차로,2023.5.18 22:00,339,0,69,408,0
연산터널→연산교차로,2023.5.18 22:00,185,229,28,442,0
교대→연산교차로,2023.5.18 23:00,183,0,101,284,0
부산시청→연산교차로,2023.5.18 23:00,289,193,107,589,0
사직운동장→연산교차로,2023.5.18 23:00,116,249,6,371,0
신리→연산교차로,2023.5.18 23:00,186,106,15,307,0
안락→연산교차로,2023.5.18 23:00,224,0,44,268,0
연산터널→연산교차로,2023.5.18 23:00,99,142,22,263,0
교대→연산교차로,2023.5.19 00:00,116,0,108,224,0
부산시청→연산교차로,2023.5.19 00:00,209,161,82,452,0
사직운동장→연산교차로,2023.5.19 00:00,86,178,12,276,0
신리→연산교차로,2023.5.19 00:00,123,98,13,234,0
안락→연산교차로,2023.5.19 00:00,203,0,37,240,0
연산터널→연산교차로,2023.5.19 00:00,106,124,14,244,0
교대→연산교차로,2023.5.19 01:00,73,0,118,191,0
부산시청→연산교차로,2023.5.19 01:00,195,101,76,372,0
사직운동장→연산교차로,2023.5.19 01:00,65,149,13,227,0
신리→연산교차로,2023.5.19 01:00,120,66,7,193,0
안락→연산교차로,2023.5.19 01:00,187,0,37,224,0
연산터널→연산교차로,2023.5.19 01:00,92,133,17,242,0
교대→연산교차로,2023.5.19 02:00,79,0,113,192,0
부산시청→연산교차로,2023.5.19 02:00,176,80,71,327,0
사직운동장→연산교차로,2023.5.19 02:00,84,133,17,234,0
신리→연산교차로,2023.5.19 02:00,88,53,14,155,0
안락→연산교차로,2023.5.19 02:00,139,0,33,172,0
연산터널→연산교차로,2023.5.19 02:00,95,128,12,235,0
교대→연산교차로,2023.5.19 03:00,70,0,96,166,0
부산시청→연산교차로,2023.5.19 03:00,130,67,38,235,0
사직운동장→연산교차로,2023.5.19 03:00,53,130,11,194,0
신리→연산교차로,2023.5.19 03:00,63,35,3,101,0
안락→연산교차로,2023.5.19 03:00,106,0,29,135,0
연산터널→연산교차로,2023.5.19 03:00,76,95,19,190,0
교대→연산교차로,2023.5.19 04:00,32,0,45,77,0
부산시청→연산교차로,2023.5.19 04:00,71,25,23,119,0
사직운동장→연산교차로,2023.5.19 04:00,15,59,12,86,0
신리→연산교차로,2023.5.19 04:00,53,26,1,80,0
안락→연산교차로,2023.5.19 04:00,117,0,8,125,0
연산터널→연산교차로,2023.5.19 04:00,46,46,4,96,0
교대→연산교차로,2023.5.19 05:00,92,0,111,203,0
부산시청→연산교차로,2023.5.19 05:00,172,109,57,338,0
사직운동장→연산교차로,2023.5.19 05:00,44,124,28,196,0
신리→연산교차로,2023.5.19 05:00,184,71,9,264,0
안락→연산교차로,2023.5.19 05:00,275,0,45,320,0
연산터널→연산교차로,2023.5.19 05:00,97,110,19,226,0
교대→연산교차로,2023.5.19 06:00,182,0,225,407,0
부산시청→연산교차로,2023.5.19 06:00,343,248,102,693,0
사직운동장→연산교차로,2023.5.19 06:00,103,276,48,427,0
신리→연산교차로,2023.5.19 06:00,328,158,18,504,0
안락→연산교차로,2023.5.19 06:00,514,0,84,598,0
연산터널→연산교차로,2023.5.19 06:00,216,206,34,456,0
교대→연산교차로,2023.5.19 07:00,234,0,412,646,0
부산시청→연산교차로,2023.5.19 07:00,542,354,205,1101,0
사직운동장→연산교차로,2023.5.19 07:00,216,457,53,726,0
신리→연산교차로,2023.5.19 07:00,459,322,30,811,0
안락→연산교차로,2023.5.19 07:00,600,0,82,682,0
연산터널→연산교차로,2023.5.19 07:00,308,364,53,725,0
교대→연산교차로,2023.5.19 08:00,236,0,383,619,0
부산시청→연산교차로,2023.5.19 08:00,423,315,274,1012,0
사직운동장→연산교차로,2023.5.19 08:00,218,498,33,749,0
신리→연산교차로,2023.5.19 08:00,394,251,17,662,0
안락→연산교차로,2023.5.19 08:00,456,0,72,528,0
연산터널→연산교차로,2023.5.19 08:00,225,291,28,544,0
교대→연산교차로,2023.5.19 09:00,312,0,518,830,0
부산시청→연산교차로,2023.5.19 09:00,539,371,291,1201,0
사직운동장→연산교차로,2023.5.19 09:00,292,588,87,967,0
신리→연산교차로,2023.5.19 09:00,472,317,45,834,0
안락→연산교차로,2023.5.19 09:00,590,0,98,688,0
연산터널→연산교차로,2023.5.19 09:00,316,358,41,715,0
교대→연산교차로,2023.5.19 10:00,284,0,490,774,0
부산시청→연산교차로,2023.5.19 10:00,590,377,275,1242,0
사직운동장→연산교차로,2023.5.19 10:00,304,576,78,958,0
신리→연산교차로,2023.5.19 10:00,463,293,51,807,0
안락→연산교차로,2023.5.19 10:00,563,0,125,688,0
연산터널→연산교차로,2023.5.19 10:00,272,342,52,666,0
교대→연산교차로,2023.5.19 11:00,298,0,450,748,0
부산시청→연산교차로,2023.5.19 11:00,606,366,253,1225,0
사직운동장→연산교차로,2023.5.19 11:00,298,585,69,952,0
신리→연산교차로,2023.5.19 11:00,490,244,71,805,0
안락→연산교차로,2023.5.19 11:00,551,0,128,679,0
연산터널→연산교차로,2023.5.19 11:00,290,325,46,661,0
교대→연산교차로,2023.5.19 12:00,304,0,473,777,0
부산시청→연산교차로,2023.5.19 12:00,584,360,264,1208,0
사직운동장→연산교차로,2023.5.19 12:00,321,566,68,955,0
신리→연산교차로,2023.5.19 12:00,401,235,46,682,0
안락→연산교차로,2023.5.19 12:00,515,0,130,645,0
연산터널→연산교차로,2023.5.19 12:00,278,296,54,628,0
교대→연산교차로,2023.5.19 13:00,337,0,488,825,0
부산시청→연산교차로,2023.5.19 13:00,561,465,299,1325,0
사직운동장→연산교차로,2023.5.19 13:00,323,583,90,996,0
신리→연산교차로,2023.5.19 13:00,421,269,52,742,0
안락→연산교차로,2023.5.19 13:00,456,0,110,566,0
연산터널→연산교차로,2023.5.19 13:00,257,258,29,544,0
교대→연산교차로,2023.5.19 14:00,343,0,496,839,0
부산시청→연산교차로,2023.5.19 14:00,599,488,276,1363,0
사직운동장→연산교차로,2023.5.19 14:00,350,656,83,1089,0
신리→연산교차로,2023.5.19 14:00,478,283,76,837,0
안락→연산교차로,2023.5.19 14:00,437,0,98,535,0
연산터널→연산교차로,2023.5.19 14:00,250,298,53,601,0
교대→연산교차로,2023.5.19 15:00,370,0,507,877,0
부산시청→연산교차로,2023.5.19 15:00,595,498,303,1396,0
사직운동장→연산교차로,2023.5.19 15:00,308,643,90,1041,0
신리→연산교차로,2023.5.19 15:00,534,297,40,871,0
안락→연산교차로,2023.5.19 15:00,442,0,97,539,0
연산터널→연산교차로,2023.5.19 15:00,252,261,44,557,0
교대→연산교차로,2023.5.19 16:00,369,0,508,877,0
부산시청→연산교차로,2023.5.19 16:00,584,514,326,1424,0
사직운동장→연산교차로,2023.5.19 16:00,359,661,65,1085,0
신리→연산교차로,2023.5.19 16:00,544,304,51,899,0
안락→연산교차로,2023.5.19 16:00,446,0,106,552,0
연산터널→연산교차로,2023.5.19 16:00,259,281,37,577,0
교대→연산교차로,2023.5.19 17:00,374,0,576,950,0
부산시청→연산교차로,2023.5.19 17:00,603,544,278,1425,0
사직운동장→연산교차로,2023.5.19 17:00,324,712,54,1090,0
신리→연산교차로,2023.5.19 17:00,490,327,59,876,0
안락→연산교차로,2023.5.19 17:00,462,0,115,577,0
연산터널→연산교차로,2023.5.19 17:00,256,275,32,563,0
교대→연산교차로,2023.5.19 18:00,374,0,559,933,0
부산시청→연산교차로,2023.5.19 18:00,597,576,327,1500,0
사직운동장→연산교차로,2023.5.19 18:00,321,685,57,1063,0
신리→연산교차로,2023.5.19 18:00,490,279,41,810,0
안락→연산교차로,2023.5.19 18:00,488,0,97,585,0
연산터널→연산교차로,2023.5.19 18:00,222,275,56,553,0
교대→연산교차로,2023.5.19 19:00,355,0,446,801,0
부산시청→연산교차로,2023.5.19 19:00,571,407,274,1252,0
사직운동장→연산교차로,2023.5.19 19:00,197,563,76,836,0
신리→연산교차로,2023.5.19 19:00,397,240,34,671,0
안락→연산교차로,2023.5.19 19:00,454,0,88,542,0
연산터널→연산교차로,2023.5.19 19:00,209,279,58,546,0
교대→연산교차로,2023.5.19 20:00,343,0,389,732,0
부산시청→연산교차로,2023.5.19 20:00,544,411,244,1199,0
사직운동장→연산교차로,2023.5.19 20:00,188,530,70,788,0
신리→연산교차로,2023.5.19 20:00,353,182,31,566,0
안락→연산교차로,2023.5.19 20:00,441,0,105,546,0
연산터널→연산교차로,2023.5.19 20:00,222,289,59,570,0
교대→연산교차로,2023.5.19 21:00,301,0,320,621,0
부산시청→연산교차로,2023.5.19 21:00,523,381,219,1123,0
사직운동장→연산교차로,2023.5.19 21:00,202,462,71,735,0
신리→연산교차로,2023.5.19 21:00,351,210,38,599,0
안락→연산교차로,2023.5.19 21:00,441,0,122,563,0
연산터널→연산교차로,2023.5.19 21:00,241,302,66,609,0
교대→연산교차로,2023.5.19 22:00,298,0,268,566,0
부산시청→연산교차로,2023.5.19 22:00,483,295,194,972,0
사직운동장→연산교차로,2023.5.19 22:00,233,494,61,788,0
신리→연산교차로,2023.5.19 22:00,311,173,30,514,0
안락→연산교차로,2023.5.19 22:00,370,0,97,467,0
연산터널→연산교차로,2023.5.19 22:00,233,254,59,546,0
교대→연산교차로,2023.5.19 23:00,244,0,235,479,0
부산시청→연산교차로,2023.5.19 23:00,412,243,152,807,0
사직운동장→연산교차로,2023.5.19 23:00,194,377,65,636,0
신리→연산교차로,2023.5.19 23:00,247,157,33,437,0
안락→연산교차로,2023.5.19 23:00,342,0,80,422,0
연산터널→연산교차로,2023.5.19 23:00,165,197,54,416,0
교대→연산교차로,2023.5.20 00:00,171,0,159,330,0
부산시청→연산교차로,2023.5.20 00:00,322,242,139,703,0
사직운동장→연산교차로,2023.5.20 00:00,136,275,51,462,0
신리→연산교차로,2023.5.20 00:00,247,160,17,424,0
안락→연산교차로,2023.5.20 00:00,265,0,63,328,0
연산터널→연산교차로,2023.5.20 00:00,158,186,41,385,0
교대→연산교차로,2023.5.20 01:00,153,0,226,379,0
부산시청→연산교차로,2023.5.20 01:00,264,198,117,579,0
사직운동장→연산교차로,2023.5.20 01:00,107,211,52,370,0
신리→연산교차로,2023.5.20 01:00,160,87,13,260,0
안락→연산교차로,2023.5.20 01:00,237,0,51,288,0
연산터널→연산교차로,2023.5.20 01:00,142,176,67,385,0
교대→연산교차로,2023.5.20 02:00,105,0,212,317,0
부산시청→연산교차로,2023.5.20 02:00,249,140,95,484,0
사직운동장→연산교차로,2023.5.20 02:00,79,191,51,321,0
신리→연산교차로,2023.5.20 02:00,132,73,19,224,0
안락→연산교차로,2023.5.20 02:00,218,0,60,278,0
연산터널→연산교차로,2023.5.20 02:00,141,155,44,340,0
교대→연산교차로,2023.5.20 03:00,94,0,164,258,0
부산시청→연산교차로,2023.5.20 03:00,200,101,64,365,0
사직운동장→연산교차로,2023.5.20 03:00,60,160,70,290,0
신리→연산교차로,2023.5.20 03:00,95,66,13,174,0
안락→연산교차로,2023.5.20 03:00,143,0,34,177,0
연산터널→연산교차로,2023.5.20 03:00,101,152,44,297,0
교대→연산교차로,2023.5.20 04:00,86,0,102,188,0
부산시청→연산교차로,2023.5.20 04:00,211,91,60,362,0
사직운동장→연산교차로,2023.5.20 04:00,43,130,34,207,0
신리→연산교차로,2023.5.20 04:00,107,58,7,172,0
안락→연산교차로,2023.5.20 04:00,196,0,41,237,0
연산터널→연산교차로,2023.5.20 04:00,85,149,27,261,0
교대→연산교차로,2023.5.20 05:00,123,0,158,281,0
부산시청→연산교차로,2023.5.20 05:00,271,162,84,517,0
사직운동장→연산교차로,2023.5.20 05:00,72,173,36,281,0
신리→연산교차로,2023.5.20 05:00,203,94,11,308,0
안락→연산교차로,2023.5.20 05:00,341,0,54,395,0
연산터널→연산교차로,2023.5.20 05:00,123,168,28,319,0
교대→연산교차로,2023.5.20 06:00,175,0,220,395,0
부산시청→연산교차로,2023.5.20 06:00,339,255,102,696,0
사직운동장→연산교차로,2023.5.20 06:00,99,245,48,392,0
신리→연산교차로,2023.5.20 06:00,312,136,27,475,0
안락→연산교차로,2023.5.20 06:00,405,0,71,476,0
연산터널→연산교차로,2023.5.20 06:00,184,180,27,391,0
교대→연산교차로,2023.5.20 07:00,182,0,212,394,0
부산시청→연산교차로,2023.5.20 07:00,412,289,147,848,0
사직운동장→연산교차로,2023.5.20 07:00,126,326,57,509,0
신리→연산교차로,2023.5.20 07:00,314,153,17,484,0
안락→연산교차로,2023.5.20 07:00,435,0,65,500,0
연산터널→연산교차로,2023.5.20 07:00,194,202,33,429,0
교대→연산교차로,2023.5.20 08:00,278,0,338,616,0
부산시청→연산교차로,2023.5.20 08:00,459,337,232,1028,0
사직운동장→연산교차로,2023.5.20 08:00,259,519,62,840,0
신리→연산교차로,2023.5.20 08:00,469,251,34,754,0
안락→연산교차로,2023.5.20 08:00,572,0,106,678,0
연산터널→연산교차로,2023.5.20 08:00,283,315,43,641,0
교대→연산교차로,2023.5.20 09:00,309,0,378,687,0
부산시청→연산교차로,2023.5.20 09:00,555,384,273,1212,0
사직운동장→연산교차로,2023.5.20 09:00,272,594,75,941,0
신리→연산교차로,2023.5.20 09:00,512,283,70,865,0
안락→연산교차로,2023.5.20 09:00,632,0,103,735,0
연산터널→연산교차로,2023.5.20 09:00,324,348,49,721,0
교대→연산교차로,2023.5.20 10:00,289,0,447,736,0
부산시청→연산교차로,2023.5.20 10:00,613,385,280,1278,0
사직운동장→연산교차로,2023.5.20 10:00,341,631,68,1040,0
신리→연산교차로,2023.5.20 10:00,535,315,58,908,0
안락→연산교차로,2023.5.20 10:00,603,0,123,726,0
연산터널→연산교차로,2023.5.20 10:00,312,380,52,744,0
교대→연산교차로,2023.5.20 11:00,310,0,441,751,0
부산시청→연산교차로,2023.5.20 11:00,596,391,299,1286,0
사직운동장→연산교차로,2023.5.20 11:00,308,621,60,989,0
신리→연산교차로,2023.5.20 11:00,519,306,69,894,0
안락→연산교차로,2023.5.20 11:00,613,0,157,770,0
연산터널→연산교차로,2023.5.20 11:00,331,338,54,723,0
교대→연산교차로,2023.5.20 12:00,313,0,480,793,0
부산시청→연산교차로,2023.5.20 12:00,607,405,255,1267,0
사직운동장→연산교차로,2023.5.20 12:00,293,630,79,1002,0
신리→연산교차로,2023.5.20 12:00,492,318,62,872,0
안락→연산교차로,2023.5.20 12:00,596,0,111,707,0
연산터널→연산교차로,2023.5.20 12:00,322,359,46,727,0
교대→연산교차로,2023.5.20 13:00,357,0,542,899,0
부산시청→연산교차로,2023.5.20 13:00,653,480,303,1436,0
사직운동장→연산교차로,2023.5.20 13:00,272,671,66,1009,0
신리→연산교차로,2023.5.20 13:00,433,324,70,827,0
안락→연산교차로,2023.5.20 13:00,478,0,96,574,0
연산터널→연산교차로,2023.5.20 13:00,260,293,41,594,0
교대→연산교차로,2023.5.20 14:00,379,0,512,891,0
부산시청→연산교차로,2023.5.20 14:00,645,530,302,1477,0
사직운동장→연산교차로,2023.5.20 14:00,306,684,63,1053,0
신리→연산교차로,2023.5.20 14:00,462,299,60,821,0
안락→연산교차로,2023.5.20 14:00,461,0,107,568,0
연산터널→연산교차로,2023.5.20 14:00,239,297,41,577,0
교대→연산교차로,2023.5.20 15:00,351,0,471,822,0
부산시청→연산교차로,2023.5.20 15:00,597,518,283,1398,0
사직운동장→연산교차로,2023.5.20 15:00,289,665,68,1022,0
신리→연산교차로,2023.5.20 15:00,453,332,48,833,0
안락→연산교차로,2023.5.20 15:00,473,0,104,577,0
연산터널→연산교차로,2023.5.20 15:00,230,260,46,536,0
교대→연산교차로,2023.5.20 16:00,350,0,403,753,0
부산시청→연산교차로,2023.5.20 16:00,558,463,233,1254,0
사직운동장→연산교차로,2023.5.20 16:00,278,665,50,993,0
신리→연산교차로,2023.5.20 16:00,455,283,41,779,0
안락→연산교차로,2023.5.20 16:00,464,0,103,567,0
연산터널→연산교차로,2023.5.20 16:00,246,274,53,573,0
교대→연산교차로,2023.5.20 17:00,375,0,372,747,0
부산시청→연산교차로,2023.5.20 17:00,530,417,233,1180,0
사직운동장→연산교차로,2023.5.20 17:00,300,658,71,1029,0
신리→연산교차로,2023.5.20 17:00,486,250,48,784,0
안락→연산교차로,2023.5.20 17:00,491,0,94,585,0
연산터널→연산교차로,2023.5.20 17:00,244,251,49,544,0
교대→연산교차로,2023.5.20 18:00,351,0,425,776,0
부산시청→연산교차로,2023.5.20 18:00,605,442,233,1280,0
사직운동장→연산교차로,2023.5.20 18:00,244,598,81,923,0
신리→연산교차로,2023.5.20 18:00,410,233,33,676,0
안락→연산교차로,2023.5.20 18:00,484,0,105,589,0
연산터널→연산교차로,2023.5.20 18:00,227,269,68,564,0
교대→연산교차로,2023.5.20 19:00,296,0,326,622,0
부산시청→연산교차로,2023.5.20 19:00,506,342,225,1073,0
사직운동장→연산교차로,2023.5.20 19:00,230,518,88,836,0
신리→연산교차로,2023.5.20 19:00,337,205,43,585,0
안락→연산교차로,2023.5.20 19:00,463,0,100,563,0
연산터널→연산교차로,2023.5.20 19:00,201,276,60,537,0
교대→연산교차로,2023.5.20 20:00,314,0,293,607,0
부산시청→연산교차로,2023.5.20 20:00,449,358,170,977,0
사직운동장→연산교차로,2023.5.20 20:00,228,551,53,832,0
신리→연산교차로,2023.5.20 20:00,349,202,30,581,0
안락→연산교차로,2023.5.20 20:00,436,0,93,529,0
연산터널→연산교차로,2023.5.20 20:00,243,257,48,548,0
교대→연산교차로,2023.5.20 21:00,289,0,305,594,0
부산시청→연산교차로,2023.5.20 21:00,423,325,186,934,0
사직운동장→연산교차로,2023.5.20 21:00,258,506,40,804,0
신리→연산교차로,2023.5.20 21:00,332,222,27,581,0
안락→연산교차로,2023.5.20 21:00,393,0,138,531,0
연산터널→연산교차로,2023.5.20 21:00,230,228,59,517,0
교대→연산교차로,2023.5.20 22:00,261,0,246,507,0
부산시청→연산교차로,2023.5.20 22:00,445,310,180,935,0
사직운동장→연산교차로,2023.5.20 22:00,145,370,67,582,0
신리→연산교차로,2023.5.20 22:00,272,180,27,479,0
안락→연산교차로,2023.5.20 22:00,350,0,95,445,0
연산터널→연산교차로,2023.5.20 22:00,204,220,59,483,0
교대→연산교차로,2023.5.20 23:00,223,0,189,412,0
부산시청→연산교차로,2023.5.20 23:00,378,261,133,772,0
사직운동장→연산교차로,2023.5.20 23:00,99,272,53,424,0
신리→연산교차로,2023.5.20 23:00,234,155,21,410,0
안락→연산교차로,2023.5.20 23:00,320,0,67,387,0
연산터널→연산교차로,2023.5.20 23:00,161,211,52,424,0
교대→연산교차로,2023.5.21 00:00,181,0,177,358,1
부산시청→연산교차로,2023.5.21 00:00,353,216,128,697,1
사직운동장→연산교차로,2023.5.21 00:00,93,268,70,431,1
신리→연산교차로,2023.5.21 00:00,226,133,16,375,1
안락→연산교차로,2023.5.21 00:00,293,0,51,344,1
연산터널→연산교차로,2023.5.21 00:00,131,164,45,340,1
교대→연산교차로,2023.5.21 01:00,159,0,185,344,1
부산시청→연산교차로,2023.5.21 01:00,287,177,98,562,1
사직운동장→연산교차로,2023.5.21 01:00,72,201,70,343,1
신리→연산교차로,2023.5.21 01:00,177,101,14,292,1
안락→연산교차로,2023.5.21 01:00,229,0,39,268,1
연산터널→연산교차로,2023.5.21 01:00,123,199,39,361,1
교대→연산교차로,2023.5.21 02:00,128,0,181,309,1
부산시청→연산교차로,2023.5.21 02:00,282,146,98,526,1
사직운동장→연산교차로,2023.5.21 02:00,61,156,52,269,1
신리→연산교차로,2023.5.21 02:00,139,83,15,237,1
안락→연산교차로,2023.5.21 02:00,204,0,34,238,1
연산터널→연산교차로,2023.5.21 02:00,103,165,30,298,1
교대→연산교차로,2023.5.21 03:00,100,0,185,285,1
부산시청→연산교차로,2023.5.21 03:00,214,108,82,404,1
사직운동장→연산교차로,2023.5.21 03:00,66,140,47,253,1
신리→연산교차로,2023.5.21 03:00,115,56,13,184,1
안락→연산교차로,2023.5.21 03:00,141,0,32,173,1
연산터널→연산교차로,2023.5.21 03:00,112,117,31,260,1
교대→연산교차로,2023.5.21 04:00,84,0,128,212,1
부산시청→연산교차로,2023.5.21 04:00,167,103,55,325,1
사직운동장→연산교차로,2023.5.21 04:00,52,118,49,219,1
신리→연산교차로,2023.5.21 04:00,91,50,6,147,1
안락→연산교차로,2023.5.21 04:00,161,0,36,197,1
연산터널→연산교차로,2023.5.21 04:00,98,127,20,245,1
교대→연산교차로,2023.5.21 05:00,70,0,105,175,1
부산시청→연산교차로,2023.5.21 05:00,198,118,66,382,1
사직운동장→연산교차로,2023.5.21 05:00,58,110,33,201,1
신리→연산교차로,2023.5.21 05:00,157,57,6,220,1
안락→연산교차로,2023.5.21 05:00,203,0,50,253,1
연산터널→연산교차로,2023.5.21 05:00,104,125,20,249,1
교대→연산교차로,2023.5.21 06:00,103,0,128,231,1
부산시청→연산교차로,2023.5.21 06:00,226,180,69,475,1
사직운동장→연산교차로,2023.5.21 06:00,64,167,31,262,1
신리→연산교차로,2023.5.21 06:00,155,65,15,235,1
안락→연산교차로,2023.5.21 06:00,255,0,48,303,1
연산터널→연산교차로,2023.5.21 06:00,123,139,27,289,1
교대→연산교차로,2023.5.21 07:00,145,0,137,282,1
부산시청→연산교차로,2023.5.21 07:00,250,200,88,538,1
사직운동장→연산교차로,2023.5.21 07:00,85,220,39,344,1
신리→연산교차로,2023.5.21 07:00,230,96,16,342,1
안락→연산교차로,2023.5.21 07:00,287,0,59,346,1
연산터널→연산교차로,2023.5.21 07:00,137,123,19,279,1
교대→연산교차로,2023.5.21 08:00,172,0,200,372,1
부산시청→연산교차로,2023.5.21 08:00,299,250,136,685,1
사직운동장→연산교차로,2023.5.21 08:00,151,315,45,511,1
신리→연산교차로,2023.5.21 08:00,263,159,17,439,1
안락→연산교차로,2023.5.21 08:00,376,0,78,454,1
연산터널→연산교차로,2023.5.21 08:00,183,183,30,396,1
교대→연산교차로,2023.5.21 09:00,253,0,252,505,1
부산시청→연산교차로,2023.5.21 09:00,409,329,166,904,1
사직운동장→연산교차로,2023.5.21 09:00,186,386,43,615,1
신리→연산교차로,2023.5.21 09:00,392,218,25,635,1
안락→연산교차로,2023.5.21 09:00,459,0,103,562,1
연산터널→연산교차로,2023.5.21 09:00,283,252,35,570,1
교대→연산교차로,2023.5.21 10:00,293,0,319,612,1
부산시청→연산교차로,2023.5.21 10:00,477,352,187,1016,1
사직운동장→연산교차로,2023.5.21 10:00,250,542,59,851,1
신리→연산교차로,2023.5.21 10:00,458,209,27,694,1
안락→연산교차로,2023.5.21 10:00,535,0,101,636,1
연산터널→연산교차로,2023.5.21 10:00,290,309,45,644,1
교대→연산교차로,2023.5.21 11:00,267,0,338,605,1
부산시청→연산교차로,2023.5.21 11:00,459,330,198,987,1
사직운동장→연산교차로,2023.5.21 11:00,225,525,48,798,1
신리→연산교차로,2023.5.21 11:00,420,229,24,673,1
안락→연산교차로,2023.5.21 11:00,567,0,137,704,1
연산터널→연산교차로,2023.5.21 11:00,314,300,39,653,1
교대→연산교차로,2023.5.21 12:00,268,0,357,625,1
부산시청→연산교차로,2023.5.21 12:00,527,368,220,1115,1
사직운동장→연산교차로,2023.5.21 12:00,253,525,62,840,1
신리→연산교차로,2023.5.21 12:00,431,291,33,755,1
안락→연산교차로,2023.5.21 12:00,588,0,140,728,1
연산터널→연산교차로,2023.5.21 12:00,302,259,33,594,1
교대→연산교차로,2023.5.21 13:00,308,0,348,656,1
부산시청→연산교차로,2023.5.21 13:00,521,358,207,1086,1
사직운동장→연산교차로,2023.5.21 13:00,277,578,43,898,1
신리→연산교차로,2023.5.21 13:00,450,254,30,734,1
안락→연산교차로,2023.5.21 13:00,539,0,146,685,1
연산터널→연산교차로,2023.5.21 13:00,279,268,43,590,1
교대→연산교차로,2023.5.21 14:00,317,0,375,692,1
부산시청→연산교차로,2023.5.21 14:00,580,371,244,1195,1
사직운동장→연산교차로,2023.5.21 14:00,267,584,62,913,1
신리→연산교차로,2023.5.21 14:00,410,225,43,678,1
안락→연산교차로,2023.5.21 14:00,518,0,141,659,1
연산터널→연산교차로,2023.5.21 14:00,222,255,69,546,1
교대→연산교차로,2023.5.21 15:00,314,0,352,666,1
부산시청→연산교차로,2023.5.21 15:00,606,386,249,1241,1
사직운동장→연산교차로,2023.5.21 15:00,258,577,55,890,1
신리→연산교차로,2023.5.21 15:00,383,214,42,639,1
안락→연산교차로,2023.5.21 15:00,549,0,119,668,1
연산터널→연산교차로,2023.5.21 15:00,233,271,48,552,1
교대→연산교차로,2023.5.21 16:00,311,0,327,638,1
부산시청→연산교차로,2023.5.21 16:00,542,330,239,1111,1
사직운동장→연산교차로,2023.5.21 16:00,245,573,30,848,1
신리→연산교차로,2023.5.21 16:00,420,212,35,667,1
안락→연산교차로,2023.5.21 16:00,534,0,111,645,1
연산터널→연산교차로,2023.5.21 16:00,286,269,49,604,1
교대→연산교차로,2023.5.21 17:00,315,0,320,635,1
부산시청→연산교차로,2023.5.21 17:00,509,370,221,1100,1
사직운동장→연산교차로,2023.5.21 17:00,240,537,69,846,1
신리→연산교차로,2023.5.21 17:00,388,205,27,620,1
안락→연산교차로,2023.5.21 17:00,545,0,131,676,1
연산터널→연산교차로,2023.5.21 17:00,251,301,53,605,1
교대→연산교차로,2023.5.21 18:00,307,0,300,607,1
부산시청→연산교차로,2023.5.21 18:00,498,353,214,1065,1
사직운동장→연산교차로,2023.5.21 18:00,285,557,57,899,1
신리→연산교차로,2023.5.21 18:00,314,193,28,535,1
안락→연산교차로,2023.5.21 18:00,505,0,117,622,1
연산터널→연산교차로,2023.5.21 18:00,229,286,51,566,1
교대→연산교차로,2023.5.21 19:00,285,0,271,556,1
부산시청→연산교차로,2023.5.21 19:00,462,303,190,955,1
사직운동장→연산교차로,2023.5.21 19:00,196,412,44,652,1
신리→연산교차로,2023.5.21 19:00,305,165,30,500,1
안락→연산교차로,2023.5.21 19:00,450,0,86,536,1
연산터널→연산교차로,2023.5.21 19:00,207,230,56,493,1
교대→연산교차로,2023.5.21 20:00,284,0,267,551,1
부산시청→연산교차로,2023.5.21 20:00,424,275,216,915,1
사직운동장→연산교차로,2023.5.21 20:00,178,401,47,626,1
신리→연산교차로,2023.5.21 20:00,351,178,25,554,1
안락→연산교차로,2023.5.21 20:00,431,0,122,553,1
연산터널→연산교차로,2023.5.21 20:00,230,213,47,490,1
교대→연산교차로,2023.5.21 21:00,257,0,195,452,1
부산시청→연산교차로,2023.5.21 21:00,397,244,171,812,1
사직운동장→연산교차로,2023.5.21 21:00,134,345,42,521,1
신리→연산교차로,2023.5.21 21:00,284,145,27,456,1
안락→연산교차로,2023.5.21 21:00,409,0,90,499,1
연산터널→연산교차로,2023.5.21 21:00,191,213,32,436,1
교대→연산교차로,2023.5.21 22:00,196,0,195,391,1
부산시청→연산교차로,2023.5.21 22:00,344,209,135,688,1
사직운동장→연산교차로,2023.5.21 22:00,103,316,51,470,1
신리→연산교차로,2023.5.21 22:00,242,131,18,391,1
안락→연산교차로,2023.5.21 22:00,306,0,51,357,1
연산터널→연산교차로,2023.5.21 22:00,159,170,41,370,1
교대→연산교차로,2023.5.21 23:00,132,0,140,272,1
부산시청→연산교차로,2023.5.21 23:00,269,154,97,520,1
사직운동장→연산교차로,2023.5.21 23:00,85,231,53,369,1
신리→연산교차로,2023.5.21 23:00,199,102,23,324,1
안락→연산교차로,2023.5.21 23:00,226,0,37,263,1
연산터널→연산교차로,2023.5.21 23:00,140,134,57,331,1
교대→연산교차로,2023.5.22 00:00,111,0,148,259,0
부산시청→연산교차로,2023.5.22 00:00,199,127,84,410,0
사직운동장→연산교차로,2023.5.22 00:00,66,173,65,304,0
신리→연산교차로,2023.5.22 00:00,135,60,22,217,0
안락→연산교차로,2023.5.22 00:00,171,0,50,221,0
연산터널→연산교차로,2023.5.22 00:00,96,130,56,282,0
교대→연산교차로,2023.5.22 01:00,66,0,111,177,0
부산시청→연산교차로,2023.5.22 01:00,168,70,68,306,0
사직운동장→연산교차로,2023.5.22 01:00,44,123,35,202,0
신리→연산교차로,2023.5.22 01:00,100,50,7,157,0
안락→연산교차로,2023.5.22 01:00,125,0,32,157,0
연산터널→연산교차로,2023.5.22 01:00,70,96,30,196,0
교대→연산교차로,2023.5.22 02:00,60,0,101,161,0
부산시청→연산교차로,2023.5.22 02:00,130,76,53,259,0
사직운동장→연산교차로,2023.5.22 02:00,29,112,39,180,0
신리→연산교차로,2023.5.22 02:00,63,38,10,111,0
안락→연산교차로,2023.5.22 02:00,120,0,20,140,0
연산터널→연산교차로,2023.5.22 02:00,67,84,38,189,0
교대→연산교차로,2023.5.22 03:00,41,0,74,115,0
부산시청→연산교차로,2023.5.22 03:00,119,54,43,216,0
사직운동장→연산교차로,2023.5.22 03:00,28,98,22,148,0
신리→연산교차로,2023.5.22 03:00,68,30,7,105,0
안락→연산교차로,2023.5.22 03:00,84,0,16,100,0
연산터널→연산교차로,2023.5.22 03:00,49,84,28,161,0
교대→연산교차로,2023.5.22 04:00,46,0,61,107,0
부산시청→연산교차로,2023.5.22 04:00,133,67,33,233,0
사직운동장→연산교차로,2023.5.22 04:00,27,82,20,129,0
신리→연산교차로,2023.5.22 04:00,91,43,7,141,0
안락→연산교차로,2023.5.22 04:00,184,0,29,213,0
연산터널→연산교차로,2023.5.22 04:00,83,86,21,190,0
교대→연산교차로,2023.5.22 05:00,101,0,136,237,0
부산시청→연산교차로,2023.5.22 05:00,252,163,81,496,0
사직운동장→연산교차로,2023.5.22 05:00,49,148,27,224,0
신리→연산교차로,2023.5.22 05:00,245,82,6,333,0
안락→연산교차로,2023.5.22 05:00,344,0,51,395,0
연산터널→연산교차로,2023.5.22 05:00,127,146,23,296,0
교대→연산교차로,2023.5.22 06:00,201,0,252,453,0
부산시청→연산교차로,2023.5.22 06:00,405,269,129,803,0
사직운동장→연산교차로,2023.5.22 06:00,100,290,51,441,0
신리→연산교차로,2023.5.22 06:00,340,151,18,509,0
안락→연산교차로,2023.5.22 06:00,550,0,87,637,0
연산터널→연산교차로,2023.5.22 06:00,226,254,38,518,0
교대→연산교차로,2023.5.22 07:00,257,0,454,711,0
부산시청→연산교차로,2023.5.22 07:00,564,400,261,1225,0
사직운동장→연산교차로,2023.5.22 07:00,217,504,70,791,0
신리→연산교차로,2023.5.22 07:00,512,272,35,819,0
안락→연산교차로,2023.5.22 07:00,627,0,81,708,0
연산터널→연산교차로,2023.5.22 07:00,282,360,42,684,0
교대→연산교차로,2023.5.22 08:00,328,0,520,848,0
부산시청→연산교차로,2023.5.22 08:00,593,412,355,1360,0
사직운동장→연산교차로,2023.5.22 08:00,270,678,79,1027,0
신리→연산교차로,2023.5.22 08:00,506,355,36,897,0
안락→연산교차로,2023.5.22 08:00,634,0,121,755,0
연산터널→연산교차로,2023.5.22 08:00,344,374,31,749,0
교대→연산교차로,2023.5.22 09:00,298,0,542,840,0
부산시청→연산교차로,2023.5.22 09:00,509,380,261,1150,0
사직운동장→연산교차로,2023.5.22 09:00,255,583,102,940,0
신리→연산교차로,2023.5.22 09:00,482,316,47,845,0
안락→연산교차로,2023.5.22 09:00,611,0,107,718,0
연산터널→연산교차로,2023.5.22 09:00,317,334,62,713,0
교대→연산교차로,2023.5.22 10:00,294,0,423,717,0
부산시청→연산교차로,2023.5.22 10:00,516,373,243,1132,0
사직운동장→연산교차로,2023.5.22 10:00,373,570,69,1012,0
신리→연산교차로,2023.5.22 10:00,407,277,57,741,0
안락→연산교차로,2023.5.22 10:00,553,0,148,701,0
연산터널→연산교차로,2023.5.22 10:00,317,340,41,698,0
교대→연산교차로,2023.5.22 11:00,292,0,467,759,0
부산시청→연산교차로,2023.5.22 11:00,571,393,286,1250,0
사직운동장→연산교차로,2023.5.22 11:00,310,552,94,956,0
신리→연산교차로,2023.5.22 11:00,468,253,51,772,0
안락→연산교차로,2023.5.22 11:00,520,0,141,661,0
연산터널→연산교차로,2023.5.22 11:00,275,274,59,608,0
교대→연산교차로,2023.5.22 12:00,283,0,408,691,0
부산시청→연산교차로,2023.5.22 12:00,555,361,233,1149,0
사직운동장→연산교차로,2023.5.22 12:00,222,566,87,875,0
신리→연산교차로,2023.5.22 12:00,404,252,53,709,0
안락→연산교차로,2023.5.22 12:00,486,0,126,612,0
연산터널→연산교차로,2023.5.22 12:00,296,261,40,597,0
교대→연산교차로,2023.5.22 13:00,315,0,450,765,0
부산시청→연산교차로,2023.5.22 13:00,560,436,325,1321,0
사직운동장→연산교차로,2023.5.22 13:00,327,618,87,1032,0
신리→연산교차로,2023.5.22 13:00,458,262,51,771,0
안락→연산교차로,2023.5.22 13:00,456,0,123,579,0
연산터널→연산교차로,2023.5.22 13:00,246,259,52,557,0
교대→연산교차로,2023.5.22 14:00,336,0,517,853,0
부산시청→연산교차로,2023.5.22 14:00,517,425,335,1277,0
사직운동장→연산교차로,2023.5.22 14:00,344,573,102,1019,0
신리→연산교차로,2023.5.22 14:00,469,285,64,818,0
안락→연산교차로,2023.5.22 14:00,440,0,115,555,0
연산터널→연산교차로,2023.5.22 14:00,236,286,49,571,0
교대→연산교차로,2023.5.22 15:00,349,0,490,839,0
부산시청→연산교차로,2023.5.22 15:00,598,468,295,1361,0
사직운동장→연산교차로,2023.5.22 15:00,424,621,95,1140,0
신리→연산교차로,2023.5.22 15:00,495,259,59,813,0
안락→연산교차로,2023.5.22 15:00,449,0,110,559,0
연산터널→연산교차로,2023.5.22 15:00,223,294,42,559,0
교대→연산교차로,2023.5.22 16:00,348,0,495,843,0
부산시청→연산교차로,2023.5.22 16:00,622,464,292,1378,0
사직운동장→연산교차로,2023.5.22 16:00,400,655,70,1125,0
신리→연산교차로,2023.5.22 16:00,502,286,59,847,0
안락→연산교차로,2023.5.22 16:00,445,0,113,558,0
연산터널→연산교차로,2023.5.22 16:00,239,273,43,555,0
교대→연산교차로,2023.5.22 17:00,376,0,516,892,0
부산시청→연산교차로,2023.5.22 17:00,616,572,298,1486,0
사직운동장→연산교차로,2023.5.22 17:00,328,668,79,1075,0
신리→연산교차로,2023.5.22 17:00,521,302,45,868,0
안락→연산교차로,2023.5.22 17:00,468,0,95,563,0
연산터널→연산교차로,2023.5.22 17:00,244,277,42,563,0
교대→연산교차로,2023.5.22 18:00,373,0,553,926,0
부산시청→연산교차로,2023.5.22 18:00,594,553,347,1494,0
사직운동장→연산교차로,2023.5.22 18:00,389,668,34,1091,0
신리→연산교차로,2023.5.22 18:00,478,255,52,785,0
안락→연산교차로,2023.5.22 18:00,481,0,106,587,0
연산터널→연산교차로,2023.5.22 18:00,254,296,49,599,0
교대→연산교차로,2023.5.22 19:00,314,0,424,738,0
부산시청→연산교차로,2023.5.22 19:00,516,395,262,1173,0
사직운동장→연산교차로,2023.5.22 19:00,176,531,74,781,0
신리→연산교차로,2023.5.22 19:00,354,212,36,602,0
안락→연산교차로,2023.5.22 19:00,403,0,96,499,0
연산터널→연산교차로,2023.5.22 19:00,207,275,60,542,0
교대→연산교차로,2023.5.22 20:00,291,0,305,596,0
부산시청→연산교차로,2023.5.22 20:00,483,351,240,1074,0
사직운동장→연산교차로,2023.5.22 20:00,185,452,81,718,0
신리→연산교차로,2023.5.22 20:00,331,165,33,529,0
안락→연산교차로,2023.5.22 20:00,388,0,112,500,0
연산터널→연산교차로,2023.5.22 20:00,186,225,60,471,0
교대→연산교차로,2023.5.22 21:00,239,0,285,524,0
부산시청→연산교차로,2023.5.22 21:00,513,331,222,1066,0
사직운동장→연산교차로,2023.5.22 21:00,147,425,79,651,0
신리→연산교차로,2023.5.22 21:00,270,159,29,458,0
안락→연산교차로,2023.5.22 21:00,359,0,79,438,0
연산터널→연산교차로,2023.5.22 21:00,222,264,59,545,0
교대→연산교차로,2023.5.22 22:00,230,0,232,462,0
부산시청→연산교차로,2023.5.22 22:00,390,272,143,805,0
사직운동장→연산교차로,2023.5.22 22:00,130,376,81,587,0
신리→연산교차로,2023.5.22 22:00,268,127,22,417,0
안락→연산교차로,2023.5.22 22:00,324,0,110,434,0
연산터널→연산교차로,2023.5.22 22:00,212,223,60,495,0
교대→연산교차로,2023.5.22 23:00,157,0,158,315,0
부산시청→연산교차로,2023.5.22 23:00,280,174,129,583,0
사직운동장→연산교차로,2023.5.22 23:00,94,221,56,371,0
신리→연산교차로,2023.5.22 23:00,174,108,15,297,0
안락→연산교차로,2023.5.22 23:00,239,0,61,300,0
연산터널→연산교차로,2023.5.22 23:00,124,170,47,341,0
교대→연산교차로,2023.5.23 00:00,122,0,155,277,0
부산시청→연산교차로,2023.5.23 00:00,232,136,106,474,0
사직운동장→연산교차로,2023.5.23 00:00,75,219,75,369,0
신리→연산교차로,2023.5.23 00:00,148,91,17,256,0
안락→연산교차로,2023.5.23 00:00,180,0,45,225,0
연산터널→연산교차로,2023.5.23 00:00,140,151,58,349,0
교대→연산교차로,2023.5.23 01:00,88,0,146,234,0
부산시청→연산교차로,2023.5.23 01:00,185,116,66,367,0
사직운동장→연산교차로,2023.5.23 01:00,61,175,63,299,0
신리→연산교차로,2023.5.23 01:00,102,60,11,173,0
안락→연산교차로,2023.5.23 01:00,150,0,28,178,0
연산터널→연산교차로,2023.5.23 01:00,118,132,45,295,0
교대→연산교차로,2023.5.23 02:00,81,0,107,188,0
부산시청→연산교차로,2023.5.23 02:00,165,87,61,313,0
사직운동장→연산교차로,2023.5.23 02:00,36,128,43,207,0
신리→연산교차로,2023.5.23 02:00,75,43,14,132,0
안락→연산교차로,2023.5.23 02:00,131,0,28,159,0
연산터널→연산교차로,2023.5.23 02:00,96,112,36,244,0
교대→연산교차로,2023.5.23 03:00,50,0,95,145,0
부산시청→연산교차로,2023.5.23 03:00,142,73,39,254,0
사직운동장→연산교차로,2023.5.23 03:00,31,124,49,204,0
신리→연산교차로,2023.5.23 03:00,69,42,10,121,0
안락→연산교차로,2023.5.23 03:00,107,0,27,134,0
연산터널→연산교차로,2023.5.23 03:00,66,92,43,201,0
교대→연산교차로,2023.5.23 04:00,46,0,87,133,0
부산시청→연산교차로,2023.5.23 04:00,142,77,42,261,0
사직운동장→연산교차로,2023.5.23 04:00,24,89,37,150,0
신리→연산교차로,2023.5.23 04:00,99,45,4,148,0
안락→연산교차로,2023.5.23 04:00,175,0,32,207,0
연산터널→연산교차로,2023.5.23 04:00,75,98,29,202,0
교대→연산교차로,2023.5.23 05:00,101,0,166,267,0
부산시청→연산교차로,2023.5.23 05:00,255,167,91,513,0
사직운동장→연산교차로,2023.5.23 05:00,56,166,35,257,0
신리→연산교차로,2023.5.23 05:00,241,106,9,356,0
안락→연산교차로,2023.5.23 05:00,328,0,78,406,0
연산터널→연산교차로,2023.5.23 05:00,139,152,37,328,0
교대→연산교차로,2023.5.23 06:00,192,0,273,465,0
부산시청→연산교차로,2023.5.23 06:00,361,256,145,762,0
사직운동장→연산교차로,2023.5.23 06:00,97,293,51,441,0
신리→연산교차로,2023.5.23 06:00,352,147,33,532,0
안락→연산교차로,2023.5.23 06:00,517,0,72,589,0
연산터널→연산교차로,2023.5.23 06:00,248,237,39,524,0
교대→연산교차로,2023.5.23 07:00,261,0,380,641,0
부산시청→연산교차로,2023.5.23 07:00,545,368,239,1152,0
사직운동장→연산교차로,2023.5.23 07:00,217,501,64,782,0
신리→연산교차로,2023.5.23 07:00,527,251,34,812,0
안락→연산교차로,2023.5.23 07:00,646,0,59,705,0
연산터널→연산교차로,2023.5.23 07:00,291,374,38,703,0
교대→연산교차로,2023.5.23 08:00,330,0,497,827,0
부산시청→연산교차로,2023.5.23 08:00,587,444,310,1341,0
사직운동장→연산교차로,2023.5.23 08:00,243,634,48,925,0
신리→연산교차로,2023.5.23 08:00,474,328,22,824,0
안락→연산교차로,2023.5.23 08:00,634,0,85,719,0
연산터널→연산교차로,2023.5.23 08:00,316,388,40,744,0
교대→연산교차로,2023.5.23 09:00,288,0,530,818,0
부산시청→연산교차로,2023.5.23 09:00,537,387,254,1178,0
사직운동장→연산교차로,2023.5.23 09:00,296,569,88,953,0
신리→연산교차로,2023.5.23 09:00,469,326,39,834,0
안락→연산교차로,2023.5.23 09:00,605,0,100,705,0
연산터널→연산교차로,2023.5.23 09:00,294,361,40,695,0
교대→연산교차로,2023.5.23 10:00,289,0,483,772,0
부산시청→연산교차로,2023.5.23 10:00,520,382,298,1200,0
사직운동장→연산교차로,2023.5.23 10:00,336,574,66,976,0
신리→연산교차로,2023.5.23 10:00,461,293,66,820,0
안락→연산교차로,2023.5.23 10:00,605,0,131,736,0
연산터널→연산교차로,2023.5.23 10:00,309,347,53,709,0
교대→연산교차로,2023.5.23 11:00,280,0,461,741,0
부산시청→연산교차로,2023.5.23 11:00,574,373,265,1212,0
사직운동장→연산교차로,2023.5.23 11:00,289,565,91,945,0
신리→연산교차로,2023.5.23 11:00,459,225,50,734,0
안락→연산교차로,2023.5.23 11:00,508,0,141,649,0
연산터널→연산교차로,2023.5.23 11:00,265,297,50,612,0
교대→연산교차로,2023.5.23 12:00,288,0,365,653,0
부산시청→연산교차로,2023.5.23 12:00,580,354,229,1163,0
사직운동장→연산교차로,2023.5.23 12:00,225,540,76,841,0
신리→연산교차로,2023.5.23 12:00,410,240,54,704,0
안락→연산교차로,2023.5.23 12:00,499,0,173,672,0
연산터널→연산교차로,2023.5.23 12:00,296,269,48,613,0
교대→연산교차로,2023.5.23 13:00,349,0,432,781,0
부산시청→연산교차로,2023.5.23 13:00,580,429,274,1283,0
사직운동장→연산교차로,2023.5.23 13:00,280,553,90,923,0
신리→연산교차로,2023.5.23 13:00,407,262,59,728,0
안락→연산교차로,2023.5.23 13:00,459,0,127,586,0
연산터널→연산교차로,2023.5.23 13:00,242,270,32,544,0
교대→연산교차로,2023.5.23 14:00,341,0,511,852,0
부산시청→연산교차로,2023.5.23 14:00,551,427,322,1300,0
사직운동장→연산교차로,2023.5.23 14:00,294,595,102,991,0
신리→연산교차로,2023.5.23 14:00,484,271,44,799,0
안락→연산교차로,2023.5.23 14:00,451,0,114,565,0
연산터널→연산교차로,2023.5.23 14:00,225,283,56,564,0
교대→연산교차로,2023.5.23 15:00,361,0,504,865,0
부산시청→연산교차로,2023.5.23 15:00,615,479,255,1349,0
사직운동장→연산교차로,2023.5.23 15:00,239,593,98,930,0
신리→연산교차로,2023.5.23 15:00,463,232,56,751,0
안락→연산교차로,2023.5.23 15:00,447,0,88,535,0
연산터널→연산교차로,2023.5.23 15:00,216,291,56,563,0
교대→연산교차로,2023.5.23 16:00,363,0,468,831,0
부산시청→연산교차로,2023.5.23 16:00,601,517,301,1419,0
사직운동장→연산교차로,2023.5.23 16:00,319,624,51,994,0
신리→연산교차로,2023.5.23 16:00,494,298,60,852,0
안락→연산교차로,2023.5.23 16:00,466,0,81,547,0
연산터널→연산교차로,2023.5.23 16:00,240,278,30,548,0
교대→연산교차로,2023.5.23 17:00,363,0,482,845,0
부산시청→연산교차로,2023.5.23 17:00,617,556,320,1493,0
사직운동장→연산교차로,2023.5.23 17:00,298,687,65,1050,0
신리→연산교차로,2023.5.23 17:00,488,314,69,871,0
안락→연산교차로,2023.5.23 17:00,453,0,89,542,0
연산터널→연산교차로,2023.5.23 17:00,261,280,33,574,0
교대→연산교차로,2023.5.23 18:00,373,0,574,947,0
부산시청→연산교차로,2023.5.23 18:00,598,565,363,1526,0
사직운동장→연산교차로,2023.5.23 18:00,287,714,56,1057,0
신리→연산교차로,2023.5.23 18:00,492,283,53,828,0
안락→연산교차로,2023.5.23 18:00,479,0,90,569,0
연산터널→연산교차로,2023.5.23 18:00,212,281,57,550,0
교대→연산교차로,2023.5.23 19:00,342,0,428,770,0
부산시청→연산교차로,2023.5.23 19:00,521,402,253,1176,0
사직운동장→연산교차로,2023.5.23 19:00,188,568,73,829,0
신리→연산교차로,2023.5.23 19:00,360,243,46,649,0
안락→연산교차로,2023.5.23 19:00,452,0,99,551,0
연산터널→연산교차로,2023.5.23 19:00,218,240,66,524,0
교대→연산교차로,2023.5.23 20:00,289,0,299,588,0
부산시청→연산교차로,2023.5.23 20:00,483,340,257,1080,0
사직운동장→연산교차로,2023.5.23 20:00,180,474,84,738,0
신리→연산교차로,2023.5.23 20:00,300,168,29,497,0
안락→연산교차로,2023.5.23 20:00,375,0,91,466,0
연산터널→연산교차로,2023.5.23 20:00,232,270,64,566,0
교대→연산교차로,2023.5.23 21:00,292,0,283,575,0
부산시청→연산교차로,2023.5.23 21:00,506,349,208,1063,0
사직운동장→연산교차로,2023.5.23 21:00,195,491,51,737,0
신리→연산교차로,2023.5.23 21:00,286,207,42,535,0
안락→연산교차로,2023.5.23 21:00,403,0,106,509,0
연산터널→연산교차로,2023.5.23 21:00,236,285,48,569,0
교대→연산교차로,2023.5.23 22:00,266,0,264,530,0
부산시청→연산교차로,2023.5.23 22:00,411,301,172,884,0
사직운동장→연산교차로,2023.5.23 22:00,219,407,51,677,0
신리→연산교차로,2023.5.23 22:00,251,154,27,432,0
안락→연산교차로,2023.5.23 22:00,348,0,91,439,0
연산터널→연산교차로,2023.5.23 22:00,204,239,51,494,0
교대→연산교차로,2023.5.23 23:00,186,0,162,348,0
부산시청→연산교차로,2023.5.23 23:00,314,201,133,648,0
사직운동장→연산교차로,2023.5.23 23:00,130,279,56,465,0
신리→연산교차로,2023.5.23 23:00,203,135,18,356,0
안락→연산교차로,2023.5.23 23:00,247,0,71,318,0
연산터널→연산교차로,2023.5.23 23:00,149,169,51,369,0
교대→연산교차로,2023.5.24 00:00,138,0,163,301,0
부산시청→연산교차로,2023.5.24 00:00,273,150,100,523,0
사직운동장→연산교차로,2023.5.24 00:00,82,244,59,385,0
신리→연산교차로,2023.5.24 00:00,164,102,11,277,0
안락→연산교차로,2023.5.24 00:00,245,0,51,296,0
연산터널→연산교차로,2023.5.24 00:00,136,156,48,340,0
교대→연산교차로,2023.5.24 01:00,104,0,149,253,0
부산시청→연산교차로,2023.5.24 01:00,189,124,85,398,0
사직운동장→연산교차로,2023.5.24 01:00,63,178,57,298,0
신리→연산교차로,2023.5.24 01:00,127,77,12,216,0
안락→연산교차로,2023.5.24 01:00,160,0,36,196,0
연산터널→연산교차로,2023.5.24 01:00,123,141,47,311,0
교대→연산교차로,2023.5.24 02:00,70,0,127,197,0
부산시청→연산교차로,2023.5.24 02:00,177,99,55,331,0
사직운동장→연산교차로,2023.5.24 02:00,68,138,46,252,0
신리→연산교차로,2023.5.24 02:00,83,44,10,137,0
안락→연산교차로,2023.5.24 02:00,123,0,41,164,0
연산터널→연산교차로,2023.5.24 02:00,89,112,44,245,0
교대→연산교차로,2023.5.24 03:00,65,0,87,152,0
부산시청→연산교차로,2023.5.24 03:00,157,68,42,267,0
사직운동장→연산교차로,2023.5.24 03:00,29,108,37,174,0
신리→연산교차로,2023.5.24 03:00,86,33,6,125,0
안락→연산교차로,2023.5.24 03:00,117,0,35,152,0
연산터널→연산교차로,2023.5.24 03:00,73,104,46,223,0
교대→연산교차로,2023.5.24 04:00,56,0,75,131,0
부산시청→연산교차로,2023.5.24 04:00,147,65,46,258,0
사직운동장→연산교차로,2023.5.24 04:00,47,121,35,203,0
신리→연산교차로,2023.5.24 04:00,86,44,11,141,0
안락→연산교차로,2023.5.24 04:00,176,0,40,216,0
연산터널→연산교차로,2023.5.24 04:00,99,91,43,233,0
교대→연산교차로,2023.5.24 05:00,95,0,154,249,0
부산시청→연산교차로,2023.5.24 05:00,235,171,84,490,0
사직운동장→연산교차로,2023.5.24 05:00,70,161,38,269,0
신리→연산교차로,2023.5.24 05:00,218,109,6,333,0
안락→연산교차로,2023.5.24 05:00,374,0,58,432,0
연산터널→연산교차로,2023.5.24 05:00,129,157,34,320,0
교대→연산교차로,2023.5.24 06:00,200,0,250,450,0
부산시청→연산교차로,2023.5.24 06:00,392,286,113,791,0
사직운동장→연산교차로,2023.5.24 06:00,107,291,49,447,0
신리→연산교차로,2023.5.24 06:00,333,148,20,501,0
안락→연산교차로,2023.5.24 06:00,518,0,78,596,0
연산터널→연산교차로,2023.5.24 06:00,225,241,31,497,0
교대→연산교차로,2023.5.24 07:00,240,0,424,664,0
부산시청→연산교차로,2023.5.24 07:00,527,407,223,1157,0
사직운동장→연산교차로,2023.5.24 07:00,202,505,70,777,0
신리→연산교차로,2023.5.24 07:00,471,248,32,751,0
안락→연산교차로,2023.5.24 07:00,613,0,74,687,0
연산터널→연산교차로,2023.5.24 07:00,278,338,48,664,0
교대→연산교차로,2023.5.24 08:00,334,0,491,825,0
부산시청→연산교차로,2023.5.24 08:00,551,410,318,1279,0
사직운동장→연산교차로,2023.5.24 08:00,238,629,90,957,0
신리→연산교차로,2023.5.24 08:00,535,357,19,911,0
안락→연산교차로,2023.5.24 08:00,649,0,104,753,0
연산터널→연산교차로,2023.5.24 08:00,320,383,35,738,0
교대→연산교차로,2023.5.24 09:00,293,0,513,806,0
부산시청→연산교차로,2023.5.24 09:00,506,355,293,1154,0
사직운동장→연산교차로,2023.5.24 09:00,281,586,82,949,0
신리→연산교차로,2023.5.24 09:00,480,314,35,829,0
안락→연산교차로,2023.5.24 09:00,591,0,83,674,0
연산터널→연산교차로,2023.5.24 09:00,289,351,47,687,0
교대→연산교차로,2023.5.24 10:00,306,0,458,764,0
부산시청→연산교차로,2023.5.24 10:00,540,354,266,1160,0
사직운동장→연산교차로,2023.5.24 10:00,332,539,48,919,0
신리→연산교차로,2023.5.24 10:00,435,268,58,761,0
안락→연산교차로,2023.5.24 10:00,556,0,132,688,0
연산터널→연산교차로,2023.5.24 10:00,302,325,40,667,0
교대→연산교차로,2023.5.24 11:00,293,0,420,713,0
부산시청→연산교차로,2023.5.24 11:00,580,381,290,1251,0
사직운동장→연산교차로,2023.5.24 11:00,313,534,67,914,0
신리→연산교차로,2023.5.24 11:00,424,238,52,714,0
안락→연산교차로,2023.5.24 11:00,554,0,159,713,0
연산터널→연산교차로,2023.5.24 11:00,257,320,60,637,0
교대→연산교차로,2023.5.24 12:00,294,0,381,675,0
부산시청→연산교차로,2023.5.24 12:00,541,354,244,1139,0
사직운동장→연산교차로,2023.5.24 12:00,235,540,76,851,0
신리→연산교차로,2023.5.24 12:00,388,206,44,638,0
안락→연산교차로,2023.5.24 12:00,473,0,156,629,0
연산터널→연산교차로,2023.5.24 12:00,265,306,38,609,0
교대→연산교차로,2023.5.24 13:00,330,0,387,717,0
부산시청→연산교차로,2023.5.24 13:00,586,435,251,1272,0
사직운동장→연산교차로,2023.5.24 13:00,298,578,67,943,0
신리→연산교차로,2023.5.24 13:00,429,254,41,724,0
안락→연산교차로,2023.5.24 13:00,447,0,110,557,0
연산터널→연산교차로,2023.5.24 13:00,235,267,27,529,0
교대→연산교차로,2023.5.24 14:00,334,0,539,873,0
부산시청→연산교차로,2023.5.24 14:00,598,481,321,1400,0
사직운동장→연산교차로,2023.5.24 14:00,334,612,83,1029,0
신리→연산교차로,2023.5.24 14:00,450,249,54,753,0
안락→연산교차로,2023.5.24 14:00,430,0,114,544,0
연산터널→연산교차로,2023.5.24 14:00,234,282,54,570,0
교대→연산교차로,2023.5.24 15:00,354,0,483,837,0
부산시청→연산교차로,2023.5.24 15:00,593,471,310,1374,0
사직운동장→연산교차로,2023.5.24 15:00,308,641,89,1038,0
신리→연산교차로,2023.5.24 15:00,438,286,49,773,0
안락→연산교차로,2023.5.24 15:00,470,0,116,586,0
연산터널→연산교차로,2023.5.24 15:00,232,274,50,556,0
교대→연산교차로,2023.5.24 16:00,354,0,496,850,0
부산시청→연산교차로,2023.5.24 16:00,589,501,309,1399,0
사직운동장→연산교차로,2023.5.24 16:00,324,638,70,1032,0
신리→연산교차로,2023.5.24 16:00,495,306,54,855,0
안락→연산교차로,2023.5.24 16:00,460,0,104,564,0
연산터널→연산교차로,2023.5.24 16:00,248,264,44,556,0
교대→연산교차로,2023.5.24 17:00,364,0,581,945,0
부산시청→연산교차로,2023.5.24 17:00,625,564,312,1501,0
사직운동장→연산교차로,2023.5.24 17:00,334,663,69,1066,0
신리→연산교차로,2023.5.24 17:00,518,308,48,874,0
안락→연산교차로,2023.5.24 17:00,461,0,103,564,0
연산터널→연산교차로,2023.5.24 17:00,234,285,39,558,0
교대→연산교차로,2023.5.24 18:00,385,0,512,897,0
부산시청→연산교차로,2023.5.24 18:00,578,553,370,1501,0
사직운동장→연산교차로,2023.5.24 18:00,288,708,58,1054,0
신리→연산교차로,2023.5.24 18:00,504,292,34,830,0
안락→연산교차로,2023.5.24 18:00,492,0,88,580,0
연산터널→연산교차로,2023.5.24 18:00,260,266,53,579,0
교대→연산교차로,2023.5.24 19:00,337,0,403,740,0
부산시청→연산교차로,2023.5.24 19:00,539,390,265,1194,0
사직운동장→연산교차로,2023.5.24 19:00,177,540,74,791,0
신리→연산교차로,2023.5.24 19:00,346,193,31,570,0
안락→연산교차로,2023.5.24 19:00,418,0,113,531,0
연산터널→연산교차로,2023.5.24 19:00,206,236,58,500,0
교대→연산교차로,2023.5.24 20:00,311,0,314,625,0
부산시청→연산교차로,2023.5.24 20:00,510,392,254,1156,0
사직운동장→연산교차로,2023.5.24 20:00,168,474,98,740,0
신리→연산교차로,2023.5.24 20:00,338,180,41,559,0
안락→연산교차로,2023.5.24 20:00,392,0,107,499,0
연산터널→연산교차로,2023.5.24 20:00,185,289,53,527,0
교대→연산교차로,2023.5.24 21:00,279,0,308,587,0
부산시청→연산교차로,2023.5.24 21:00,482,355,200,1037,0
사직운동장→연산교차로,2023.5.24 21:00,183,458,60,701,0
신리→연산교차로,2023.5.24 21:00,338,189,29,556,0
안락→연산교차로,2023.5.24 21:00,393,0,110,503,0
연산터널→연산교차로,2023.5.24 21:00,209,259,60,528,0
교대→연산교차로,2023.5.24 22:00,252,0,245,497,0
부산시청→연산교차로,2023.5.24 22:00,425,255,171,851,0
사직운동장→연산교차로,2023.5.24 22:00,238,442,50,730,0
신리→연산교차로,2023.5.24 22:00,247,170,37,454,0
안락→연산교차로,2023.5.24 22:00,368,0,90,458,0
연산터널→연산교차로,2023.5.24 22:00,206,235,51,492,0
교대→연산교차로,2023.5.24 23:00,199,0,168,367,0
부산시청→연산교차로,2023.5.24 23:00,301,185,106,592,0
사직운동장→연산교차로,2023.5.24 23:00,114,294,64,472,0
신리→연산교차로,2023.5.24 23:00,210,126,14,350,0
안락→연산교차로,2023.5.24 23:00,293,0,66,359,0
연산터널→연산교차로,2023.5.24 23:00,132,180,60,372,0
교대→연산교차로,2023.5.25 00:00,159,0,171,330,0
부산시청→연산교차로,2023.5.25 00:00,266,165,109,540,0
사직운동장→연산교차로,2023.5.25 00:00,98,228,50,376,0
신리→연산교차로,2023.5.25 00:00,169,103,18,290,0
안락→연산교차로,2023.5.25 00:00,236,0,61,297,0
연산터널→연산교차로,2023.5.25 00:00,136,161,47,344,0
교대→연산교차로,2023.5.25 01:00,113,0,129,242,0
부산시청→연산교차로,2023.5.25 01:00,221,119,92,432,0
사직운동장→연산교차로,2023.5.25 01:00,71,182,51,304,0
신리→연산교차로,2023.5.25 01:00,126,83,17,226,0
안락→연산교차로,2023.5.25 01:00,186,0,43,229,0
연산터널→연산교차로,2023.5.25 01:00,118,131,49,298,0
교대→연산교차로,2023.5.25 02:00,84,0,134,218,0
부산시청→연산교차로,2023.5.25 02:00,162,84,64,310,0
사직운동장→연산교차로,2023.5.25 02:00,53,163,37,253,0
신리→연산교차로,2023.5.25 02:00,80,46,22,148,0
안락→연산교차로,2023.5.25 02:00,132,0,38,170,0
연산터널→연산교차로,2023.5.25 02:00,97,105,42,244,0
교대→연산교차로,2023.5.25 03:00,54,0,105,159,0
부산시청→연산교차로,2023.5.25 03:00,145,69,45,259,0
사직운동장→연산교차로,2023.5.25 03:00,44,131,37,212,0
신리→연산교차로,2023.5.25 03:00,77,35,12,124,0
안락→연산교차로,2023.5.25 03:00,111,0,26,137,0
연산터널→연산교차로,2023.5.25 03:00,82,96,46,224,0
교대→연산교차로,2023.5.25 04:00,52,0,83,135,0
부산시청→연산교차로,2023.5.25 04:00,170,83,39,292,0
사직운동장→연산교차로,2023.5.25 04:00,38,127,35,200,0
신리→연산교차로,2023.5.25 04:00,88,46,11,145,0
안락→연산교차로,2023.5.25 04:00,196,0,28,224,0
연산터널→연산교차로,2023.5.25 04:00,95,115,21,231,0
교대→연산교차로,2023.5.25 05:00,119,0,161,280,0
부산시청→연산교차로,2023.5.25 05:00,258,143,88,489,0
사직운동장→연산교차로,2023.5.25 05:00,63,167,44,274,0
신리→연산교차로,2023.5.25 05:00,209,107,9,325,0
안락→연산교차로,2023.5.25 05:00,346,0,60,406,0
연산터널→연산교차로,2023.5.25 05:00,141,155,26,322,0
교대→연산교차로,2023.5.25 06:00,192,0,267,459,0
부산시청→연산교차로,2023.5.25 06:00,368,278,114,760,0
사직운동장→연산교차로,2023.5.25 06:00,112,296,45,453,0
신리→연산교차로,2023.5.25 06:00,325,156,28,509,0
안락→연산교차로,2023.5.25 06:00,531,0,75,606,0
연산터널→연산교차로,2023.5.25 06:00,233,256,42,531,0
교대→연산교차로,2023.5.25 07:00,265,0,407,672,0
부산시청→연산교차로,2023.5.25 07:00,544,376,231,1151,0
사직운동장→연산교차로,2023.5.25 07:00,221,501,63,785,0
신리→연산교차로,2023.5.25 07:00,524,245,31,800,0
안락→연산교차로,2023.5.25 07:00,657,0,75,732,0
연산터널→연산교차로,2023.5.25 07:00,275,359,50,684,0
교대→연산교차로,2023.5.25 08:00,310,0,506,816,0
부산시청→연산교차로,2023.5.25 08:00,597,419,324,1340,0
사직운동장→연산교차로,2023.5.25 08:00,275,625,58,958,0
신리→연산교차로,2023.5.25 08:00,513,340,32,885,0
안락→연산교차로,2023.5.25 08:00,640,0,103,743,0
연산터널→연산교차로,2023.5.25 08:00,323,389,33,745,0
교대→연산교차로,2023.5.25 09:00,297,0,424,721,0
부산시청→연산교차로,2023.5.25 09:00,450,327,254,1031,0
사직운동장→연산교차로,2023.5.25 09:00,252,520,53,825,0
신리→연산교차로,2023.5.25 09:00,468,281,46,795,0
안락→연산교차로,2023.5.25 09:00,464,0,87,551,0
연산터널→연산교차로,2023.5.25 09:00,298,314,32,644,0
교대→연산교차로,2023.5.25 10:00,285,0,433,718,0
부산시청→연산교차로,2023.5.25 10:00,538,360,277,1175,0
사직운동장→연산교차로,2023.5.25 10:00,341,566,70,977,0
신리→연산교차로,2023.5.25 10:00,480,280,55,815,0
안락→연산교차로,2023.5.25 10:00,571,0,133,704,0
연산터널→연산교차로,2023.5.25 10:00,287,340,39,666,0
교대→연산교차로,2023.5.25 11:00,288,0,395,683,0
부산시청→연산교차로,2023.5.25 11:00,618,377,237,1232,0
사직운동장→연산교차로,2023.5.25 11:00,367,583,63,1013,0
신리→연산교차로,2023.5.25 11:00,439,257,52,748,0
안락→연산교차로,2023.5.25 11:00,535,0,156,691,0
연산터널→연산교차로,2023.5.25 11:00,252,257,63,572,0
교대→연산교차로,2023.5.25 12:00,287,0,387,674,0
부산시청→연산교차로,2023.5.25 12:00,602,364,268,1234,0
사직운동장→연산교차로,2023.5.25 12:00,261,504,60,825,0
신리→연산교차로,2023.5.25 12:00,392,228,32,652,0
안락→연산교차로,2023.5.25 12:00,519,0,143,662,0
연산터널→연산교차로,2023.5.25 12:00,288,298,47,633,0
교대→연산교차로,2023.5.25 13:00,340,0,390,730,0
부산시청→연산교차로,2023.5.25 13:00,672,454,298,1424,0
사직운동장→연산교차로,2023.5.25 13:00,269,592,91,952,0
신리→연산교차로,2023.5.25 13:00,422,285,46,753,0
안락→연산교차로,2023.5.25 13:00,406,0,157,563,0
연산터널→연산교차로,2023.5.25 13:00,245,264,41,550,0
교대→연산교차로,2023.5.25 14:00,360,0,470,830,0
부산시청→연산교차로,2023.5.25 14:00,610,469,307,1386,0
사직운동장→연산교차로,2023.5.25 14:00,241,610,72,923,0
신리→연산교차로,2023.5.25 14:00,450,258,64,772,0
안락→연산교차로,2023.5.25 14:00,423,0,105,528,0
연산터널→연산교차로,2023.5.25 14:00,243,263,49,555,0
교대→연산교차로,2023.5.25 15:00,364,0,468,832,0
부산시청→연산교차로,2023.5.25 15:00,577,485,304,1366,0
사직운동장→연산교차로,2023.5.25 15:00,263,689,76,1028,0
신리→연산교차로,2023.5.25 15:00,455,285,47,787,0
안락→연산교차로,2023.5.25 15:00,439,0,101,540,0
연산터널→연산교차로,2023.5.25 15:00,233,293,47,573,0
교대→연산교차로,2023.5.25 16:00,352,0,500,852,0
부산시청→연산교차로,2023.5.25 16:00,594,535,319,1448,0
사직운동장→연산교차로,2023.5.25 16:00,300,665,41,1006,0
신리→연산교차로,2023.5.25 16:00,559,279,47,885,0
안락→연산교차로,2023.5.25 16:00,440,0,85,525,0
연산터널→연산교차로,2023.5.25 16:00,227,276,34,537,0
교대→연산교차로,2023.5.25 17:00,365,0,484,849,0
부산시청→연산교차로,2023.5.25 17:00,618,568,304,1490,0
사직운동장→연산교차로,2023.5.25 17:00,316,716,71,1103,0
신리→연산교차로,2023.5.25 17:00,507,310,51,868,0
안락→연산교차로,2023.5.25 17:00,455,0,99,554,0
연산터널→연산교차로,2023.5.25 17:00,236,269,41,546,0
교대→연산교차로,2023.5.25 18:00,380,0,545,925,0
부산시청→연산교차로,2023.5.25 18:00,599,576,333,1508,0
사직운동장→연산교차로,2023.5.25 18:00,301,673,69,1043,0
신리→연산교차로,2023.5.25 18:00,501,275,40,816,0
안락→연산교차로,2023.5.25 18:00,479,0,118,597,0
연산터널→연산교차로,2023.5.25 18:00,258,262,54,574,0
교대→연산교차로,2023.5.25 19:00,338,0,425,763,0
부산시청→연산교차로,2023.5.25 19:00,511,379,271,1161,0
사직운동장→연산교차로,2023.5.25 19:00,177,522,89,788,0
신리→연산교차로,2023.5.25 19:00,340,208,32,580,0
안락→연산교차로,2023.5.25 19:00,443,0,87,530,0
연산터널→연산교차로,2023.5.25 19:00,218,247,59,524,0
교대→연산교차로,2023.5.25 20:00,338,0,344,682,0
부산시청→연산교차로,2023.5.25 20:00,476,356,227,1059,0
사직운동장→연산교차로,2023.5.25 20:00,192,555,89,836,0
신리→연산교차로,2023.5.25 20:00,328,176,32,536,0
안락→연산교차로,2023.5.25 20:00,412,0,95,507,0
연산터널→연산교차로,2023.5.25 20:00,216,250,54,520,0
교대→연산교차로,2023.5.25 21:00,293,0,304,597,0
부산시청→연산교차로,2023.5.25 21:00,501,346,239,1086,0
사직운동장→연산교차로,2023.5.25 21:00,214,459,81,754,0
신리→연산교차로,2023.5.25 21:00,292,194,37,523,0
안락→연산교차로,2023.5.25 21:00,415,0,126,541,0
연산터널→연산교차로,2023.5.25 21:00,197,255,53,505,0
교대→연산교차로,2023.5.25 22:00,278,0,267,545,0
부산시청→연산교차로,2023.5.25 22:00,454,280,157,891,0
사직운동장→연산교차로,2023.5.25 22:00,211,435,50,696,0
신리→연산교차로,2023.5.25 22:00,268,195,35,498,0
안락→연산교차로,2023.5.25 22:00,381,0,94,475,0
연산터널→연산교차로,2023.5.25 22:00,195,220,37,452,0
교대→연산교차로,2023.5.25 23:00,190,0,200,390,0
부산시청→연산교차로,2023.5.25 23:00,349,212,133,694,0
사직운동장→연산교차로,2023.5.25 23:00,112,296,54,462,0
신리→연산교차로,2023.5.25 23:00,239,134,25,398,0
안락→연산교차로,2023.5.25 23:00,238,0,67,305,0
연산터널→연산교차로,2023.5.25 23:00,145,173,41,359,0
교대→연산교차로,2023.5.26 00:00,164,0,193,357,0
부산시청→연산교차로,2023.5.26 00:00,283,166,110,559,0
사직운동장→연산교차로,2023.5.26 00:00,95,210,62,367,0
신리→연산교차로,2023.5.26 00:00,186,122,19,327,0
안락→연산교차로,2023.5.26 00:00,221,0,49,270,0
연산터널→연산교차로,2023.5.26 00:00,127,167,44,338,0
교대→연산교차로,2023.5.26 01:00,129,0,154,283,0
부산시청→연산교차로,2023.5.26 01:00,210,144,79,433,0
사직운동장→연산교차로,2023.5.26 01:00,67,202,62,331,0
신리→연산교차로,2023.5.26 01:00,116,73,16,205,0
안락→연산교차로,2023.5.26 01:00,182,0,52,234,0
연산터널→연산교차로,2023.5.26 01:00,97,134,52,283,0
교대→연산교차로,2023.5.26 02:00,94,0,123,217,0
부산시청→연산교차로,2023.5.26 02:00,185,85,64,334,0
사직운동장→연산교차로,2023.5.26 02:00,50,140,64,254,0
신리→연산교차로,2023.5.26 02:00,100,49,17,166,0
안락→연산교차로,2023.5.26 02:00,148,0,34,182,0
연산터널→연산교차로,2023.5.26 02:00,105,135,53,293,0
교대→연산교차로,2023.5.26 03:00,67,0,113,180,0
부산시청→연산교차로,2023.5.26 03:00,160,75,53,288,0
사직운동장→연산교차로,2023.5.26 03:00,38,148,43,229,0
신리→연산교차로,2023.5.26 03:00,83,43,14,140,0
안락→연산교차로,2023.5.26 03:00,115,0,29,144,0
연산터널→연산교차로,2023.5.26 03:00,95,119,47,261,0
교대→연산교차로,2023.5.26 04:00,56,0,80,136,0
부산시청→연산교차로,2023.5.26 04:00,164,86,52,302,0
사직운동장→연산교차로,2023.5.26 04:00,45,117,36,198,0
신리→연산교차로,2023.5.26 04:00,81,42,7,130,0
안락→연산교차로,2023.5.26 04:00,206,0,48,254,0
연산터널→연산교차로,2023.5.26 04:00,83,99,42,224,0
교대→연산교차로,2023.5.26 05:00,113,0,171,284,0
부산시청→연산교차로,2023.5.26 05:00,278,135,90,503,0
사직운동장→연산교차로,2023.5.26 05:00,67,167,41,275,0
신리→연산교차로,2023.5.26 05:00,215,97,13,325,0
안락→연산교차로,2023.5.26 05:00,342,0,61,403,0
연산터널→연산교차로,2023.5.26 05:00,133,150,34,317,0
교대→연산교차로,2023.5.26 06:00,190,0,230,420,0
부산시청→연산교차로,2023.5.26 06:00,391,263,118,772,0
사직운동장→연산교차로,2023.5.26 06:00,108,282,33,423,0
신리→연산교차로,2023.5.26 06:00,324,152,23,499,0
안락→연산교차로,2023.5.26 06:00,544,0,93,637,0
연산터널→연산교차로,2023.5.26 06:00,227,239,29,495,0
교대→연산교차로,2023.5.26 07:00,249,0,417,666,0
부산시청→연산교차로,2023.5.26 07:00,548,362,278,1188,0
사직운동장→연산교차로,2023.5.26 07:00,209,498,62,769,0
신리→연산교차로,2023.5.26 07:00,480,250,25,755,0
안락→연산교차로,2023.5.26 07:00,620,0,69,689,0
연산터널→연산교차로,2023.5.26 07:00,276,355,46,677,0
교대→연산교차로,2023.5.26 08:00,313,0,535,848,0
부산시청→연산교차로,2023.5.26 08:00,558,413,350,1321,0
사직운동장→연산교차로,2023.5.26 08:00,299,642,81,1022,0
신리→연산교차로,2023.5.26 08:00,533,335,28,896,0
안락→연산교차로,2023.5.26 08:00,657,0,92,749,0
연산터널→연산교차로,2023.5.26 08:00,310,405,41,756,0
교대→연산교차로,2023.5.26 09:00,307,0,488,795,0
부산시청→연산교차로,2023.5.26 09:00,535,408,311,1254,0
사직운동장→연산교차로,2023.5.26 09:00,303,631,118,1052,0
신리→연산교차로,2023.5.26 09:00,447,333,46,826,0
안락→연산교차로,2023.5.26 09:00,608,0,92,700,0
연산터널→연산교차로,2023.5.26 09:00,301,367,42,710,0
교대→연산교차로,2023.5.26 10:00,304,0,501,805,0
부산시청→연산교차로,2023.5.26 10:00,541,368,293,1202,0
사직운동장→연산교차로,2023.5.26 10:00,339,595,81,1015,0
신리→연산교차로,2023.5.26 10:00,443,303,57,803,0
안락→연산교차로,2023.5.26 10:00,594,0,124,718,0
연산터널→연산교차로,2023.5.26 10:00,325,338,42,705,0
교대→연산교차로,2023.5.26 11:00,301,0,441,742,0
부산시청→연산교차로,2023.5.26 11:00,567,383,348,1298,0
사직운동장→연산교차로,2023.5.26 11:00,399,570,69,1038,0
신리→연산교차로,2023.5.26 11:00,447,265,57,769,0
안락→연산교차로,2023.5.26 11:00,512,0,161,673,0
연산터널→연산교차로,2023.5.26 11:00,284,288,54,626,0
교대→연산교차로,2023.5.26 12:00,289,0,412,701,0
부산시청→연산교차로,2023.5.26 12:00,574,376,285,1235,0
사직운동장→연산교차로,2023.5.26 12:00,259,564,62,885,0
신리→연산교차로,2023.5.26 12:00,413,251,57,721,0
안락→연산교차로,2023.5.26 12:00,516,0,139,655,0
연산터널→연산교차로,2023.5.26 12:00,284,302,48,634,0
교대→연산교차로,2023.5.26 13:00,308,0,422,730,0
부산시청→연산교차로,2023.5.26 13:00,543,423,289,1255,0
사직운동장→연산교차로,2023.5.26 13:00,346,562,102,1010,0
신리→연산교차로,2023.5.26 13:00,476,284,42,802,0
안락→연산교차로,2023.5.26 13:00,472,0,110,582,0
연산터널→연산교차로,2023.5.26 13:00,264,280,43,587,0
교대→연산교차로,2023.5.26 14:00,355,0,447,802,0
부산시청→연산교차로,2023.5.26 14:00,577,440,301,1318,0
사직운동장→연산교차로,2023.5.26 14:00,389,636,99,1124,0
신리→연산교차로,2023.5.26 14:00,439,271,67,777,0
안락→연산교차로,2023.5.26 14:00,459,0,116,575,0
연산터널→연산교차로,2023.5.26 14:00,271,282,40,593,0
교대→연산교차로,2023.5.26 15:00,354,0,507,861,0
부산시청→연산교차로,2023.5.26 15:00,588,512,306,1406,0
사직운동장→연산교차로,2023.5.26 15:00,380,635,70,1085,0
신리→연산교차로,2023.5.26 15:00,501,280,62,843,0
안락→연산교차로,2023.5.26 15:00,470,0,109,579,0
연산터널→연산교차로,2023.5.26 15:00,249,282,47,578,0
교대→연산교차로,2023.5.26 16:00,347,0,541,888,0
부산시청→연산교차로,2023.5.26 16:00,620,543,311,1474,0
사직운동장→연산교차로,2023.5.26 16:00,354,654,86,1094,0
신리→연산교차로,2023.5.26 16:00,542,292,53,887,0
안락→연산교차로,2023.5.26 16:00,476,0,101,577,0
연산터널→연산교차로,2023.5.26 16:00,233,277,49,559,0
교대→연산교차로,2023.5.26 17:00,391,0,552,943,0
부산시청→연산교차로,2023.5.26 17:00,595,554,344,1493,0
사직운동장→연산교차로,2023.5.26 17:00,326,714,63,1103,0
신리→연산교차로,2023.5.26 17:00,541,308,54,903,0
안락→연산교차로,2023.5.26 17:00,493,0,91,584,0
연산터널→연산교차로,2023.5.26 17:00,238,289,42,569,0
교대→연산교차로,2023.5.26 18:00,371,0,527,898,0
부산시청→연산교차로,2023.5.26 18:00,609,580,302,1491,0
사직운동장→연산교차로,2023.5.26 18:00,317,696,47,1060,0
신리→연산교차로,2023.5.26 18:00,526,240,49,815,0
안락→연산교차로,2023.5.26 18:00,503,0,85,588,0
연산터널→연산교차로,2023.5.26 18:00,224,290,62,576,0
교대→연산교차로,2023.5.26 19:00,345,0,413,758,0
부산시청→연산교차로,2023.5.26 19:00,547,428,295,1270,0
사직운동장→연산교차로,2023.5.26 19:00,198,576,60,834,0
신리→연산교차로,2023.5.26 19:00,389,208,39,636,0
안락→연산교차로,2023.5.26 19:00,435,0,84,519,0
연산터널→연산교차로,2023.5.26 19:00,195,291,54,540,0
교대→연산교차로,2023.5.26 20:00,341,0,408,749,0
부산시청→연산교차로,2023.5.26 20:00,497,390,272,1159,0
사직운동장→연산교차로,2023.5.26 20:00,200,507,77,784,0
신리→연산교차로,2023.5.26 20:00,350,181,29,560,0
안락→연산교차로,2023.5.26 20:00,431,0,107,538,0
연산터널→연산교차로,2023.5.26 20:00,230,258,55,543,0
교대→연산교차로,2023.5.26 21:00,298,0,391,689,0
부산시청→연산교차로,2023.5.26 21:00,512,380,233,1125,0
사직운동장→연산교차로,2023.5.26 21:00,202,497,80,779,0
신리→연산교차로,2023.5.26 21:00,315,209,37,561,0
안락→연산교차로,2023.5.26 21:00,461,0,111,572,0
연산터널→연산교차로,2023.5.26 21:00,257,251,63,571,0
교대→연산교차로,2023.5.26 22:00,290,0,294,584,0
부산시청→연산교차로,2023.5.26 22:00,443,280,195,918,0
사직운동장→연산교차로,2023.5.26 22:00,143,411,101,655,0
신리→연산교차로,2023.5.26 22:00,325,190,26,541,0
안락→연산교차로,2023.5.26 22:00,396,0,112,508,0
연산터널→연산교차로,2023.5.26 22:00,228,251,62,541,0
교대→연산교차로,2023.5.26 23:00,243,0,237,480,0
부산시청→연산교차로,2023.5.26 23:00,402,232,147,781,0
사직운동장→연산교차로,2023.5.26 23:00,143,341,62,546,0
신리→연산교차로,2023.5.26 23:00,240,142,26,408,0
안락→연산교차로,2023.5.26 23:00,333,0,101,434,0
연산터널→연산교차로,2023.5.26 23:00,164,198,54,416,0
교대→연산교차로,2023.5.27 00:00,186,0,213,399,1
부산시청→연산교차로,2023.5.27 00:00,335,185,120,640,1
사직운동장→연산교차로,2023.5.27 00:00,103,276,62,441,1
신리→연산교차로,2023.5.27 00:00,218,140,17,375,1
안락→연산교차로,2023.5.27 00:00,281,0,69,350,1
연산터널→연산교차로,2023.5.27 00:00,165,158,39,362,1
교대→연산교차로,2023.5.27 01:00,148,0,192,340,1
부산시청→연산교차로,2023.5.27 01:00,269,169,105,543,1
사직운동장→연산교차로,2023.5.27 01:00,100,247,83,430,1
신리→연산교차로,2023.5.27 01:00,197,106,9,312,1
안락→연산교차로,2023.5.27 01:00,235,0,58,293,1
연산터널→연산교차로,2023.5.27 01:00,132,153,30,315,1
교대→연산교차로,2023.5.27 02:00,138,0,181,319,1
부산시청→연산교차로,2023.5.27 02:00,240,155,92,487,1
사직운동장→연산교차로,2023.5.27 02:00,68,173,63,304,1
신리→연산교차로,2023.5.27 02:00,138,84,18,240,1
안락→연산교차로,2023.5.27 02:00,226,0,57,283,1
연산터널→연산교차로,2023.5.27 02:00,126,163,49,338,1
교대→연산교차로,2023.5.27 03:00,107,0,159,266,1
부산시청→연산교차로,2023.5.27 03:00,226,101,78,405,1
사직운동장→연산교차로,2023.5.27 03:00,71,158,45,274,1
신리→연산교차로,2023.5.27 03:00,88,61,16,165,1
안락→연산교차로,2023.5.27 03:00,164,0,57,221,1
연산터널→연산교차로,2023.5.27 03:00,116,152,33,301,1
교대→연산교차로,2023.5.27 04:00,70,0,124,194,1
부산시청→연산교차로,2023.5.27 04:00,204,111,61,376,1
사직운동장→연산교차로,2023.5.27 04:00,54,150,32,236,1
신리→연산교차로,2023.5.27 04:00,100,61,9,170,1
안락→연산교차로,2023.5.27 04:00,207,0,33,240,1
연산터널→연산교차로,2023.5.27 04:00,99,124,18,241,1
교대→연산교차로,2023.5.27 05:00,124,0,144,268,1
부산시청→연산교차로,2023.5.27 05:00,257,170,87,514,1
사직운동장→연산교차로,2023.5.27 05:00,77,172,28,277,1
신리→연산교차로,2023.5.27 05:00,194,90,8,292,1
안락→연산교차로,2023.5.27 05:00,316,0,54,370,1
연산터널→연산교차로,2023.5.27 05:00,122,164,23,309,1
교대→연산교차로,2023.5.27 06:00,163,0,211,374,1
부산시청→연산교차로,2023.5.27 06:00,316,210,100,626,1
사직운동장→연산교차로,2023.5.27 06:00,114,249,58,421,1
신리→연산교차로,2023.5.27 06:00,286,107,20,413,1
안락→연산교차로,2023.5.27 06:00,413,0,93,506,1
연산터널→연산교차로,2023.5.27 06:00,173,186,28,387,1
교대→연산교차로,2023.5.27 07:00,178,0,196,374,1
부산시청→연산교차로,2023.5.27 07:00,384,253,153,790,1
사직운동장→연산교차로,2023.5.27 07:00,99,307,56,462,1
신리→연산교차로,2023.5.27 07:00,300,138,25,463,1
안락→연산교차로,2023.5.27 07:00,385,0,78,463,1
연산터널→연산교차로,2023.5.27 07:00,206,192,41,439,1
교대→연산교차로,2023.5.27 08:00,234,0,229,463,1
부산시청→연산교차로,2023.5.27 08:00,404,320,177,901,1
사직운동장→연산교차로,2023.5.27 08:00,168,416,40,624,1
신리→연산교차로,2023.5.27 08:00,403,192,35,630,1
안락→연산교차로,2023.5.27 08:00,461,0,111,572,1
연산터널→연산교차로,2023.5.27 08:00,259,264,32,555,1
교대→연산교차로,2023.5.27 09:00,258,0,290,548,1
부산시청→연산교차로,2023.5.27 09:00,507,349,243,1099,1
사직운동장→연산교차로,2023.5.27 09:00,191,563,61,815,1
신리→연산교차로,2023.5.27 09:00,495,259,44,798,1
안락→연산교차로,2023.5.27 09:00,553,0,132,685,1
연산터널→연산교차로,2023.5.27 09:00,311,313,43,667,1
교대→연산교차로,2023.5.27 10:00,295,0,380,675,1
부산시청→연산교차로,2023.5.27 10:00,595,380,248,1223,1
사직운동장→연산교차로,2023.5.27 10:00,292,626,50,968,1
신리→연산교차로,2023.5.27 10:00,516,238,68,822,1
안락→연산교차로,2023.5.27 10:00,582,0,141,723,1
연산터널→연산교차로,2023.5.27 10:00,280,326,49,655,1
교대→연산교차로,2023.5.27 11:00,295,0,413,708,1
부산시청→연산교차로,2023.5.27 11:00,636,377,280,1293,1
사직운동장→연산교차로,2023.5.27 11:00,328,603,54,985,1
신리→연산교차로,2023.5.27 11:00,500,286,62,848,1
안락→연산교차로,2023.5.27 11:00,580,0,145,725,1
연산터널→연산교차로,2023.5.27 11:00,302,362,53,717,1
교대→연산교차로,2023.5.27 12:00,299,0,396,695,1
부산시청→연산교차로,2023.5.27 12:00,674,390,270,1334,1
사직운동장→연산교차로,2023.5.27 12:00,270,610,55,935,1
신리→연산교차로,2023.5.27 12:00,491,260,58,809,1
안락→연산교차로,2023.5.27 12:00,573,0,150,723,1
연산터널→연산교차로,2023.5.27 12:00,315,321,40,676,1
교대→연산교차로,2023.5.27 13:00,332,0,420,752,1
부산시청→연산교차로,2023.5.27 13:00,637,385,281,1303,1
사직운동장→연산교차로,2023.5.27 13:00,267,623,51,941,1
신리→연산교차로,2023.5.27 13:00,482,286,64,832,1
안락→연산교차로,2023.5.27 13:00,569,0,189,758,1
연산터널→연산교차로,2023.5.27 13:00,331,311,43,685,1
교대→연산교차로,2023.5.27 14:00,327,0,375,702,1
부산시청→연산교차로,2023.5.27 14:00,597,375,290,1262,1
사직운동장→연산교차로,2023.5.27 14:00,319,575,50,944,1
신리→연산교차로,2023.5.27 14:00,460,248,57,765,1
안락→연산교차로,2023.5.27 14:00,582,0,140,722,1
연산터널→연산교차로,2023.5.27 14:00,281,307,64,652,1
교대→연산교차로,2023.5.27 15:00,311,0,370,681,1
부산시청→연산교차로,2023.5.27 15:00,635,388,257,1280,1
사직운동장→연산교차로,2023.5.27 15:00,314,621,50,985,1
신리→연산교차로,2023.5.27 15:00,446,251,54,751,1
안락→연산교차로,2023.5.27 15:00,541,0,147,688,1
연산터널→연산교차로,2023.5.27 15:00,249,305,61,615,1
교대→연산교차로,2023.5.27 16:00,318,0,353,671,1
부산시청→연산교차로,2023.5.27 16:00,606,377,259,1242,1
사직운동장→연산교차로,2023.5.27 16:00,324,613,44,981,1
신리→연산교차로,2023.5.27 16:00,454,276,49,779,1
안락→연산교차로,2023.5.27 16:00,575,0,146,721,1
연산터널→연산교차로,2023.5.27 16:00,266,289,44,599,1
교대→연산교차로,2023.5.27 17:00,315,0,364,679,1
부산시청→연산교차로,2023.5.27 17:00,602,379,242,1223,1
사직운동장→연산교차로,2023.5.27 17:00,266,536,51,853,1
신리→연산교차로,2023.5.27 17:00,418,257,34,709,1
안락→연산교차로,2023.5.27 17:00,554,0,181,735,1
연산터널→연산교차로,2023.5.27 17:00,274,277,50,601,1
교대→연산교차로,2023.5.27 18:00,308,0,401,709,1
부산시청→연산교차로,2023.5.27 18:00,561,374,227,1162,1
사직운동장→연산교차로,2023.5.27 18:00,235,543,76,854,1
신리→연산교차로,2023.5.27 18:00,365,229,26,620,1
안락→연산교차로,2023.5.27 18:00,561,0,178,739,1
연산터널→연산교차로,2023.5.27 18:00,275,286,57,618,1
교대→연산교차로,2023.5.27 19:00,293,0,357,650,1
부산시청→연산교차로,2023.5.27 19:00,501,299,214,1014,1
사직운동장→연산교차로,2023.5.27 19:00,208,502,55,765,1
신리→연산교차로,2023.5.27 19:00,328,194,36,558,1
안락→연산교차로,2023.5.27 19:00,511,0,119,630,1
연산터널→연산교차로,2023.5.27 19:00,236,250,59,545,1
교대→연산교차로,2023.5.27 20:00,294,0,388,682,1
부산시청→연산교차로,2023.5.27 20:00,526,321,196,1043,1
사직운동장→연산교차로,2023.5.27 20:00,200,484,75,759,1
신리→연산교차로,2023.5.27 20:00,346,178,25,549,1
안락→연산교차로,2023.5.27 20:00,490,0,120,610,1
연산터널→연산교차로,2023.5.27 20:00,269,260,54,583,1
교대→연산교차로,2023.5.27 21:00,301,0,286,587,1
부산시청→연산교차로,2023.5.27 21:00,487,344,194,1025,1
사직운동장→연산교차로,2023.5.27 21:00,189,436,62,687,1
신리→연산교차로,2023.5.27 21:00,367,226,23,616,1
안락→연산교차로,2023.5.27 21:00,464,0,127,591,1
연산터널→연산교차로,2023.5.27 21:00,246,265,50,561,1
교대→연산교차로,2023.5.27 22:00,284,0,284,568,1
부산시청→연산교차로,2023.5.27 22:00,380,251,164,795,1
사직운동장→연산교차로,2023.5.27 22:00,200,487,61,748,1
신리→연산교차로,2023.5.27 22:00,313,192,21,526,1
안락→연산교차로,2023.5.27 22:00,395,0,104,499,1
연산터널→연산교차로,2023.5.27 22:00,230,212,42,484,1
교대→연산교차로,2023.5.27 23:00,234,0,202,436,1
부산시청→연산교차로,2023.5.27 23:00,336,226,119,681,1
사직운동장→연산교차로,2023.5.27 23:00,123,299,62,484,1
신리→연산교차로,2023.5.27 23:00,244,134,20,398,1
안락→연산교차로,2023.5.27 23:00,323,0,78,401,1
연산터널→연산교차로,2023.5.27 23:00,164,188,57,409,1
교대→연산교차로,2023.5.28 00:00,197,0,183,380,1
부산시청→연산교차로,2023.5.28 00:00,345,231,117,693,1
사직운동장→연산교차로,2023.5.28 00:00,100,263,56,419,1
신리→연산교차로,2023.5.28 00:00,246,130,17,393,1
안락→연산교차로,2023.5.28 00:00,273,0,79,352,1
연산터널→연산교차로,2023.5.28 00:00,139,175,37,351,1
교대→연산교차로,2023.5.28 01:00,166,0,204,370,1
부산시청→연산교차로,2023.5.28 01:00,268,164,122,554,1
사직운동장→연산교차로,2023.5.28 01:00,76,203,61,340,1
신리→연산교차로,2023.5.28 01:00,197,107,17,321,1
안락→연산교차로,2023.5.28 01:00,227,0,50,277,1
연산터널→연산교차로,2023.5.28 01:00,138,176,28,342,1
교대→연산교차로,2023.5.28 02:00,107,0,209,316,1
부산시청→연산교차로,2023.5.28 02:00,232,140,97,469,1
사직운동장→연산교차로,2023.5.28 02:00,61,185,59,305,1
신리→연산교차로,2023.5.28 02:00,153,76,11,240,1
안락→연산교차로,2023.5.28 02:00,194,0,42,236,1
연산터널→연산교차로,2023.5.28 02:00,127,149,38,314,1
교대→연산교차로,2023.5.28 03:00,100,0,186,286,1
부산시청→연산교차로,2023.5.28 03:00,205,116,80,401,1
사직운동장→연산교차로,2023.5.28 03:00,45,178,33,256,1
신리→연산교차로,2023.5.28 03:00,108,76,14,198,1
안락→연산교차로,2023.5.28 03:00,152,0,50,202,1
연산터널→연산교차로,2023.5.28 03:00,98,132,25,255,1
교대→연산교차로,2023.5.28 04:00,83,0,119,202,1
부산시청→연산교차로,2023.5.28 04:00,162,97,63,322,1
사직운동장→연산교차로,2023.5.28 04:00,55,106,27,188,1
신리→연산교차로,2023.5.28 04:00,106,61,9,176,1
안락→연산교차로,2023.5.28 04:00,139,0,35,174,1
연산터널→연산교차로,2023.5.28 04:00,72,109,16,197,1
교대→연산교차로,2023.5.28 05:00,94,0,125,219,1
부산시청→연산교차로,2023.5.28 05:00,168,115,54,337,1
사직운동장→연산교차로,2023.5.28 05:00,50,147,36,233,1
신리→연산교차로,2023.5.28 05:00,130,77,7,214,1
안락→연산교차로,2023.5.28 05:00,157,0,42,199,1
연산터널→연산교차로,2023.5.28 05:00,89,93,14,196,1
교대→연산교차로,2023.5.28 06:00,105,0,137,242,1
부산시청→연산교차로,2023.5.28 06:00,210,159,66,435,1
사직운동장→연산교차로,2023.5.28 06:00,64,154,50,268,1
신리→연산교차로,2023.5.28 06:00,159,87,15,261,1
안락→연산교차로,2023.5.28 06:00,243,0,47,290,1
연산터널→연산교차로,2023.5.28 06:00,133,131,26,290,1
교대→연산교차로,2023.5.28 07:00,129,0,185,314,1
부산시청→연산교차로,2023.5.28 07:00,242,186,98,526,1
사직운동장→연산교차로,2023.5.28 07:00,92,225,53,370,1
신리→연산교차로,2023.5.28 07:00,217,81,17,315,1
안락→연산교차로,2023.5.28 07:00,264,0,65,329,1
연산터널→연산교차로,2023.5.28 07:00,136,112,38,286,1
교대→연산교차로,2023.5.28 08:00,174,0,175,349,1
부산시청→연산교차로,2023.5.28 08:00,277,236,127,640,1
사직운동장→연산교차로,2023.5.28 08:00,130,295,45,470,1
신리→연산교차로,2023.5.28 08:00,281,158,17,456,1
안락→연산교차로,2023.5.28 08:00,326,0,70,396,1
연산터널→연산교차로,2023.5.28 08:00,170,164,27,361,1
교대→연산교차로,2023.5.28 09:00,211,0,246,457,1
부산시청→연산교차로,2023.5.28 09:00,366,320,145,831,1
사직운동장→연산교차로,2023.5.28 09:00,167,418,49,634,1
신리→연산교차로,2023.5.28 09:00,354,209,27,590,1
안락→연산교차로,2023.5.28 09:00,416,0,113,529,1
연산터널→연산교차로,2023.5.28 09:00,247,249,34,530,1
교대→연산교차로,2023.5.28 10:00,298,0,340,638,1
부산시청→연산교차로,2023.5.28 10:00,414,331,173,918,1
사직운동장→연산교차로,2023.5.28 10:00,224,517,58,799,1
신리→연산교차로,2023.5.28 10:00,439,226,26,691,1
안락→연산교차로,2023.5.28 10:00,487,0,113,600,1
연산터널→연산교차로,2023.5.28 10:00,244,252,34,530,1
교대→연산교차로,2023.5.28 11:00,252,0,374,626,1
부산시청→연산교차로,2023.5.28 11:00,515,354,190,1059,1
사직운동장→연산교차로,2023.5.28 11:00,203,540,81,824,1
신리→연산교차로,2023.5.28 11:00,476,229,31,736,1
안락→연산교차로,2023.5.28 11:00,534,0,126,660,1
연산터널→연산교차로,2023.5.28 11:00,249,248,44,541,1
교대→연산교차로,2023.5.28 12:00,291,0,333,624,1
부산시청→연산교차로,2023.5.28 12:00,481,350,204,1035,1
사직운동장→연산교차로,2023.5.28 12:00,202,547,65,814,1
신리→연산교차로,2023.5.28 12:00,401,226,32,659,1
안락→연산교차로,2023.5.28 12:00,516,0,139,655,1
연산터널→연산교차로,2023.5.28 12:00,270,274,42,586,1
교대→연산교차로,2023.5.28 13:00,300,0,363,663,1
부산시청→연산교차로,2023.5.28 13:00,569,370,235,1174,1
사직운동장→연산교차로,2023.5.28 13:00,208,597,66,871,1
신리→연산교차로,2023.5.28 13:00,413,240,35,688,1
안락→연산교차로,2023.5.28 13:00,543,0,128,671,1
연산터널→연산교차로,2023.5.28 13:00,256,231,49,536,1
교대→연산교차로,2023.5.28 14:00,281,0,353,634,1
부산시청→연산교차로,2023.5.28 14:00,499,336,249,1084,1
사직운동장→연산교차로,2023.5.28 14:00,215,548,65,828,1
신리→연산교차로,2023.5.28 14:00,435,210,46,691,1
안락→연산교차로,2023.5.28 14:00,528,0,126,654,1
연산터널→연산교차로,2023.5.28 14:00,236,253,68,557,1
교대→연산교차로,2023.5.28 15:00,289,0,338,627,1
부산시청→연산교차로,2023.5.28 15:00,505,339,228,1072,1
사직운동장→연산교차로,2023.5.28 15:00,198,551,53,802,1
신리→연산교차로,2023.5.28 15:00,415,243,35,693,1
안락→연산교차로,2023.5.28 15:00,494,0,124,618,1
연산터널→연산교차로,2023.5.28 15:00,216,247,47,510,1
교대→연산교차로,2023.5.28 16:00,279,0,288,567,1
부산시청→연산교차로,2023.5.28 16:00,512,339,217,1068,1
사직운동장→연산교차로,2023.5.28 16:00,225,497,49,771,1
신리→연산교차로,2023.5.28 16:00,413,202,31,646,1
안락→연산교차로,2023.5.28 16:00,534,0,147,681,1
연산터널→연산교차로,2023.5.28 16:00,236,264,44,544,1
교대→연산교차로,2023.5.28 17:00,279,0,338,617,1
부산시청→연산교차로,2023.5.28 17:00,504,330,213,1047,1
사직운동장→연산교차로,2023.5.28 17:00,200,488,57,745,1
신리→연산교차로,2023.5.28 17:00,372,202,28,602,1
안락→연산교차로,2023.5.28 17:00,527,0,114,641,1
연산터널→연산교차로,2023.5.28 17:00,241,264,44,549,1
교대→연산교차로,2023.5.28 18:00,287,0,296,583,1
부산시청→연산교차로,2023.5.28 18:00,463,290,187,940,1
사직운동장→연산교차로,2023.5.28 18:00,168,464,74,706,1
신리→연산교차로,2023.5.28 18:00,321,184,35,540,1
안락→연산교차로,2023.5.28 18:00,494,0,119,613,1
연산터널→연산교차로,2023.5.28 18:00,239,237,58,534,1
교대→연산교차로,2023.5.28 19:00,265,0,250,515,1
부산시청→연산교차로,2023.5.28 19:00,395,284,156,835,1
사직운동장→연산교차로,2023.5.28 19:00,160,396,49,605,1
신리→연산교차로,2023.5.28 19:00,301,170,27,498,1
안락→연산교차로,2023.5.28 19:00,413,0,85,498,1
연산터널→연산교차로,2023.5.28 19:00,193,223,64,480,1
교대→연산교차로,2023.5.28 20:00,248,0,246,494,1
부산시청→연산교차로,2023.5.28 20:00,382,253,138,773,1
사직운동장→연산교차로,2023.5.28 20:00,152,376,48,576,1
신리→연산교차로,2023.5.28 20:00,280,156,16,452,1
안락→연산교차로,2023.5.28 20:00,400,0,94,494,1
연산터널→연산교차로,2023.5.28 20:00,196,231,33,460,1
교대→연산교차로,2023.5.28 21:00,252,0,220,472,1
부산시청→연산교차로,2023.5.28 21:00,374,237,126,737,1
사직운동장→연산교차로,2023.5.28 21:00,155,313,53,521,1
신리→연산교차로,2023.5.28 21:00,289,181,21,491,1
안락→연산교차로,2023.5.28 21:00,316,0,74,390,1
연산터널→연산교차로,2023.5.28 21:00,190,181,39,410,1
교대→연산교차로,2023.5.28 22:00,183,0,178,361,1
부산시청→연산교차로,2023.5.28 22:00,353,189,129,671,1
사직운동장→연산교차로,2023.5.28 22:00,125,354,51,530,1
신리→연산교차로,2023.5.28 22:00,233,139,12,384,1
안락→연산교차로,2023.5.28 22:00,304,0,69,373,1
연산터널→연산교차로,2023.5.28 22:00,155,157,34,346,1
교대→연산교차로,2023.5.28 23:00,156,0,154,310,1
부산시청→연산교차로,2023.5.28 23:00,276,157,100,533,1
사직운동장→연산교차로,2023.5.28 23:00,103,221,28,352,1
신리→연산교차로,2023.5.28 23:00,196,114,25,335,1
안락→연산교차로,2023.5.28 23:00,246,0,43,289,1
연산터널→연산교차로,2023.5.28 23:00,120,162,31,313,1
교대→연산교차로,2023.5.29 00:00,133,0,130,263,1
부산시청→연산교차로,2023.5.29 00:00,236,150,90,476,1
사직운동장→연산교차로,2023.5.29 00:00,74,184,21,279,1
신리→연산교차로,2023.5.29 00:00,167,84,11,262,1
안락→연산교차로,2023.5.29 00:00,188,0,45,233,1
연산터널→연산교차로,2023.5.29 00:00,99,147,32,278,1
교대→연산교차로,2023.5.29 01:00,105,0,101,206,1
부산시청→연산교차로,2023.5.29 01:00,188,110,70,368,1
사직운동장→연산교차로,2023.5.29 01:00,50,134,27,211,1
신리→연산교차로,2023.5.29 01:00,111,60,13,184,1
안락→연산교차로,2023.5.29 01:00,159,0,29,188,1
연산터널→연산교차로,2023.5.29 01:00,72,94,37,203,1
교대→연산교차로,2023.5.29 02:00,90,0,112,202,1
부산시청→연산교차로,2023.5.29 02:00,159,98,84,341,1
사직운동장→연산교차로,2023.5.29 02:00,37,127,27,191,1
신리→연산교차로,2023.5.29 02:00,94,54,13,161,1
안락→연산교차로,2023.5.29 02:00,161,0,33,194,1
연산터널→연산교차로,2023.5.29 02:00,77,108,40,225,1
교대→연산교차로,2023.5.29 03:00,48,0,75,123,1
부산시청→연산교차로,2023.5.29 03:00,168,75,43,286,1
사직운동장→연산교차로,2023.5.29 03:00,35,110,10,155,1
신리→연산교차로,2023.5.29 03:00,77,41,6,124,1
안락→연산교차로,2023.5.29 03:00,105,0,27,132,1
연산터널→연산교차로,2023.5.29 03:00,67,104,11,182,1
교대→연산교차로,2023.5.29 04:00,55,0,70,125,1
부산시청→연산교차로,2023.5.29 04:00,156,79,37,272,1
사직운동장→연산교차로,2023.5.29 04:00,36,91,8,135,1
신리→연산교차로,2023.5.29 04:00,91,35,2,128,1
안락→연산교차로,2023.5.29 04:00,141,0,27,168,1
연산터널→연산교차로,2023.5.29 04:00,74,82,0,156,1
교대→연산교차로,2023.5.29 05:00,75,0,95,170,1
부산시청→연산교차로,2023.5.29 05:00,198,130,49,377,1
사직운동장→연산교차로,2023.5.29 05:00,39,122,23,184,1
신리→연산교차로,2023.5.29 05:00,142,68,4,214,1
안락→연산교차로,2023.5.29 05:00,229,0,59,288,1
연산터널→연산교차로,2023.5.29 05:00,83,109,15,207,1
교대→연산교차로,2023.5.29 06:00,129,0,148,277,1
부산시청→연산교차로,2023.5.29 06:00,251,181,70,502,1
사직운동장→연산교차로,2023.5.29 06:00,66,186,28,280,1
신리→연산교차로,2023.5.29 06:00,221,99,14,334,1
안락→연산교차로,2023.5.29 06:00,348,0,65,413,1
연산터널→연산교차로,2023.5.29 06:00,154,151,27,332,1
교대→연산교차로,2023.5.29 07:00,150,0,149,299,1
부산시청→연산교차로,2023.5.29 07:00,329,208,116,653,1
사직운동장→연산교차로,2023.5.29 07:00,114,273,35,422,1
신리→연산교차로,2023.5.29 07:00,272,130,30,432,1
안락→연산교차로,2023.5.29 07:00,361,0,75,436,1
연산터널→연산교차로,2023.5.29 07:00,164,161,40,365,1
교대→연산교차로,2023.5.29 08:00,192,0,240,432,1
부산시청→연산교차로,2023.5.29 08:00,380,251,197,828,1
사직운동장→연산교차로,2023.5.29 08:00,152,377,46,575,1
신리→연산교차로,2023.5.29 08:00,329,187,37,553,1
안락→연산교차로,2023.5.29 08:00,434,0,83,517,1
연산터널→연산교차로,2023.5.29 08:00,211,242,35,488,1
교대→연산교차로,2023.5.29 09:00,243,0,306,549,1
부산시청→연산교차로,2023.5.29 09:00,408,280,217,905,1
사직운동장→연산교차로,2023.5.29 09:00,156,468,72,696,1
신리→연산교차로,2023.5.29 09:00,367,258,50,675,1
안락→연산교차로,2023.5.29 09:00,444,0,127,571,1
연산터널→연산교차로,2023.5.29 09:00,233,239,48,520,1
교대→연산교차로,2023.5.29 10:00,289,0,357,646,1
부산시청→연산교차로,2023.5.29 10:00,506,339,259,1104,1
사직운동장→연산교차로,2023.5.29 10:00,244,536,65,845,1
신리→연산교차로,2023.5.29 10:00,438,241,55,734,1
안락→연산교차로,2023.5.29 10:00,502,0,132,634,1
연산터널→연산교차로,2023.5.29 10:00,233,318,47,598,1
교대→연산교차로,2023.5.29 11:00,279,0,369,648,1
부산시청→연산교차로,2023.5.29 11:00,548,328,253,1129,1
사직운동장→연산교차로,2023.5.29 11:00,225,557,54,836,1
신리→연산교차로,2023.5.29 11:00,479,225,54,758,1
안락→연산교차로,2023.5.29 11:00,561,0,119,680,1
연산터널→연산교차로,2023.5.29 11:00,266,273,60,599,1
교대→연산교차로,2023.5.29 12:00,296,0,338,634,1
부산시청→연산교차로,2023.5.29 12:00,535,338,245,1118,1
사직운동장→연산교차로,2023.5.29 12:00,233,551,60,844,1
신리→연산교차로,2023.5.29 12:00,484,219,50,753,1
안락→연산교차로,2023.5.29 12:00,531,0,147,678,1
연산터널→연산교차로,2023.5.29 12:00,267,299,53,619,1
교대→연산교차로,2023.5.29 13:00,281,0,369,650,1
부산시청→연산교차로,2023.5.29 13:00,564,379,235,1178,1
사직운동장→연산교차로,2023.5.29 13:00,231,579,41,851,1
신리→연산교차로,2023.5.29 13:00,428,240,70,738,1
안락→연산교차로,2023.5.29 13:00,478,0,146,624,1
연산터널→연산교차로,2023.5.29 13:00,237,287,33,557,1
교대→연산교차로,2023.5.29 14:00,306,0,368,674,1
부산시청→연산교차로,2023.5.29 14:00,572,370,250,1192,1
사직운동장→연산교차로,2023.5.29 14:00,277,567,57,901,1
신리→연산교차로,2023.5.29 14:00,426,264,56,746,1
안락→연산교차로,2023.5.29 14:00,502,0,159,661,1
연산터널→연산교차로,2023.5.29 14:00,260,284,50,594,1
교대→연산교차로,2023.5.29 15:00,306,0,401,707,1
부산시청→연산교차로,2023.5.29 15:00,556,368,271,1195,1
사직운동장→연산교차로,2023.5.29 15:00,249,551,48,848,1
신리→연산교차로,2023.5.29 15:00,421,260,43,724,1
안락→연산교차로,2023.5.29 15:00,533,0,151,684,1
연산터널→연산교차로,2023.5.29 15:00,272,274,43,589,1
교대→연산교차로,2023.5.29 16:00,300,0,403,703,1
부산시청→연산교차로,2023.5.29 16:00,590,365,248,1203,1
사직운동장→연산교차로,2023.5.29 16:00,289,551,45,885,1
신리→연산교차로,2023.5.29 16:00,421,233,48,702,1
안락→연산교차로,2023.5.29 16:00,526,0,152,678,1
연산터널→연산교차로,2023.5.29 16:00,257,306,51,614,1
교대→연산교차로,2023.5.29 17:00,290,0,387,677,1
부산시청→연산교차로,2023.5.29 17:00,576,361,252,1189,1
사직운동장→연산교차로,2023.5.29 17:00,217,549,56,822,1
신리→연산교차로,2023.5.29 17:00,399,247,49,695,1
안락→연산교차로,2023.5.29 17:00,500,0,158,658,1
연산터널→연산교차로,2023.5.29 17:00,281,265,58,604,1
교대→연산교차로,2023.5.29 18:00,291,0,324,615,1
부산시청→연산교차로,2023.5.29 18:00,453,359,243,1055,1
사직운동장→연산교차로,2023.5.29 18:00,234,509,59,802,1
신리→연산교차로,2023.5.29 18:00,391,206,42,639,1
안락→연산교차로,2023.5.29 18:00,479,0,142,621,1
연산터널→연산교차로,2023.5.29 18:00,227,247,58,532,1
교대→연산교차로,2023.5.29 19:00,253,0,233,486,1
부산시청→연산교차로,2023.5.29 19:00,403,295,177,875,1
사직운동장→연산교차로,2023.5.29 19:00,156,386,40,582,1
신리→연산교차로,2023.5.29 19:00,297,145,31,473,1
안락→연산교차로,2023.5.29 19:00,310,0,123,433,1
연산터널→연산교차로,2023.5.29 19:00,194,237,43,474,1
교대→연산교차로,2023.5.29 20:00,236,0,184,420,1
부산시청→연산교차로,2023.5.29 20:00,373,259,177,809,1
사직운동장→연산교차로,2023.5.29 20:00,158,381,27,566,1
신리→연산교차로,2023.5.29 20:00,259,143,19,421,1
안락→연산교차로,2023.5.29 20:00,329,0,115,444,1
연산터널→연산교차로,2023.5.29 20:00,208,201,34,443,1
교대→연산교차로,2023.5.29 21:00,211,0,175,386,1
부산시청→연산교차로,2023.5.29 21:00,344,215,123,682,1
사직운동장→연산교차로,2023.5.29 21:00,154,356,14,524,1
신리→연산교차로,2023.5.29 21:00,269,133,14,416,1
안락→연산교차로,2023.5.29 21:00,320,0,46,366,1
연산터널→연산교차로,2023.5.29 21:00,213,180,22,415,1
교대→연산교차로,2023.5.29 22:00,171,0,136,307,1
부산시청→연산교차로,2023.5.29 22:00,293,189,117,599,1
사직운동장→연산교차로,2023.5.29 22:00,126,285,8,419,1
신리→연산교차로,2023.5.29 22:00,204,112,13,329,1
안락→연산교차로,2023.5.29 22:00,279,0,56,335,1
연산터널→연산교차로,2023.5.29 22:00,133,158,28,319,1
교대→연산교차로,2023.5.29 23:00,110,0,99,209,1
부산시청→연산교차로,2023.5.29 23:00,226,157,70,453,1
사직운동장→연산교차로,2023.5.29 23:00,75,207,8,290,1
신리→연산교차로,2023.5.29 23:00,150,69,6,225,1
안락→연산교차로,2023.5.29 23:00,194,0,46,240,1
연산터널→연산교차로,2023.5.29 23:00,105,118,26,249,1
교대→연산교차로,2023.5.30 00:00,82,0,91,173,0
부산시청→연산교차로,2023.5.30 00:00,184,129,74,387,0
사직운동장→연산교차로,2023.5.30 00:00,88,162,10,260,0
신리→연산교차로,2023.5.30 00:00,132,53,13,198,0
안락→연산교차로,2023.5.30 00:00,175,0,38,213,0
연산터널→연산교차로,2023.5.30 00:00,89,109,19,217,0
교대→연산교차로,2023.5.30 01:00,64,0,80,144,0
부산시청→연산교차로,2023.5.30 01:00,156,108,49,313,0
사직운동장→연산교차로,2023.5.30 01:00,74,120,12,206,0
신리→연산교차로,2023.5.30 01:00,78,43,4,125,0
안락→연산교차로,2023.5.30 01:00,132,0,37,169,0
연산터널→연산교차로,2023.5.30 01:00,74,104,20,198,0
교대→연산교차로,2023.5.30 02:00,47,0,83,130,0
부산시청→연산교차로,2023.5.30 02:00,98,71,55,224,0
사직운동장→연산교차로,2023.5.30 02:00,35,102,8,145,0
신리→연산교차로,2023.5.30 02:00,74,32,11,117,0
안락→연산교차로,2023.5.30 02:00,100,0,26,126,0
연산터널→연산교차로,2023.5.30 02:00,66,80,14,160,0
교대→연산교차로,2023.5.30 03:00,39,0,52,91,0
부산시청→연산교차로,2023.5.30 03:00,115,65,26,206,0
사직운동장→연산교차로,2023.5.30 03:00,21,83,11,115,0
신리→연산교차로,2023.5.30 03:00,61,26,5,92,0
안락→연산교차로,2023.5.30 03:00,83,0,19,102,0
연산터널→연산교차로,2023.5.30 03:00,67,68,10,145,0
교대→연산교차로,2023.5.30 04:00,54,0,55,109,0
부산시청→연산교차로,2023.5.30 04:00,128,75,36,239,0
사직운동장→연산교차로,2023.5.30 04:00,26,80,6,112,0
신리→연산교차로,2023.5.30 04:00,76,35,4,115,0
안락→연산교차로,2023.5.30 04:00,146,0,31,177,0
연산터널→연산교차로,2023.5.30 04:00,54,64,10,128,0
교대→연산교차로,2023.5.30 05:00,98,0,123,221,0
부산시청→연산교차로,2023.5.30 05:00,233,157,76,466,0
사직운동장→연산교차로,2023.5.30 05:00,54,154,31,239,0
신리→연산교차로,2023.5.30 05:00,218,102,6,326,0
안락→연산교차로,2023.5.30 05:00,318,0,52,370,0
연산터널→연산교차로,2023.5.30 05:00,129,139,24,292,0
교대→연산교차로,2023.5.30 06:00,196,0,250,446,0
부산시청→연산교차로,2023.5.30 06:00,357,247,122,726,0
사직운동장→연산교차로,2023.5.30 06:00,120,302,48,470,0
신리→연산교차로,2023.5.30 06:00,358,151,22,531,0
안락→연산교차로,2023.5.30 06:00,503,0,71,574,0
연산터널→연산교차로,2023.5.30 06:00,220,255,37,512,0
교대→연산교차로,2023.5.30 07:00,276,0,447,723,0
부산시청→연산교차로,2023.5.30 07:00,545,372,257,1174,0
사직운동장→연산교차로,2023.5.30 07:00,198,473,74,745,0
신리→연산교차로,2023.5.30 07:00,509,262,31,802,0
안락→연산교차로,2023.5.30 07:00,652,0,76,728,0
연산터널→연산교차로,2023.5.30 07:00,278,387,50,715,0
교대→연산교차로,2023.5.30 08:00,317,0,534,851,0
부산시청→연산교차로,2023.5.30 08:00,585,423,312,1320,0
사직운동장→연산교차로,2023.5.30 08:00,230,655,61,946,0
신리→연산교차로,2023.5.30 08:00,515,362,26,903,0
안락→연산교차로,2023.5.30 08:00,628,0,93,721,0
연산터널→연산교차로,2023.5.30 08:00,334,383,36,753,0
교대→연산교차로,2023.5.30 09:00,307,0,506,813,0
부산시청→연산교차로,2023.5.30 09:00,521,382,293,1196,0
사직운동장→연산교차로,2023.5.30 09:00,233,562,111,906,0
신리→연산교차로,2023.5.30 09:00,471,346,48,865,0
안락→연산교차로,2023.5.30 09:00,620,0,97,717,0
연산터널→연산교차로,2023.5.30 09:00,303,377,50,730,0
교대→연산교차로,2023.5.30 10:00,294,0,500,794,0
부산시청→연산교차로,2023.5.30 10:00,552,367,276,1195,0
사직운동장→연산교차로,2023.5.30 10:00,314,577,109,1000,0
신리→연산교차로,2023.5.30 10:00,432,281,56,769,0
안락→연산교차로,2023.5.30 10:00,579,0,107,686,0
연산터널→연산교차로,2023.5.30 10:00,293,338,58,689,0
교대→연산교차로,2023.5.30 11:00,300,0,431,731,0
부산시청→연산교차로,2023.5.30 11:00,568,380,251,1199,0
사직운동장→연산교차로,2023.5.30 11:00,316,580,90,986,0
신리→연산교차로,2023.5.30 11:00,422,281,58,761,0
안락→연산교차로,2023.5.30 11:00,507,0,171,678,0
연산터널→연산교차로,2023.5.30 11:00,274,327,67,668,0
교대→연산교차로,2023.5.30 12:00,298,0,433,731,0
부산시청→연산교차로,2023.5.30 12:00,543,372,239,1154,0
사직운동장→연산교차로,2023.5.30 12:00,236,552,94,882,0
신리→연산교차로,2023.5.30 12:00,407,228,40,675,0
안락→연산교차로,2023.5.30 12:00,483,0,146,629,0
연산터널→연산교차로,2023.5.30 12:00,279,300,46,625,0
교대→연산교차로,2023.5.30 13:00,322,0,440,762,0
부산시청→연산교차로,2023.5.30 13:00,596,481,251,1328,0
사직운동장→연산교차로,2023.5.30 13:00,328,594,81,1003,0
신리→연산교차로,2023.5.30 13:00,397,257,50,704,0
안락→연산교차로,2023.5.30 13:00,474,0,123,597,0
연산터널→연산교차로,2023.5.30 13:00,249,299,31,579,0
교대→연산교차로,2023.5.30 14:00,352,0,535,887,0
부산시청→연산교차로,2023.5.30 14:00,534,456,304,1294,0
사직운동장→연산교차로,2023.5.30 14:00,321,609,106,1036,0
신리→연산교차로,2023.5.30 14:00,444,265,61,770,0
안락→연산교차로,2023.5.30 14:00,451,0,136,587,0
연산터널→연산교차로,2023.5.30 14:00,243,283,62,588,0
교대→연산교차로,2023.5.30 15:00,355,0,560,915,0
부산시청→연산교차로,2023.5.30 15:00,587,485,268,1340,0
사직운동장→연산교차로,2023.5.30 15:00,289,631,100,1020,0
신리→연산교차로,2023.5.30 15:00,440,274,46,760,0
안락→연산교차로,2023.5.30 15:00,459,0,120,579,0
연산터널→연산교차로,2023.5.30 15:00,231,289,56,576,0
교대→연산교차로,2023.5.30 16:00,359,0,531,890,0
부산시청→연산교차로,2023.5.30 16:00,594,519,318,1431,0
사직운동장→연산교차로,2023.5.30 16:00,399,683,75,1157,0
신리→연산교차로,2023.5.30 16:00,522,279,52,853,0
안락→연산교차로,2023.5.30 16:00,450,0,110,560,0
연산터널→연산교차로,2023.5.30 16:00,236,293,35,564,0
교대→연산교차로,2023.5.30 17:00,368,0,556,924,0
부산시청→연산교차로,2023.5.30 17:00,622,552,325,1499,0
사직운동장→연산교차로,2023.5.30 17:00,391,658,59,1108,0
신리→연산교차로,2023.5.30 17:00,544,283,55,882,0
안락→연산교차로,2023.5.30 17:00,487,0,99,586,0
연산터널→연산교차로,2023.5.30 17:00,234,283,34,551,0
교대→연산교차로,2023.5.30 18:00,365,0,566,931,0
부산시청→연산교차로,2023.5.30 18:00,611,563,327,1501,0
사직운동장→연산교차로,2023.5.30 18:00,362,697,35,1094,0
신리→연산교차로,2023.5.30 18:00,547,236,64,847,0
안락→연산교차로,2023.5.30 18:00,496,0,113,609,0
연산터널→연산교차로,2023.5.30 18:00,229,281,52,562,0
교대→연산교차로,2023.5.30 19:00,330,0,451,781,0
부산시청→연산교차로,2023.5.30 19:00,512,413,283,1208,0
사직운동장→연산교차로,2023.5.30 19:00,205,543,84,832,0
신리→연산교차로,2023.5.30 19:00,407,212,37,656,0
안락→연산교차로,2023.5.30 19:00,412,0,102,514,0
연산터널→연산교차로,2023.5.30 19:00,199,276,63,538,0
교대→연산교차로,2023.5.30 20:00,318,0,335,653,0
부산시청→연산교차로,2023.5.30 20:00,497,350,255,1102,0
사직운동장→연산교차로,2023.5.30 20:00,146,493,75,714,0
신리→연산교차로,2023.5.30 20:00,339,159,43,541,0
안락→연산교차로,2023.5.30 20:00,403,0,109,512,0
연산터널→연산교차로,2023.5.30 20:00,225,262,49,536,0
교대→연산교차로,2023.5.30 21:00,288,0,320,608,0
부산시청→연산교차로,2023.5.30 21:00,522,330,220,1072,0
사직운동장→연산교차로,2023.5.30 21:00,161,433,107,701,0
신리→연산교차로,2023.5.30 21:00,308,194,32,534,0
안락→연산교차로,2023.5.30 21:00,403,0,88,491,0
연산터널→연산교차로,2023.5.30 21:00,236,254,56,546,0
교대→연산교차로,2023.5.30 22:00,170,0,180,350,0
부산시청→연산교차로,2023.5.30 22:00,306,195,113,614,0
사직운동장→연산교차로,2023.5.30 22:00,116,256,50,422,0
신리→연산교차로,2023.5.30 22:00,177,108,19,304,0
안락→연산교차로,2023.5.30 22:00,251,0,64,315,0
연산터널→연산교차로,2023.5.30 22:00,127,148,39,314,0
교대→연산교차로,2023.5.30 23:00,185,0,177,362,0
부산시청→연산교차로,2023.5.30 23:00,287,189,117,593,0
사직운동장→연산교차로,2023.5.30 23:00,128,288,50,466,0
신리→연산교차로,2023.5.30 23:00,191,110,15,316,0
안락→연산교차로,2023.5.30 23:00,267,0,60,327,0
연산터널→연산교차로,2023.5.30 23:00,155,197,60,412,0
교대→연산교차로,2023.5.31 00:00,125,0,165,290,0
부산시청→연산교차로,2023.5.31 00:00,233,148,99,480,0
사직운동장→연산교차로,2023.5.31 00:00,68,226,56,350,0
신리→연산교차로,2023.5.31 00:00,163,84,13,260,0
안락→연산교차로,2023.5.31 00:00,216,0,49,265,0
연산터널→연산교차로,2023.5.31 00:00,135,154,54,343,0
교대→연산교차로,2023.5.31 01:00,101,0,117,218,0
부산시청→연산교차로,2023.5.31 01:00,202,112,81,395,0
사직운동장→연산교차로,2023.5.31 01:00,71,189,34,294,0
신리→연산교차로,2023.5.31 01:00,109,71,16,196,0
안락→연산교차로,2023.5.31 01:00,180,0,41,221,0
연산터널→연산교차로,2023.5.31 01:00,120,145,65,330,0
교대→연산교차로,2023.5.31 02:00,79,0,87,166,0
부산시청→연산교차로,2023.5.31 02:00,152,89,53,294,0
사직운동장→연산교차로,2023.5.31 02:00,62,140,42,244,0
신리→연산교차로,2023.5.31 02:00,80,42,16,138,0
안락→연산교차로,2023.5.31 02:00,149,0,30,179,0
연산터널→연산교차로,2023.5.31 02:00,91,124,37,252,0
교대→연산교차로,2023.5.31 03:00,67,0,76,143,0
부산시청→연산교차로,2023.5.31 03:00,154,65,57,276,0
사직운동장→연산교차로,2023.5.31 03:00,38,129,31,198,0
신리→연산교차로,2023.5.31 03:00,86,31,12,129,0
안락→연산교차로,2023.5.31 03:00,92,0,28,120,0
연산터널→연산교차로,2023.5.31 03:00,96,82,40,218,0
교대→연산교차로,2023.5.31 04:00,52,0,77,129,0
부산시청→연산교차로,2023.5.31 04:00,155,70,45,270,0
사직운동장→연산교차로,2023.5.31 04:00,45,112,25,182,0
신리→연산교차로,2023.5.31 04:00,92,45,10,147,0
안락→연산교차로,2023.5.31 04:00,173,0,37,210,0
연산터널→연산교차로,2023.5.31 04:00,81,88,29,198,0
교대→연산교차로,2023.5.31 05:00,104,0,145,249,0
부산시청→연산교차로,2023.5.31 05:00,260,167,72,499,0
사직운동장→연산교차로,2023.5.31 05:00,59,163,32,254,0
신리→연산교차로,2023.5.31 05:00,240,98,14,352,0
안락→연산교차로,2023.5.31 05:00,331,0,57,388,0
연산터널→연산교차로,2023.5.31 05:00,128,161,29,318,0
교대→연산교차로,2023.5.31 06:00,196,0,260,456,0
부산시청→연산교차로,2023.5.31 06:00,365,247,113,725,0
사직운동장→연산교차로,2023.5.31 06:00,113,290,46,449,0
신리→연산교차로,2023.5.31 06:00,363,176,17,556,0
안락→연산교차로,2023.5.31 06:00,555,0,90,645,0
연산터널→연산교차로,2023.5.31 06:00,232,255,38,525,0
교대→연산교차로,2023.5.31 07:00,266,0,408,674,0
부산시청→연산교차로,2023.5.31 07:00,538,367,214,1119,0
사직운동장→연산교차로,2023.5.31 07:00,203,497,69,769,0
신리→연산교차로,2023.5.31 07:00,508,266,32,806,0
안락→연산교차로,2023.5.31 07:00,601,0,94,695,0
연산터널→연산교차로,2023.5.31 07:00,296,384,41,721,0
교대→연산교차로,2023.5.31 08:00,309,0,529,838,0
부산시청→연산교차로,2023.5.31 08:00,625,433,299,1357,0
사직운동장→연산교차로,2023.5.31 08:00,252,621,70,943,0
신리→연산교차로,2023.5.31 08:00,527,341,27,895,0
안락→연산교차로,2023.5.31 08:00,634,0,104,738,0
연산터널→연산교차로,2023.5.31 08:00,319,387,38,744,0
교대→연산교차로,2023.5.31 09:00,298,0,503,801,0
부산시청→연산교차로,2023.5.31 09:00,479,368,290,1137,0
사직운동장→연산교차로,2023.5.31 09:00,288,554,92,934,0
신리→연산교차로,2023.5.31 09:00,479,331,40,850,0
안락→연산교차로,2023.5.31 09:00,586,0,86,672,0
연산터널→연산교차로,2023.5.31 09:00,309,372,47,728,0
교대→연산교차로,2023.5.31 10:00,308,0,437,745,0
부산시청→연산교차로,2023.5.31 10:00,545,370,263,1178,0
사직운동장→연산교차로,2023.5.31 10:00,267,574,81,922,0
신리→연산교차로,2023.5.31 10:00,476,271,51,798,0
안락→연산교차로,2023.5.31 10:00,575,0,115,690,0
연산터널→연산교차로,2023.5.31 10:00,294,348,41,683,0
교대→연산교차로,2023.5.31 11:00,299,0,464,763,0
부산시청→연산교차로,2023.5.31 11:00,557,381,255,1193,0
사직운동장→연산교차로,2023.5.31 11:00,344,570,66,980,0
신리→연산교차로,2023.5.31 11:00,444,258,53,755,0
안락→연산교차로,2023.5.31 11:00,512,0,173,685,0
연산터널→연산교차로,2023.5.31 11:00,286,273,60,619,0
교대→연산교차로,2023.5.31 12:00,299,0,377,676,0
부산시청→연산교차로,2023.5.31 12:00,580,373,234,1187,0
사직운동장→연산교차로,2023.5.31 12:00,261,520,64,845,0
신리→연산교차로,2023.5.31 12:00,404,240,54,698,0
안락→연산교차로,2023.5.31 12:00,451,0,167,618,0
연산터널→연산교차로,2023.5.31 12:00,260,278,50,588,0
교대→연산교차로,2023.5.31 13:00,309,0,444,753,0
부산시청→연산교차로,2023.5.31 13:00,575,466,259,1300,0
사직운동장→연산교차로,2023.5.31 13:00,295,565,83,943,0
신리→연산교차로,2023.5.31 13:00,432,268,54,754,0
안락→연산교차로,2023.5.31 13:00,438,0,128,566,0
연산터널→연산교차로,2023.5.31 13:00,238,258,52,548,0
교대→연산교차로,2023.5.31 14:00,92,0,131,223,0
부산시청→연산교차로,2023.5.31 14:00,169,120,60,349,0
사직운동장→연산교차로,2023.5.31 14:00,66,159,17,242,0
신리→연산교차로,2023.5.31 14:00,123,65,11,199,0
안락→연산교차로,2023.5.31 14:00,115,0,20,135,0
연산터널→연산교차로,2023.5.31 14:00,59,76,11,146,0
교대→연산교차로,2023.5.31 15:00,367,0,449,816,0
부산시청→연산교차로,2023.5.31 15:00,583,496,297,1376,0
사직운동장→연산교차로,2023.5.31 15:00,264,624,63,951,0
신리→연산교차로,2023.5.31 15:00,480,257,78,815,0
안락→연산교차로,2023.5.31 15:00,461,0,89,550,0
연산터널→연산교차로,2023.5.31 15:00,239,273,32,544,0
교대→연산교차로,2023.5.31 16:00,364,0,469,833,0
부산시청→연산교차로,2023.5.31 16:00,552,479,303,1334,0
사직운동장→연산교차로,2023.5.31 16:00,294,652,37,983,0
신리→연산교차로,2023.5.31 16:00,512,279,42,833,0
안락→연산교차로,2023.5.31 16:00,465,0,118,583,0
연산터널→연산교차로,2023.5.31 16:00,251,281,34,566,0
교대→연산교차로,2023.5.31 17:00,356,0,498,854,0
부산시청→연산교차로,2023.5.31 17:00,622,576,275,1473,0
사직운동장→연산교차로,2023.5.31 17:00,279,691,27,997,0
신리→연산교차로,2023.5.31 17:00,541,283,61,885,0
안락→연산교차로,2023.5.31 17:00,460,0,101,561,0
연산터널→연산교차로,2023.5.31 17:00,254,280,45,579,0
교대→연산교차로,2023.5.31 18:00,372,0,554,926,0
부산시청→연산교차로,2023.5.31 18:00,598,560,332,1490,0
사직운동장→연산교차로,2023.5.31 18:00,306,690,48,1044,0
신리→연산교차로,2023.5.31 18:00,551,284,37,872,0
안락→연산교차로,2023.5.31 18:00,462,0,86,548,0
연산터널→연산교차로,2023.5.31 18:00,224,287,47,558,0
교대→연산교차로,2023.5.31 19:00,333,0,405,738,0
부산시청→연산교차로,2023.5.31 19:00,520,408,293,1221,0
사직운동장→연산교차로,2023.5.31 19:00,214,517,79,810,0
신리→연산교차로,2023.5.31 19:00,354,218,39,611,0
안락→연산교차로,2023.5.31 19:00,450,0,88,538,0
연산터널→연산교차로,2023.5.31 19:00,220,259,53,532,0
교대→연산교차로,2023.5.31 20:00,317,0,326,643,0
부산시청→연산교차로,2023.5.31 20:00,494,380,211,1085,0
사직운동장→연산교차로,2023.5.31 20:00,179,504,78,761,0
신리→연산교차로,2023.5.31 20:00,362,206,33,601,0
안락→연산교차로,2023.5.31 20:00,429,0,91,520,0
연산터널→연산교차로,2023.5.31 20:00,217,257,56,530,0
교대→연산교차로,2023.5.31 21:00,315,0,321,636,0
부산시청→연산교차로,2023.5.31 21:00,523,337,223,1083,0
사직운동장→연산교차로,2023.5.31 21:00,179,454,74,707,0
신리→연산교차로,2023.5.31 21:00,330,161,41,532,0
안락→연산교차로,2023.5.31 21:00,434,0,102,536,0
연산터널→연산교차로,2023.5.31 21:00,230,262,62,554,0
교대→연산교차로,2023.5.31 22:00,257,0,256,513,0
부산시청→연산교차로,2023.5.31 22:00,428,236,169,833,0
사직운동장→연산교차로,2023.5.31 22:00,165,365,69,599,0
신리→연산교차로,2023.5.31 22:00,273,173,27,473,0
안락→연산교차로,2023.5.31 22:00,393,0,100,493,0
연산터널→연산교차로,2023.5.31 22:00,214,247,70,531,0
교대→연산교차로,2023.5.31 23:00,186,0,188,374,0
부산시청→연산교차로,2023.5.31 23:00,312,190,107,609,0
사직운동장→연산교차로,2023.5.31 23:00,111,272,57,440,0
신리→연산교차로,2023.5.31 23:00,212,117,18,347,0
안락→연산교차로,2023.5.31 23:00,265,0,55,320,0
연산터널→연산교차로,2023.5.31 23:00,151,150,34,335,0
교대→연산교차로,2023.6.1 00:00,166,0,207,373,0
부산시청→연산교차로,2023.6.1 00:00,253,177,105,535,0
사직운동장→연산교차로,2023.6.1 00:00,100,259,92,451,0
신리→연산교차로,2023.6.1 00:00,183,98,7,288,0
안락→연산교차로,2023.6.1 00:00,231,0,63,294,0
연산터널→연산교차로,2023.6.1 00:00,159,227,67,453,0
교대→연산교차로,2023.6.1 01:00,119,0,170,289,0
부산시청→연산교차로,2023.6.1 01:00,263,163,95,521,0
사직운동장→연산교차로,2023.6.1 01:00,55,198,63,316,0
신리→연산교차로,2023.6.1 01:00,138,69,18,225,0
안락→연산교차로,2023.6.1 01:00,182,0,60,242,0
연산터널→연산교차로,2023.6.1 01:00,127,170,79,376,0
교대→연산교차로,2023.6.1 02:00,80,0,130,210,0
부산시청→연산교차로,2023.6.1 02:00,183,96,72,351,0
사직운동장→연산교차로,2023.6.1 02:00,49,192,54,295,0
신리→연산교차로,2023.6.1 02:00,103,51,21,175,0
안락→연산교차로,2023.6.1 02:00,157,0,40,197,0
연산터널→연산교차로,2023.6.1 02:00,115,136,57,308,0
교대→연산교차로,2023.6.1 03:00,56,0,100,156,0
부산시청→연산교차로,2023.6.1 03:00,145,78,45,268,0
사직운동장→연산교차로,2023.6.1 03:00,39,125,42,206,0
신리→연산교차로,2023.6.1 03:00,77,38,14,129,0
안락→연산교차로,2023.6.1 03:00,130,0,21,151,0
연산터널→연산교차로,2023.6.1 03:00,79,106,63,248,0
교대→연산교차로,2023.6.1 04:00,75,0,80,155,0
부산시청→연산교차로,2023.6.1 04:00,154,75,47,276,0
사직운동장→연산교차로,2023.6.1 04:00,37,108,30,175,0
신리→연산교차로,2023.6.1 04:00,95,51,11,157,0
안락→연산교차로,2023.6.1 04:00,175,0,30,205,0
연산터널→연산교차로,2023.6.1 04:00,85,100,32,217,0
교대→연산교차로,2023.6.1 05:00,114,0,133,247,0
부산시청→연산교차로,2023.6.1 05:00,262,161,95,518,0
사직운동장→연산교차로,2023.6.1 05:00,75,181,41,297,0
신리→연산교차로,2023.6.1 05:00,232,91,12,335,0
안락→연산교차로,2023.6.1 05:00,357,0,57,414,0
연산터널→연산교차로,2023.6.1 05:00,147,156,35,338,0
교대→연산교차로,2023.6.1 06:00,188,0,260,448,0
부산시청→연산교차로,2023.6.1 06:00,377,262,118,757,0
사직운동장→연산교차로,2023.6.1 06:00,106,292,54,452,0
신리→연산교차로,2023.6.1 06:00,334,168,23,525,0
안락→연산교차로,2023.6.1 06:00,556,0,83,639,0
연산터널→연산교차로,2023.6.1 06:00,230,238,29,497,0
교대→연산교차로,2023.6.1 07:00,247,0,424,671,0
부산시청→연산교차로,2023.6.1 07:00,572,361,215,1148,0
사직운동장→연산교차로,2023.6.1 07:00,189,499,69,757,0
신리→연산교차로,2023.6.1 07:00,507,246,31,784,0
안락→연산교차로,2023.6.1 07:00,644,0,74,718,0
연산터널→연산교차로,2023.6.1 07:00,278,378,53,709,0
교대→연산교차로,2023.6.1 08:00,308,0,496,804,0
부산시청→연산교차로,2023.6.1 08:00,571,411,358,1340,0
사직운동장→연산교차로,2023.6.1 08:00,245,634,87,966,0
신리→연산교차로,2023.6.1 08:00,494,337,30,861,0
안락→연산교차로,2023.6.1 08:00,626,0,106,732,0
연산터널→연산교차로,2023.6.1 08:00,325,384,41,750,0
교대→연산교차로,2023.6.1 09:00,301,0,491,792,0
부산시청→연산교차로,2023.6.1 09:00,525,371,349,1245,0
사직운동장→연산교차로,2023.6.1 09:00,250,576,96,922,0
신리→연산교차로,2023.6.1 09:00,492,315,36,843,0
안락→연산교차로,2023.6.1 09:00,584,0,91,675,0
연산터널→연산교차로,2023.6.1 09:00,290,362,51,703,0
교대→연산교차로,2023.6.1 10:00,288,0,464,752,0
부산시청→연산교차로,2023.6.1 10:00,540,368,248,1156,0
사직운동장→연산교차로,2023.6.1 10:00,331,557,67,955,0
신리→연산교차로,2023.6.1 10:00,433,276,49,758,0
안락→연산교차로,2023.6.1 10:00,531,0,150,681,0
연산터널→연산교차로,2023.6.1 10:00,285,338,40,663,0
교대→연산교차로,2023.6.1 11:00,293,0,436,729,0
부산시청→연산교차로,2023.6.1 11:00,557,358,240,1155,0
사직운동장→연산교차로,2023.6.1 11:00,277,540,82,899,0
신리→연산교차로,2023.6.1 11:00,433,236,52,721,0
안락→연산교차로,2023.6.1 11:00,546,0,159,705,0
연산터널→연산교차로,2023.6.1 11:00,273,297,68,638,0
교대→연산교차로,2023.6.1 12:00,294,0,394,688,0
부산시청→연산교차로,2023.6.1 12:00,553,349,245,1147,0
사직운동장→연산교차로,2023.6.1 12:00,288,562,99,949,0
신리→연산교차로,2023.6.1 12:00,410,235,48,693,0
안락→연산교차로,2023.6.1 12:00,525,0,124,649,0
연산터널→연산교차로,2023.6.1 12:00,276,286,56,618,0
교대→연산교차로,2023.6.1 13:00,326,0,440,766,0
부산시청→연산교차로,2023.6.1 13:00,560,423,268,1251,0
사직운동장→연산교차로,2023.6.1 13:00,237,597,116,950,0
신리→연산교차로,2023.6.1 13:00,417,274,44,735,0
안락→연산교차로,2023.6.1 13:00,449,0,130,579,0
연산터널→연산교차로,2023.6.1 13:00,241,257,46,544,0
교대→연산교차로,2023.6.1 14:00,355,0,523,878,0
부산시청→연산교차로,2023.6.1 14:00,538,437,307,1282,0
사직운동장→연산교차로,2023.6.1 14:00,303,615,93,1011,0
신리→연산교차로,2023.6.1 14:00,465,253,55,773,0
안락→연산교차로,2023.6.1 14:00,470,0,120,590,0
연산터널→연산교차로,2023.6.1 14:00,250,269,47,566,0
교대→연산교차로,2023.6.1 15:00,339,0,528,867,0
부산시청→연산교차로,2023.6.1 15:00,606,467,286,1359,0
사직운동장→연산교차로,2023.6.1 15:00,312,629,95,1036,0
신리→연산교차로,2023.6.1 15:00,473,297,52,822,0
안락→연산교차로,2023.6.1 15:00,445,0,131,576,0
연산터널→연산교차로,2023.6.1 15:00,230,269,50,549,0
교대→연산교차로,2023.6.1 16:00,346,0,512,858,0
부산시청→연산교차로,2023.6.1 16:00,568,500,309,1377,0
사직운동장→연산교차로,2023.6.1 16:00,314,641,66,1021,0
신리→연산교차로,2023.6.1 16:00,485,271,56,812,0
안락→연산교차로,2023.6.1 16:00,448,0,111,559,0
연산터널→연산교차로,2023.6.1 16:00,240,282,31,553,0
교대→연산교차로,2023.6.1 17:00,362,0,578,940,0
부산시청→연산교차로,2023.6.1 17:00,596,525,289,1410,0
사직운동장→연산교차로,2023.6.1 17:00,307,658,58,1023,0
신리→연산교차로,2023.6.1 17:00,505,284,34,823,0
안락→연산교차로,2023.6.1 17:00,472,0,114,586,0
연산터널→연산교차로,2023.6.1 17:00,223,278,39,540,0
교대→연산교차로,2023.6.1 18:00,351,0,553,904,0
부산시청→연산교차로,2023.6.1 18:00,550,547,341,1438,0
사직운동장→연산교차로,2023.6.1 18:00,306,651,41,998,0
신리→연산교차로,2023.6.1 18:00,497,268,49,814,0
안락→연산교차로,2023.6.1 18:00,455,0,91,546,0
연산터널→연산교차로,2023.6.1 18:00,224,293,63,580,0
교대→연산교차로,2023.6.1 19:00,324,0,400,724,0
부산시청→연산교차로,2023.6.1 19:00,520,440,283,1243,0
사직운동장→연산교차로,2023.6.1 19:00,210,534,53,797,0
신리→연산교차로,2023.6.1 19:00,367,204,29,600,0
안락→연산교차로,2023.6.1 19:00,413,0,84,497,0
연산터널→연산교차로,2023.6.1 19:00,203,237,50,490,0
교대→연산교차로,2023.6.1 20:00,288,0,293,581,0
부산시청→연산교차로,2023.6.1 20:00,482,376,199,1057,0
사직운동장→연산교차로,2023.6.1 20:00,190,475,32,697,0
신리→연산교차로,2023.6.1 20:00,318,157,26,501,0
안락→연산교차로,2023.6.1 20:00,405,0,80,485,0
연산터널→연산교차로,2023.6.1 20:00,201,241,31,473,0
교대→연산교차로,2023.6.1 21:00,289,0,270,559,0
부산시청→연산교차로,2023.6.1 21:00,467,356,215,1038,0
사직운동장→연산교차로,2023.6.1 21:00,171,398,27,596,0
신리→연산교차로,2023.6.1 21:00,305,186,26,517,0
안락→연산교차로,2023.6.1 21:00,364,0,93,457,0
연산터널→연산교차로,2023.6.1 21:00,246,232,45,523,0
교대→연산교차로,2023.6.1 22:00,240,0,198,438,0
부산시청→연산교차로,2023.6.1 22:00,405,308,154,867,0
사직운동장→연산교차로,2023.6.1 22:00,173,334,29,536,0
신리→연산교차로,2023.6.1 22:00,245,170,20,435,0
안락→연산교차로,2023.6.1 22:00,359,0,72,431,0
연산터널→연산교차로,2023.6.1 22:00,182,219,38,439,0
교대→연산교차로,2023.6.1 23:00,178,0,177,355,0
부산시청→연산교차로,2023.6.1 23:00,310,204,127,641,0
사직운동장→연산교차로,2023.6.1 23:00,130,244,34,408,0
신리→연산교차로,2023.6.1 23:00,200,134,15,349,0
안락→연산교차로,2023.6.1 23:00,257,0,70,327,0
연산터널→연산교차로,2023.6.1 23:00,148,195,37,380,0
교대→연산교차로,2023.6.2 00:00,141,0,134,275,0
부산시청→연산교차로,2023.6.2 00:00,247,174,104,525,0
사직운동장→연산교차로,2023.6.2 00:00,91,217,24,332,0
신리→연산교차로,2023.6.2 00:00,165,96,12,273,0
안락→연산교차로,2023.6.2 00:00,195,0,64,259,0
연산터널→연산교차로,2023.6.2 00:00,130,158,37,325,0
교대→연산교차로,2023.6.2 01:00,90,0,125,215,0
부산시청→연산교차로,2023.6.2 01:00,208,108,77,393,0
사직운동장→연산교차로,2023.6.2 01:00,73,173,35,281,0
신리→연산교차로,2023.6.2 01:00,117,72,19,208,0
안락→연산교차로,2023.6.2 01:00,144,0,45,189,0
연산터널→연산교차로,2023.6.2 01:00,108,148,43,299,0
교대→연산교차로,2023.6.2 02:00,76,0,89,165,0
부산시청→연산교차로,2023.6.2 02:00,161,102,71,334,0
사직운동장→연산교차로,2023.6.2 02:00,60,139,15,214,0
신리→연산교차로,2023.6.2 02:00,87,52,7,146,0
안락→연산교차로,2023.6.2 02:00,145,0,28,173,0
연산터널→연산교차로,2023.6.2 02:00,76,116,31,223,0
교대→연산교차로,2023.6.2 03:00,58,0,73,131,0
부산시청→연산교차로,2023.6.2 03:00,139,68,42,249,0
사직운동장→연산교차로,2023.6.2 03:00,48,130,13,191,0
신리→연산교차로,2023.6.2 03:00,77,27,7,111,0
안락→연산교차로,2023.6.2 03:00,109,0,27,136,0
연산터널→연산교차로,2023.6.2 03:00,72,96,23,191,0
교대→연산교차로,2023.6.2 04:00,47,0,77,124,0
부산시청→연산교차로,2023.6.2 04:00,144,86,49,279,0
사직운동장→연산교차로,2023.6.2 04:00,37,105,16,158,0
신리→연산교차로,2023.6.2 04:00,90,42,7,139,0
안락→연산교차로,2023.6.2 04:00,181,0,27,208,0
연산터널→연산교차로,2023.6.2 04:00,74,91,22,187,0
교대→연산교차로,2023.6.2 05:00,104,0,152,256,0
부산시청→연산교차로,2023.6.2 05:00,236,155,75,466,0
사직운동장→연산교차로,2023.6.2 05:00,63,149,40,252,0
신리→연산교차로,2023.6.2 05:00,225,89,19,333,0
안락→연산교차로,2023.6.2 05:00,337,0,59,396,0
연산터널→연산교차로,2023.6.2 05:00,138,151,37,326,0
교대→연산교차로,2023.6.2 06:00,178,0,256,434,0
부산시청→연산교차로,2023.6.2 06:00,361,247,131,739,0
사직운동장→연산교차로,2023.6.2 06:00,92,283,37,412,0
신리→연산교차로,2023.6.2 06:00,323,156,27,506,0
안락→연산교차로,2023.6.2 06:00,540,0,82,622,0
연산터널→연산교차로,2023.6.2 06:00,211,233,35,479,0
교대→연산교차로,2023.6.2 07:00,250,0,424,674,0
부산시청→연산교차로,2023.6.2 07:00,541,373,203,1117,0
사직운동장→연산교차로,2023.6.2 07:00,192,509,54,755,0
신리→연산교차로,2023.6.2 07:00,461,258,37,756,0
안락→연산교차로,2023.6.2 07:00,629,0,61,690,0
연산터널→연산교차로,2023.6.2 07:00,259,362,42,663,0
교대→연산교차로,2023.6.2 08:00,331,0,481,812,0
부산시청→연산교차로,2023.6.2 08:00,578,422,348,1348,0
사직운동장→연산교차로,2023.6.2 08:00,259,660,76,995,0
신리→연산교차로,2023.6.2 08:00,530,339,29,898,0
안락→연산교차로,2023.6.2 08:00,635,0,84,719,0
연산터널→연산교차로,2023.6.2 08:00,324,388,31,743,0
교대→연산교차로,2023.6.2 09:00,306,0,538,844,0
부산시청→연산교차로,2023.6.2 09:00,515,380,295,1190,0
사직운동장→연산교차로,2023.6.2 09:00,257,611,78,946,0
신리→연산교차로,2023.6.2 09:00,464,339,54,857,0
안락→연산교차로,2023.6.2 09:00,609,0,91,700,0
연산터널→연산교차로,2023.6.2 09:00,306,354,38,698,0
교대→연산교차로,2023.6.2 10:00,291,0,422,713,0
부산시청→연산교차로,2023.6.2 10:00,542,361,283,1186,0
사직운동장→연산교차로,2023.6.2 10:00,259,522,76,857,0
신리→연산교차로,2023.6.2 10:00,480,271,67,818,0
안락→연산교차로,2023.6.2 10:00,608,0,106,714,0
연산터널→연산교차로,2023.6.2 10:00,306,340,49,695,0
교대→연산교차로,2023.6.2 11:00,298,0,423,721,0
부산시청→연산교차로,2023.6.2 11:00,560,363,264,1187,0
사직운동장→연산교차로,2023.6.2 11:00,311,553,66,930,0
신리→연산교차로,2023.6.2 11:00,438,268,65,771,0
안락→연산교차로,2023.6.2 11:00,558,0,132,690,0
연산터널→연산교차로,2023.6.2 11:00,253,279,40,572,0
교대→연산교차로,2023.6.2 12:00,320,0,391,711,0
부산시청→연산교차로,2023.6.2 12:00,572,367,249,1188,0
사직운동장→연산교차로,2023.6.2 12:00,265,549,75,889,0
신리→연산교차로,2023.6.2 12:00,393,229,37,659,0
안락→연산교차로,2023.6.2 12:00,522,0,140,662,0
연산터널→연산교차로,2023.6.2 12:00,259,267,56,582,0
교대→연산교차로,2023.6.2 13:00,352,0,440,792,0
부산시청→연산교차로,2023.6.2 13:00,621,420,260,1301,0
사직운동장→연산교차로,2023.6.2 13:00,299,586,78,963,0
신리→연산교차로,2023.6.2 13:00,443,262,44,749,0
안락→연산교차로,2023.6.2 13:00,438,0,106,544,0
연산터널→연산교차로,2023.6.2 13:00,255,272,39,566,0
교대→연산교차로,2023.6.2 14:00,363,0,473,836,0
부산시청→연산교차로,2023.6.2 14:00,605,483,301,1389,0
사직운동장→연산교차로,2023.6.2 14:00,286,633,75,994,0
신리→연산교차로,2023.6.2 14:00,485,274,71,830,0
안락→연산교차로,2023.6.2 14:00,437,0,134,571,0
연산터널→연산교차로,2023.6.2 14:00,226,277,51,554,0
교대→연산교차로,2023.6.2 15:00,361,0,492,853,0
부산시청→연산교차로,2023.6.2 15:00,597,475,339,1411,0
사직운동장→연산교차로,2023.6.2 15:00,330,632,57,1019,0
신리→연산교차로,2023.6.2 15:00,514,272,58,844,0
안락→연산교차로,2023.6.2 15:00,417,0,124,541,0
연산터널→연산교차로,2023.6.2 15:00,239,282,54,575,0
교대→연산교차로,2023.6.2 16:00,370,0,476,846,0
부산시청→연산교차로,2023.6.2 16:00,639,533,300,1472,0
사직운동장→연산교차로,2023.6.2 16:00,323,652,63,1038,0
신리→연산교차로,2023.6.2 16:00,547,311,38,896,0
안락→연산교차로,2023.6.2 16:00,444,0,96,540,0
연산터널→연산교차로,2023.6.2 16:00,256,266,38,560,0
교대→연산교차로,2023.6.2 17:00,365,0,551,916,0
부산시청→연산교차로,2023.6.2 17:00,630,545,312,1487,0
사직운동장→연산교차로,2023.6.2 17:00,304,696,55,1055,0
신리→연산교차로,2023.6.2 17:00,515,325,47,887,0
안락→연산교차로,2023.6.2 17:00,460,0,94,554,0
연산터널→연산교차로,2023.6.2 17:00,245,290,36,571,0
교대→연산교차로,2023.6.2 18:00,359,0,603,962,0
부산시청→연산교차로,2023.6.2 18:00,619,571,371,1561,0
사직운동장→연산교차로,2023.6.2 18:00,289,651,53,993,0
신리→연산교차로,2023.6.2 18:00,531,273,68,872,0
안락→연산교차로,2023.6.2 18:00,484,0,102,586,0
연산터널→연산교차로,2023.6.2 18:00,228,285,48,561,0
교대→연산교차로,2023.6.2 19:00,354,0,506,860,0
부산시청→연산교차로,2023.6.2 19:00,593,426,283,1302,0
사직운동장→연산교차로,2023.6.2 19:00,225,562,86,873,0
신리→연산교차로,2023.6.2 19:00,399,204,41,644,0
안락→연산교차로,2023.6.2 19:00,456,0,101,557,0
연산터널→연산교차로,2023.6.2 19:00,224,249,71,544,0
교대→연산교차로,2023.6.2 20:00,318,0,379,697,0
부산시청→연산교차로,2023.6.2 20:00,475,391,242,1108,0
사직운동장→연산교차로,2023.6.2 20:00,196,519,102,817,0
신리→연산교차로,2023.6.2 20:00,350,212,38,600,0
안락→연산교차로,2023.6.2 20:00,401,0,95,496,0
연산터널→연산교차로,2023.6.2 20:00,239,265,63,567,0
교대→연산교차로,2023.6.2 21:00,303,0,342,645,0
부산시청→연산교차로,2023.6.2 21:00,556,351,250,1157,0
사직운동장→연산교차로,2023.6.2 21:00,219,497,67,783,0
신리→연산교차로,2023.6.2 21:00,344,226,33,603,0
안락→연산교차로,2023.6.2 21:00,447,0,142,589,0
연산터널→연산교차로,2023.6.2 21:00,261,289,64,614,0
교대→연산교차로,2023.6.2 22:00,300,0,330,630,0
부산시청→연산교차로,2023.6.2 22:00,462,290,205,957,0
사직운동장→연산교차로,2023.6.2 22:00,230,489,60,779,0
신리→연산교차로,2023.6.2 22:00,288,180,33,501,0
안락→연산교차로,2023.6.2 22:00,422,0,118,540,0
연산터널→연산교차로,2023.6.2 22:00,229,244,80,553,0
교대→연산교차로,2023.6.2 23:00,224,0,240,464,0
부산시청→연산교차로,2023.6.2 23:00,409,218,172,799,0
사직운동장→연산교차로,2023.6.2 23:00,144,370,96,610,0
신리→연산교차로,2023.6.2 23:00,236,136,20,392,0
안락→연산교차로,2023.6.2 23:00,371,0,96,467,0
연산터널→연산교차로,2023.6.2 23:00,182,245,60,487,0
교대→연산교차로,2023.6.3 00:00,207,0,242,449,0
부산시청→연산교차로,2023.6.3 00:00,334,204,119,657,0
사직운동장→연산교차로,2023.6.3 00:00,123,267,62,452,0
신리→연산교차로,2023.6.3 00:00,235,139,24,398,0
안락→연산교차로,2023.6.3 00:00,260,0,72,332,0
연산터널→연산교차로,2023.6.3 00:00,158,210,65,433,0
교대→연산교차로,2023.6.3 01:00,170,0,217,387,0
부산시청→연산교차로,2023.6.3 01:00,277,179,133,589,0
사직운동장→연산교차로,2023.6.3 01:00,79,262,64,405,0
신리→연산교차로,2023.6.3 01:00,179,110,22,311,0
안락→연산교차로,2023.6.3 01:00,245,0,55,300,0
연산터널→연산교차로,2023.6.3 01:00,142,214,70,426,0
교대→연산교차로,2023.6.3 02:00,120,0,174,294,0
부산시청→연산교차로,2023.6.3 02:00,266,139,103,508,0
사직운동장→연산교차로,2023.6.3 02:00,87,187,64,338,0
신리→연산교차로,2023.6.3 02:00,139,93,19,251,0
안락→연산교차로,2023.6.3 02:00,180,0,57,237,0
연산터널→연산교차로,2023.6.3 02:00,147,180,50,377,0
교대→연산교차로,2023.6.3 03:00,89,0,140,229,0
부산시청→연산교차로,2023.6.3 03:00,196,92,65,353,0
사직운동장→연산교차로,2023.6.3 03:00,70,168,63,301,0
신리→연산교차로,2023.6.3 03:00,110,68,13,191,0
안락→연산교차로,2023.6.3 03:00,164,0,48,212,0
연산터널→연산교차로,2023.6.3 03:00,85,131,47,263,0
교대→연산교차로,2023.6.3 04:00,92,0,112,204,0
부산시청→연산교차로,2023.6.3 04:00,190,92,60,342,0
사직운동장→연산교차로,2023.6.3 04:00,52,142,46,240,0
신리→연산교차로,2023.6.3 04:00,106,58,9,173,0
안락→연산교차로,2023.6.3 04:00,213,0,39,252,0
연산터널→연산교차로,2023.6.3 04:00,94,117,28,239,0
교대→연산교차로,2023.6.3 05:00,117,0,184,301,0
부산시청→연산교차로,2023.6.3 05:00,243,195,76,514,0
사직운동장→연산교차로,2023.6.3 05:00,64,191,57,312,0
신리→연산교차로,2023.6.3 05:00,208,95,13,316,0
안락→연산교차로,2023.6.3 05:00,348,0,59,407,0
연산터널→연산교차로,2023.6.3 05:00,139,164,33,336,0
교대→연산교차로,2023.6.3 06:00,177,0,205,382,0
부산시청→연산교차로,2023.6.3 06:00,343,228,96,667,0
사직운동장→연산교차로,2023.6.3 06:00,100,224,36,360,0
신리→연산교차로,2023.6.3 06:00,255,129,26,410,0
안락→연산교차로,2023.6.3 06:00,420,0,81,501,0
연산터널→연산교차로,2023.6.3 06:00,193,165,42,400,0
교대→연산교차로,2023.6.3 07:00,161,0,219,380,0
부산시청→연산교차로,2023.6.3 07:00,395,241,139,775,0
사직운동장→연산교차로,2023.6.3 07:00,130,333,61,524,0
신리→연산교차로,2023.6.3 07:00,287,156,31,474,0
안락→연산교차로,2023.6.3 07:00,409,0,77,486,0
연산터널→연산교차로,2023.6.3 07:00,195,193,47,435,0
교대→연산교차로,2023.6.3 08:00,272,0,317,589,0
부산시청→연산교차로,2023.6.3 08:00,442,320,245,1007,0
사직운동장→연산교차로,2023.6.3 08:00,243,581,45,869,0
신리→연산교차로,2023.6.3 08:00,431,275,40,746,0
안락→연산교차로,2023.6.3 08:00,567,0,116,683,0
연산터널→연산교차로,2023.6.3 08:00,297,305,49,651,0
교대→연산교차로,2023.6.3 09:00,285,0,371,656,0
부산시청→연산교차로,2023.6.3 09:00,546,377,277,1200,0
사직운동장→연산교차로,2023.6.3 09:00,266,618,65,949,0
신리→연산교차로,2023.6.3 09:00,467,296,57,820,0
안락→연산교차로,2023.6.3 09:00,594,0,137,731,0
연산터널→연산교차로,2023.6.3 09:00,324,328,66,718,0
교대→연산교차로,2023.6.3 10:00,301,0,448,749,0
부산시청→연산교차로,2023.6.3 10:00,590,372,281,1243,0
사직운동장→연산교차로,2023.6.3 10:00,278,612,58,948,0
신리→연산교차로,2023.6.3 10:00,511,305,55,871,0
안락→연산교차로,2023.6.3 10:00,592,0,133,725,0
연산터널→연산교차로,2023.6.3 10:00,292,340,66,698,0
교대→연산교차로,2023.6.3 11:00,322,0,491,813,0
부산시청→연산교차로,2023.6.3 11:00,599,382,271,1252,0
사직운동장→연산교차로,2023.6.3 11:00,338,611,77,1026,0
신리→연산교차로,2023.6.3 11:00,536,297,68,901,0
안락→연산교차로,2023.6.3 11:00,597,0,181,778,0
연산터널→연산교차로,2023.6.3 11:00,327,331,60,718,0
교대→연산교차로,2023.6.3 12:00,309,0,470,779,0
부산시청→연산교차로,2023.6.3 12:00,613,400,294,1307,0
사직운동장→연산교차로,2023.6.3 12:00,287,623,53,963,0
신리→연산교차로,2023.6.3 12:00,482,312,75,869,0
안락→연산교차로,2023.6.3 12:00,583,0,160,743,0
연산터널→연산교차로,2023.6.3 12:00,310,328,59,697,0
교대→연산교차로,2023.6.3 13:00,377,0,517,894,0
부산시청→연산교차로,2023.6.3 13:00,690,474,288,1452,0
사직운동장→연산교차로,2023.6.3 13:00,311,663,45,1019,0
신리→연산교차로,2023.6.3 13:00,478,292,45,815,0
안락→연산교차로,2023.6.3 13:00,487,0,106,593,0
연산터널→연산교차로,2023.6.3 13:00,266,268,57,591,0
교대→연산교차로,2023.6.3 14:00,368,0,471,839,0
부산시청→연산교차로,2023.6.3 14:00,669,448,295,1412,0
사직운동장→연산교차로,2023.6.3 14:00,356,655,46,1057,0
신리→연산교차로,2023.6.3 14:00,463,293,64,820,0
안락→연산교차로,2023.6.3 14:00,455,0,98,553,0
연산터널→연산교차로,2023.6.3 14:00,260,270,44,574,0
교대→연산교차로,2023.6.3 15:00,354,0,459,813,0
부산시청→연산교차로,2023.6.3 15:00,618,504,331,1453,0
사직운동장→연산교차로,2023.6.3 15:00,294,650,81,1025,0
신리→연산교차로,2023.6.3 15:00,462,335,46,843,0
안락→연산교차로,2023.6.3 15:00,455,0,90,545,0
연산터널→연산교차로,2023.6.3 15:00,254,272,45,571,0
교대→연산교차로,2023.6.3 16:00,338,0,412,750,0
부산시청→연산교차로,2023.6.3 16:00,629,513,289,1431,0
사직운동장→연산교차로,2023.6.3 16:00,369,670,54,1093,0
신리→연산교차로,2023.6.3 16:00,470,310,46,826,0
안락→연산교차로,2023.6.3 16:00,460,0,71,531,0
연산터널→연산교차로,2023.6.3 16:00,237,277,41,555,0
교대→연산교차로,2023.6.3 17:00,340,0,428,768,0
부산시청→연산교차로,2023.6.3 17:00,591,464,267,1322,0
사직운동장→연산교차로,2023.6.3 17:00,263,621,64,948,0
신리→연산교차로,2023.6.3 17:00,462,229,36,727,0
안락→연산교차로,2023.6.3 17:00,481,0,103,584,0
연산터널→연산교차로,2023.6.3 17:00,232,275,49,556,0
교대→연산교차로,2023.6.3 18:00,352,0,404,756,0
부산시청→연산교차로,2023.6.3 18:00,569,416,240,1225,0
사직운동장→연산교차로,2023.6.3 18:00,244,589,59,892,0
신리→연산교차로,2023.6.3 18:00,362,223,39,624,0
안락→연산교차로,2023.6.3 18:00,466,0,104,570,0
연산터널→연산교차로,2023.6.3 18:00,228,258,53,539,0
교대→연산교차로,2023.6.3 19:00,308,0,343,651,0
부산시청→연산교차로,2023.6.3 19:00,479,329,208,1016,0
사직운동장→연산교차로,2023.6.3 19:00,194,469,95,758,0
신리→연산교차로,2023.6.3 19:00,328,203,32,563,0
안락→연산교차로,2023.6.3 19:00,429,0,107,536,0
연산터널→연산교차로,2023.6.3 19:00,222,284,61,567,0
교대→연산교차로,2023.6.3 20:00,319,0,302,621,0
부산시청→연산교차로,2023.6.3 20:00,471,379,197,1047,0
사직운동장→연산교차로,2023.6.3 20:00,180,461,56,697,0
신리→연산교차로,2023.6.3 20:00,328,169,29,526,0
안락→연산교차로,2023.6.3 20:00,419,0,87,506,0
연산터널→연산교차로,2023.6.3 20:00,228,272,70,570,0
교대→연산교차로,2023.6.3 21:00,275,0,327,602,0
부산시청→연산교차로,2023.6.3 21:00,499,327,212,1038,0
사직운동장→연산교차로,2023.6.3 21:00,245,439,59,743,0
신리→연산교차로,2023.6.3 21:00,386,214,27,627,0
안락→연산교차로,2023.6.3 21:00,405,0,141,546,0
연산터널→연산교차로,2023.6.3 21:00,236,245,60,541,0
교대→연산교차로,2023.6.3 22:00,262,0,290,552,0
부산시청→연산교차로,2023.6.3 22:00,467,272,170,909,0
사직운동장→연산교차로,2023.6.3 22:00,181,436,93,710,0
신리→연산교차로,2023.6.3 22:00,299,187,28,514,0
안락→연산교차로,2023.6.3 22:00,383,0,119,502,0
연산터널→연산교차로,2023.6.3 22:00,211,238,68,517,0
교대→연산교차로,2023.6.3 23:00,235,0,278,513,0
부산시청→연산교차로,2023.6.3 23:00,336,229,144,709,0
사직운동장→연산교차로,2023.6.3 23:00,114,346,70,530,0
신리→연산교차로,2023.6.3 23:00,295,154,21,470,0
안락→연산교차로,2023.6.3 23:00,311,0,95,406,0
연산터널→연산교차로,2023.6.3 23:00,204,231,72,507,0
교대→연산교차로,2023.6.4 00:00,171,0,214,385,1
부산시청→연산교차로,2023.6.4 00:00,329,198,125,652,1
사직운동장→연산교차로,2023.6.4 00:00,124,293,83,500,1
신리→연산교차로,2023.6.4 00:00,220,110,15,345,1
안락→연산교차로,2023.6.4 00:00,286,0,57,343,1
연산터널→연산교차로,2023.6.4 00:00,150,192,67,409,1
교대→연산교차로,2023.6.4 01:00,138,0,213,351,1
부산시청→연산교차로,2023.6.4 01:00,292,181,106,579,1
사직운동장→연산교차로,2023.6.4 01:00,91,195,69,355,1
신리→연산교차로,2023.6.4 01:00,186,108,16,310,1
안락→연산교차로,2023.6.4 01:00,222,0,69,291,1
연산터널→연산교차로,2023.6.4 01:00,145,209,42,396,1
교대→연산교차로,2023.6.4 02:00,128,0,170,298,1
부산시청→연산교차로,2023.6.4 02:00,232,129,91,452,1
사직운동장→연산교차로,2023.6.4 02:00,83,191,34,308,1
신리→연산교차로,2023.6.4 02:00,153,79,19,251,1
안락→연산교차로,2023.6.4 02:00,206,0,56,262,1
연산터널→연산교차로,2023.6.4 02:00,107,167,56,330,1
교대→연산교차로,2023.6.4 03:00,102,0,135,237,1
부산시청→연산교차로,2023.6.4 03:00,211,100,72,383,1
사직운동장→연산교차로,2023.6.4 03:00,55,168,58,281,1
신리→연산교차로,2023.6.4 03:00,101,61,15,177,1
안락→연산교차로,2023.6.4 03:00,136,0,37,173,1
연산터널→연산교차로,2023.6.4 03:00,106,111,40,257,1
교대→연산교차로,2023.6.4 04:00,71,0,105,176,1
부산시청→연산교차로,2023.6.4 04:00,175,90,55,320,1
사직운동장→연산교차로,2023.6.4 04:00,50,112,32,194,1
신리→연산교차로,2023.6.4 04:00,95,51,9,155,1
안락→연산교차로,2023.6.4 04:00,126,0,26,152,1
연산터널→연산교차로,2023.6.4 04:00,88,97,27,212,1
교대→연산교차로,2023.6.4 05:00,71,0,104,175,1
부산시청→연산교차로,2023.6.4 05:00,179,104,59,342,1
사직운동장→연산교차로,2023.6.4 05:00,41,124,39,204,1
신리→연산교차로,2023.6.4 05:00,135,68,7,210,1
안락→연산교차로,2023.6.4 05:00,180,0,41,221,1
연산터널→연산교차로,2023.6.4 05:00,91,95,26,212,1
교대→연산교차로,2023.6.4 06:00,114,0,139,253,1
부산시청→연산교차로,2023.6.4 06:00,226,163,53,442,1
사직운동장→연산교차로,2023.6.4 06:00,68,168,31,267,1
신리→연산교차로,2023.6.4 06:00,180,72,8,260,1
안락→연산교차로,2023.6.4 06:00,249,0,48,297,1
연산터널→연산교차로,2023.6.4 06:00,150,111,29,290,1
교대→연산교차로,2023.6.4 07:00,135,0,157,292,1
부산시청→연산교차로,2023.6.4 07:00,225,178,76,479,1
사직운동장→연산교차로,2023.6.4 07:00,65,196,50,311,1
신리→연산교차로,2023.6.4 07:00,211,99,17,327,1
안락→연산교차로,2023.6.4 07:00,290,0,49,339,1
연산터널→연산교차로,2023.6.4 07:00,127,108,34,269,1
교대→연산교차로,2023.6.4 08:00,157,0,197,354,1
부산시청→연산교차로,2023.6.4 08:00,294,237,101,632,1
사직운동장→연산교차로,2023.6.4 08:00,129,270,38,437,1
신리→연산교차로,2023.6.4 08:00,273,166,26,465,1
안락→연산교차로,2023.6.4 08:00,355,0,67,422,1
연산터널→연산교차로,2023.6.4 08:00,156,142,31,329,1
교대→연산교차로,2023.6.4 09:00,239,0,272,511,1
부산시청→연산교차로,2023.6.4 09:00,410,316,164,890,1
사직운동장→연산교차로,2023.6.4 09:00,173,396,48,617,1
신리→연산교차로,2023.6.4 09:00,376,217,22,615,1
안락→연산교차로,2023.6.4 09:00,435,0,110,545,1
연산터널→연산교차로,2023.6.4 09:00,263,213,23,499,1
교대→연산교차로,2023.6.4 10:00,289,0,305,594,1
부산시청→연산교차로,2023.6.4 10:00,519,309,190,1018,1
사직운동장→연산교차로,2023.6.4 10:00,215,526,51,792,1
신리→연산교차로,2023.6.4 10:00,404,208,35,647,1
안락→연산교차로,2023.6.4 10:00,510,0,118,628,1
연산터널→연산교차로,2023.6.4 10:00,231,230,43,504,1
교대→연산교차로,2023.6.4 11:00,272,0,326,598,1
부산시청→연산교차로,2023.6.4 11:00,493,333,180,1006,1
사직운동장→연산교차로,2023.6.4 11:00,265,549,51,865,1
신리→연산교차로,2023.6.4 11:00,454,223,26,703,1
안락→연산교차로,2023.6.4 11:00,471,0,147,618,1
연산터널→연산교차로,2023.6.4 11:00,250,224,43,517,1
교대→연산교차로,2023.6.4 12:00,291,0,343,634,1
부산시청→연산교차로,2023.6.4 12:00,510,349,204,1063,1
사직운동장→연산교차로,2023.6.4 12:00,212,530,64,806,1
신리→연산교차로,2023.6.4 12:00,396,297,33,726,1
안락→연산교차로,2023.6.4 12:00,524,0,167,691,1
연산터널→연산교차로,2023.6.4 12:00,297,248,40,585,1
교대→연산교차로,2023.6.4 13:00,324,0,355,679,1
부산시청→연산교차로,2023.6.4 13:00,528,353,238,1119,1
사직운동장→연산교차로,2023.6.4 13:00,249,573,51,873,1
신리→연산교차로,2023.6.4 13:00,381,274,33,688,1
안락→연산교차로,2023.6.4 13:00,540,0,129,669,1
연산터널→연산교차로,2023.6.4 13:00,296,239,56,591,1
교대→연산교차로,2023.6.4 14:00,307,0,352,659,1
부산시청→연산교차로,2023.6.4 14:00,574,377,252,1203,1
사직운동장→연산교차로,2023.6.4 14:00,301,559,57,917,1
신리→연산교차로,2023.6.4 14:00,394,209,37,640,1
안락→연산교차로,2023.6.4 14:00,469,0,111,580,1
연산터널→연산교차로,2023.6.4 14:00,230,222,62,514,1
교대→연산교차로,2023.6.4 15:00,303,0,311,614,1
부산시청→연산교차로,2023.6.4 15:00,526,365,249,1140,1
사직운동장→연산교차로,2023.6.4 15:00,246,508,53,807,1
신리→연산교차로,2023.6.4 15:00,409,190,36,635,1
안락→연산교차로,2023.6.4 15:00,502,0,124,626,1
연산터널→연산교차로,2023.6.4 15:00,251,251,38,540,1
교대→연산교차로,2023.6.4 16:00,306,0,343,649,1
부산시청→연산교차로,2023.6.4 16:00,541,370,227,1138,1
사직운동장→연산교차로,2023.6.4 16:00,247,511,42,800,1
신리→연산교차로,2023.6.4 16:00,409,212,32,653,1
안락→연산교차로,2023.6.4 16:00,497,0,137,634,1
연산터널→연산교차로,2023.6.4 16:00,227,241,43,511,1
교대→연산교차로,2023.6.4 17:00,318,0,298,616,1
부산시청→연산교차로,2023.6.4 17:00,520,343,212,1075,1
사직운동장→연산교차로,2023.6.4 17:00,291,534,50,875,1
신리→연산교차로,2023.6.4 17:00,336,202,37,575,1
안락→연산교차로,2023.6.4 17:00,527,0,148,675,1
연산터널→연산교차로,2023.6.4 17:00,242,241,48,531,1
교대→연산교차로,2023.6.4 18:00,308,0,302,610,1
부산시청→연산교차로,2023.6.4 18:00,486,292,180,958,1
사직운동장→연산교차로,2023.6.4 18:00,250,519,48,817,1
신리→연산교차로,2023.6.4 18:00,348,151,30,529,1
안락→연산교차로,2023.6.4 18:00,453,0,128,581,1
연산터널→연산교차로,2023.6.4 18:00,183,237,68,488,1
교대→연산교차로,2023.6.4 19:00,285,0,257,542,1
부산시청→연산교차로,2023.6.4 19:00,420,300,168,888,1
사직운동장→연산교차로,2023.6.4 19:00,161,435,48,644,1
신리→연산교차로,2023.6.4 19:00,329,152,26,507,1
안락→연산교차로,2023.6.4 19:00,410,0,112,522,1
연산터널→연산교차로,2023.6.4 19:00,216,224,65,505,1
교대→연산교차로,2023.6.4 20:00,287,0,262,549,1
부산시청→연산교차로,2023.6.4 20:00,433,255,180,868,1
사직운동장→연산교차로,2023.6.4 20:00,156,399,50,605,1
신리→연산교차로,2023.6.4 20:00,325,159,27,511,1
안락→연산교차로,2023.6.4 20:00,384,0,93,477,1
연산터널→연산교차로,2023.6.4 20:00,180,228,40,448,1
교대→연산교차로,2023.6.4 21:00,265,0,210,475,1
부산시청→연산교차로,2023.6.4 21:00,417,272,151,840,1
사직운동장→연산교차로,2023.6.4 21:00,151,341,56,548,1
신리→연산교차로,2023.6.4 21:00,320,165,22,507,1
안락→연산교차로,2023.6.4 21:00,397,0,88,485,1
연산터널→연산교차로,2023.6.4 21:00,206,188,51,445,1
교대→연산교차로,2023.6.4 22:00,238,0,201,439,1
부산시청→연산교차로,2023.6.4 22:00,371,218,149,738,1
사직운동장→연산교차로,2023.6.4 22:00,123,315,63,501,1
신리→연산교차로,2023.6.4 22:00,270,133,24,427,1
안락→연산교차로,2023.6.4 22:00,313,0,78,391,1
연산터널→연산교차로,2023.6.4 22:00,167,187,44,398,1
교대→연산교차로,2023.6.4 23:00,144,0,160,304,1
부산시청→연산교차로,2023.6.4 23:00,262,136,116,514,1
사직운동장→연산교차로,2023.6.4 23:00,93,234,58,385,1
신리→연산교차로,2023.6.4 23:00,180,105,16,301,1
안락→연산교차로,2023.6.4 23:00,256,0,51,307,1
연산터널→연산교차로,2023.6.4 23:00,129,154,44,327,1
교대→연산교차로,2023.6.5 00:00,110,0,133,243,0
부산시청→연산교차로,2023.6.5 00:00,219,125,91,435,0
사직운동장→연산교차로,2023.6.5 00:00,68,182,50,300,0
신리→연산교차로,2023.6.5 00:00,156,83,17,256,0
안락→연산교차로,2023.6.5 00:00,162,0,34,196,0
연산터널→연산교차로,2023.6.5 00:00,104,125,39,268,0
교대→연산교차로,2023.6.5 01:00,74,0,134,208,0
부산시청→연산교차로,2023.6.5 01:00,177,110,68,355,0
사직운동장→연산교차로,2023.6.5 01:00,41,162,59,262,0
신리→연산교차로,2023.6.5 01:00,101,56,13,170,0
안락→연산교차로,2023.6.5 01:00,140,0,36,176,0
연산터널→연산교차로,2023.6.5 01:00,100,106,43,249,0
교대→연산교차로,2023.6.5 02:00,47,0,75,122,0
부산시청→연산교차로,2023.6.5 02:00,150,77,60,287,0
사직운동장→연산교차로,2023.6.5 02:00,30,126,35,191,0
신리→연산교차로,2023.6.5 02:00,79,45,10,134,0
안락→연산교차로,2023.6.5 02:00,112,0,27,139,0
연산터널→연산교차로,2023.6.5 02:00,71,107,40,218,0
교대→연산교차로,2023.6.5 03:00,54,0,53,107,0
부산시청→연산교차로,2023.6.5 03:00,132,74,40,246,0
사직운동장→연산교차로,2023.6.5 03:00,39,101,34,174,0
신리→연산교차로,2023.6.5 03:00,73,34,9,116,0
안락→연산교차로,2023.6.5 03:00,95,0,30,125,0
연산터널→연산교차로,2023.6.5 03:00,64,94,46,204,0
교대→연산교차로,2023.6.5 04:00,46,0,65,111,0
부산시청→연산교차로,2023.6.5 04:00,138,71,41,250,0
사직운동장→연산교차로,2023.6.5 04:00,29,97,23,149,0
신리→연산교차로,2023.6.5 04:00,83,34,12,129,0
안락→연산교차로,2023.6.5 04:00,187,0,38,225,0
연산터널→연산교차로,2023.6.5 04:00,75,91,25,191,0
교대→연산교차로,2023.6.5 05:00,100,0,139,239,0
부산시청→연산교차로,2023.6.5 05:00,229,154,66,449,0
사직운동장→연산교차로,2023.6.5 05:00,52,166,37,255,0
신리→연산교차로,2023.6.5 05:00,228,106,12,346,0
안락→연산교차로,2023.6.5 05:00,345,0,53,398,0
연산터널→연산교차로,2023.6.5 05:00,120,153,26,299,0
교대→연산교차로,2023.6.5 06:00,174,0,238,412,0
부산시청→연산교차로,2023.6.5 06:00,361,247,106,714,0
사직운동장→연산교차로,2023.6.5 06:00,91,270,47,408,0
신리→연산교차로,2023.6.5 06:00,328,154,19,501,0
안락→연산교차로,2023.6.5 06:00,542,0,91,633,0
연산터널→연산교차로,2023.6.5 06:00,216,250,42,508,0
교대→연산교차로,2023.6.5 07:00,265,0,368,633,0
부산시청→연산교차로,2023.6.5 07:00,527,323,228,1078,0
사직운동장→연산교차로,2023.6.5 07:00,188,492,47,727,0
신리→연산교차로,2023.6.5 07:00,447,237,34,718,0
안락→연산교차로,2023.6.5 07:00,597,0,77,674,0
연산터널→연산교차로,2023.6.5 07:00,304,367,36,707,0
교대→연산교차로,2023.6.5 08:00,315,0,529,844,0
부산시청→연산교차로,2023.6.5 08:00,540,429,344,1313,0
사직운동장→연산교차로,2023.6.5 08:00,276,631,77,984,0
신리→연산교차로,2023.6.5 08:00,523,331,35,889,0
안락→연산교차로,2023.6.5 08:00,636,0,83,719,0
연산터널→연산교차로,2023.6.5 08:00,336,368,42,746,0
교대→연산교차로,2023.6.5 09:00,296,0,508,804,0
부산시청→연산교차로,2023.6.5 09:00,517,363,305,1185,0
사직운동장→연산교차로,2023.6.5 09:00,236,559,116,911,0
신리→연산교차로,2023.6.5 09:00,461,295,41,797,0
안락→연산교차로,2023.6.5 09:00,587,0,96,683,0
연산터널→연산교차로,2023.6.5 09:00,298,359,54,711,0
교대→연산교차로,2023.6.5 10:00,300,0,476,776,0
부산시청→연산교차로,2023.6.5 10:00,581,382,256,1219,0
사직운동장→연산교차로,2023.6.5 10:00,322,595,82,999,0
신리→연산교차로,2023.6.5 10:00,438,266,67,771,0
안락→연산교차로,2023.6.5 10:00,588,0,142,730,0
연산터널→연산교차로,2023.6.5 10:00,315,311,56,682,0
교대→연산교차로,2023.6.5 11:00,321,0,438,759,0
부산시청→연산교차로,2023.6.5 11:00,560,383,265,1208,0
사직운동장→연산교차로,2023.6.5 11:00,398,577,73,1048,0
신리→연산교차로,2023.6.5 11:00,427,257,64,748,0
안락→연산교차로,2023.6.5 11:00,540,0,137,677,0
연산터널→연산교차로,2023.6.5 11:00,263,316,61,640,0
교대→연산교차로,2023.6.5 12:00,306,0,418,724,0
부산시청→연산교차로,2023.6.5 12:00,573,347,234,1154,0
사직운동장→연산교차로,2023.6.5 12:00,325,572,68,965,0
신리→연산교차로,2023.6.5 12:00,458,168,43,669,0
안락→연산교차로,2023.6.5 12:00,491,0,122,613,0
연산터널→연산교차로,2023.6.5 12:00,285,286,47,618,0
교대→연산교차로,2023.6.5 13:00,322,0,436,758,0
부산시청→연산교차로,2023.6.5 13:00,590,444,265,1299,0
사직운동장→연산교차로,2023.6.5 13:00,322,590,98,1010,0
신리→연산교차로,2023.6.5 13:00,440,264,47,751,0
안락→연산교차로,2023.6.5 13:00,422,0,121,543,0
연산터널→연산교차로,2023.6.5 13:00,269,271,43,583,0
교대→연산교차로,2023.6.5 14:00,360,0,565,925,0
부산시청→연산교차로,2023.6.5 14:00,575,470,271,1316,0
사직운동장→연산교차로,2023.6.5 14:00,377,627,71,1075,0
신리→연산교차로,2023.6.5 14:00,456,292,46,794,0
안락→연산교차로,2023.6.5 14:00,458,0,99,557,0
연산터널→연산교차로,2023.6.5 14:00,252,265,41,558,0
교대→연산교차로,2023.6.5 15:00,359,0,517,876,0
부산시청→연산교차로,2023.6.5 15:00,630,509,288,1427,0
사직운동장→연산교차로,2023.6.5 15:00,413,637,99,1149,0
신리→연산교차로,2023.6.5 15:00,498,242,58,798,0
안락→연산교차로,2023.6.5 15:00,462,0,108,570,0
연산터널→연산교차로,2023.6.5 15:00,245,271,47,563,0
교대→연산교차로,2023.6.5 16:00,378,0,510,888,0
부산시청→연산교차로,2023.6.5 16:00,640,523,314,1477,0
사직운동장→연산교차로,2023.6.5 16:00,338,674,39,1051,0
신리→연산교차로,2023.6.5 16:00,532,270,58,860,0
안락→연산교차로,2023.6.5 16:00,447,0,92,539,0
연산터널→연산교차로,2023.6.5 16:00,265,269,38,572,0
교대→연산교차로,2023.6.5 17:00,383,0,534,917,0
부산시청→연산교차로,2023.6.5 17:00,639,538,314,1491,0
사직운동장→연산교차로,2023.6.5 17:00,286,690,70,1046,0
신리→연산교차로,2023.6.5 17:00,540,257,53,850,0
안락→연산교차로,2023.6.5 17:00,444,0,94,538,0
연산터널→연산교차로,2023.6.5 17:00,247,277,48,572,0
교대→연산교차로,2023.6.5 18:00,352,0,541,893,0
부산시청→연산교차로,2023.6.5 18:00,614,563,335,1512,0
사직운동장→연산교차로,2023.6.5 18:00,266,668,46,980,0
신리→연산교차로,2023.6.5 18:00,540,271,40,851,0
안락→연산교차로,2023.6.5 18:00,501,0,94,595,0
연산터널→연산교차로,2023.6.5 18:00,247,262,49,558,0
교대→연산교차로,2023.6.5 19:00,348,0,404,752,0
부산시청→연산교차로,2023.6.5 19:00,544,401,254,1199,0
사직운동장→연산교차로,2023.6.5 19:00,213,557,71,841,0
신리→연산교차로,2023.6.5 19:00,391,201,35,627,0
안락→연산교차로,2023.6.5 19:00,440,0,108,548,0
연산터널→연산교차로,2023.6.5 19:00,211,277,47,535,0
교대→연산교차로,2023.6.5 20:00,328,0,363,691,0
부산시청→연산교차로,2023.6.5 20:00,427,362,259,1048,0
사직운동장→연산교차로,2023.6.5 20:00,201,495,72,768,0
신리→연산교차로,2023.6.5 20:00,320,185,38,543,0
안락→연산교차로,2023.6.5 20:00,419,0,96,515,0
연산터널→연산교차로,2023.6.5 20:00,209,277,76,562,0
교대→연산교차로,2023.6.5 21:00,280,0,310,590,0
부산시청→연산교차로,2023.6.5 21:00,472,334,212,1018,0
사직운동장→연산교차로,2023.6.5 21:00,190,432,72,694,0
신리→연산교차로,2023.6.5 21:00,332,197,27,556,0
안락→연산교차로,2023.6.5 21:00,448,0,108,556,0
연산터널→연산교차로,2023.6.5 21:00,229,255,58,542,0
교대→연산교차로,2023.6.5 22:00,253,0,264,517,0
부산시청→연산교차로,2023.6.5 22:00,450,247,169,866,0
사직운동장→연산교차로,2023.6.5 22:00,162,381,82,625,0
신리→연산교차로,2023.6.5 22:00,262,170,40,472,0
안락→연산교차로,2023.6.5 22:00,350,0,98,448,0
연산터널→연산교차로,2023.6.5 22:00,246,270,64,580,0
교대→연산교차로,2023.6.5 23:00,210,0,241,451,0
부산시청→연산교차로,2023.6.5 23:00,341,202,129,672,0
사직운동장→연산교차로,2023.6.5 23:00,101,314,95,510,0
신리→연산교차로,2023.6.5 23:00,231,119,26,376,0
안락→연산교차로,2023.6.5 23:00,280,0,78,358,0
연산터널→연산교차로,2023.6.5 23:00,184,218,54,456,0
교대→연산교차로,2023.6.6 00:00,149,0,191,340,1
부산시청→연산교차로,2023.6.6 00:00,306,166,122,594,1
사직운동장→연산교차로,2023.6.6 00:00,94,263,79,436,1
신리→연산교차로,2023.6.6 00:00,194,124,18,336,1
안락→연산교차로,2023.6.6 00:00,247,0,63,310,1
연산터널→연산교차로,2023.6.6 00:00,148,204,52,404,1
교대→연산교차로,2023.6.6 01:00,136,0,187,323,1
부산시청→연산교차로,2023.6.6 01:00,250,159,100,509,1
사직운동장→연산교차로,2023.6.6 01:00,57,215,50,322,1
신리→연산교차로,2023.6.6 01:00,162,84,22,268,1
안락→연산교차로,2023.6.6 01:00,209,0,53,262,1
연산터널→연산교차로,2023.6.6 01:00,119,139,52,310,1
교대→연산교차로,2023.6.6 02:00,105,0,148,253,1
부산시청→연산교차로,2023.6.6 02:00,214,120,82,416,1
사직운동장→연산교차로,2023.6.6 02:00,57,167,44,268,1
신리→연산교차로,2023.6.6 02:00,123,73,14,210,1
안락→연산교차로,2023.6.6 02:00,166,0,40,206,1
연산터널→연산교차로,2023.6.6 02:00,125,140,33,298,1
교대→연산교차로,2023.6.6 03:00,80,0,96,176,1
부산시청→연산교차로,2023.6.6 03:00,190,91,68,349,1
사직운동장→연산교차로,2023.6.6 03:00,61,147,48,256,1
신리→연산교차로,2023.6.6 03:00,87,48,7,142,1
안락→연산교차로,2023.6.6 03:00,147,0,47,194,1
연산터널→연산교차로,2023.6.6 03:00,90,130,42,262,1
교대→연산교차로,2023.6.6 04:00,70,0,77,147,1
부산시청→연산교차로,2023.6.6 04:00,156,91,45,292,1
사직운동장→연산교차로,2023.6.6 04:00,37,107,32,176,1
신리→연산교차로,2023.6.6 04:00,116,48,9,173,1
안락→연산교차로,2023.6.6 04:00,165,0,34,199,1
연산터널→연산교차로,2023.6.6 04:00,86,82,20,188,1
교대→연산교차로,2023.6.6 05:00,100,0,135,235,1
부산시청→연산교차로,2023.6.6 05:00,238,147,61,446,1
사직운동장→연산교차로,2023.6.6 05:00,65,157,48,270,1
신리→연산교차로,2023.6.6 05:00,199,90,14,303,1
안락→연산교차로,2023.6.6 05:00,313,0,66,379,1
연산터널→연산교차로,2023.6.6 05:00,115,136,35,286,1
교대→연산교차로,2023.6.6 06:00,178,0,182,360,1
부산시청→연산교차로,2023.6.6 06:00,314,177,90,581,1
사직운동장→연산교차로,2023.6.6 06:00,80,222,47,349,1
신리→연산교차로,2023.6.6 06:00,247,117,32,396,1
안락→연산교차로,2023.6.6 06:00,400,0,86,486,1
연산터널→연산교차로,2023.6.6 06:00,196,168,35,399,1
교대→연산교차로,2023.6.6 07:00,151,0,176,327,1
부산시청→연산교차로,2023.6.6 07:00,360,223,120,703,1
사직운동장→연산교차로,2023.6.6 07:00,109,268,52,429,1
신리→연산교차로,2023.6.6 07:00,276,152,25,453,1
안락→연산교차로,2023.6.6 07:00,386,0,71,457,1
연산터널→연산교차로,2023.6.6 07:00,158,177,45,380,1
교대→연산교차로,2023.6.6 08:00,161,0,192,353,1
부산시청→연산교차로,2023.6.6 08:00,353,227,181,761,1
사직운동장→연산교차로,2023.6.6 08:00,169,376,46,591,1
신리→연산교차로,2023.6.6 08:00,274,203,32,509,1
안락→연산교차로,2023.6.6 08:00,393,0,93,486,1
연산터널→연산교차로,2023.6.6 08:00,225,200,48,473,1
교대→연산교차로,2023.6.6 09:00,233,0,245,478,1
부산시청→연산교차로,2023.6.6 09:00,446,290,175,911,1
사직운동장→연산교차로,2023.6.6 09:00,183,423,46,652,1
신리→연산교차로,2023.6.6 09:00,391,176,39,606,1
안락→연산교차로,2023.6.6 09:00,463,0,101,564,1
연산터널→연산교차로,2023.6.6 09:00,212,232,28,472,1
교대→연산교차로,2023.6.6 10:00,258,0,249,507,1
부산시청→연산교차로,2023.6.6 10:00,506,334,219,1059,1
사직운동장→연산교차로,2023.6.6 10:00,225,555,50,830,1
신리→연산교차로,2023.6.6 10:00,421,205,52,678,1
안락→연산교차로,2023.6.6 10:00,490,0,117,607,1
연산터널→연산교차로,2023.6.6 10:00,235,274,48,557,1
교대→연산교차로,2023.6.6 11:00,271,0,284,555,1
부산시청→연산교차로,2023.6.6 11:00,540,324,230,1094,1
사직운동장→연산교차로,2023.6.6 11:00,247,578,60,885,1
신리→연산교차로,2023.6.6 11:00,430,229,42,701,1
안락→연산교차로,2023.6.6 11:00,529,0,129,658,1
연산터널→연산교차로,2023.6.6 11:00,255,261,37,553,1
교대→연산교차로,2023.6.6 12:00,270,0,312,582,1
부산시청→연산교차로,2023.6.6 12:00,572,317,221,1110,1
사직운동장→연산교차로,2023.6.6 12:00,278,563,51,892,1
신리→연산교차로,2023.6.6 12:00,450,216,54,720,1
안락→연산교차로,2023.6.6 12:00,506,0,157,663,1
연산터널→연산교차로,2023.6.6 12:00,279,252,45,576,1
교대→연산교차로,2023.6.6 13:00,287,0,287,574,1
부산시청→연산교차로,2023.6.6 13:00,600,339,227,1166,1
사직운동장→연산교차로,2023.6.6 13:00,221,566,51,838,1
신리→연산교차로,2023.6.6 13:00,361,209,47,617,1
안락→연산교차로,2023.6.6 13:00,479,0,141,620,1
연산터널→연산교차로,2023.6.6 13:00,287,288,39,614,1
교대→연산교차로,2023.6.6 14:00,309,0,322,631,1
부산시청→연산교차로,2023.6.6 14:00,562,345,231,1138,1
사직운동장→연산교차로,2023.6.6 14:00,258,559,55,872,1
신리→연산교차로,2023.6.6 14:00,372,230,42,644,1
안락→연산교차로,2023.6.6 14:00,507,0,178,685,1
연산터널→연산교차로,2023.6.6 14:00,262,283,47,592,1
교대→연산교차로,2023.6.6 15:00,307,0,308,615,1
부산시청→연산교차로,2023.6.6 15:00,540,360,255,1155,1
사직운동장→연산교차로,2023.6.6 15:00,264,529,40,833,1
신리→연산교차로,2023.6.6 15:00,410,268,45,723,1
안락→연산교차로,2023.6.6 15:00,502,0,201,703,1
연산터널→연산교차로,2023.6.6 15:00,231,235,48,514,1
교대→연산교차로,2023.6.6 16:00,315,0,270,585,1
부산시청→연산교차로,2023.6.6 16:00,592,364,255,1211,1
사직운동장→연산교차로,2023.6.6 16:00,270,522,32,824,1
신리→연산교차로,2023.6.6 16:00,419,267,34,720,1
안락→연산교차로,2023.6.6 16:00,548,0,147,695,1
연산터널→연산교차로,2023.6.6 16:00,272,271,40,583,1
교대→연산교차로,2023.6.6 17:00,307,0,349,656,1
부산시청→연산교차로,2023.6.6 17:00,541,345,219,1105,1
사직운동장→연산교차로,2023.6.6 17:00,242,595,54,891,1
신리→연산교차로,2023.6.6 17:00,355,226,41,622,1
안락→연산교차로,2023.6.6 17:00,538,0,121,659,1
연산터널→연산교차로,2023.6.6 17:00,231,278,42,551,1
교대→연산교차로,2023.6.6 18:00,302,0,348,650,1
부산시청→연산교차로,2023.6.6 18:00,489,309,221,1019,1
사직운동장→연산교차로,2023.6.6 18:00,227,466,65,758,1
신리→연산교차로,2023.6.6 18:00,328,189,48,565,1
안락→연산교차로,2023.6.6 18:00,550,0,140,690,1
연산터널→연산교차로,2023.6.6 18:00,224,246,47,517,1
교대→연산교차로,2023.6.6 19:00,274,0,267,541,1
부산시청→연산교차로,2023.6.6 19:00,433,284,166,883,1
사직운동장→연산교차로,2023.6.6 19:00,165,440,62,667,1
신리→연산교차로,2023.6.6 19:00,306,174,37,517,1
안락→연산교차로,2023.6.6 19:00,408,0,106,514,1
연산터널→연산교차로,2023.6.6 19:00,204,212,64,480,1
교대→연산교차로,2023.6.6 20:00,259,0,236,495,1
부산시청→연산교차로,2023.6.6 20:00,412,268,213,893,1
사직운동장→연산교차로,2023.6.6 20:00,235,504,59,798,1
신리→연산교차로,2023.6.6 20:00,336,164,25,525,1
안락→연산교차로,2023.6.6 20:00,387,0,106,493,1
연산터널→연산교차로,2023.6.6 20:00,186,230,44,460,1
교대→연산교차로,2023.6.6 21:00,266,0,234,500,1
부산시청→연산교차로,2023.6.6 21:00,399,273,177,849,1
사직운동장→연산교차로,2023.6.6 21:00,184,410,63,657,1
신리→연산교차로,2023.6.6 21:00,260,179,31,470,1
안락→연산교차로,2023.6.6 21:00,345,0,94,439,1
연산터널→연산교차로,2023.6.6 21:00,221,215,63,499,1
교대→연산교차로,2023.6.6 22:00,204,0,229,433,1
부산시청→연산교차로,2023.6.6 22:00,348,197,122,667,1
사직운동장→연산교차로,2023.6.6 22:00,116,322,61,499,1
신리→연산교차로,2023.6.6 22:00,229,121,28,378,1
안락→연산교차로,2023.6.6 22:00,268,0,84,352,1
연산터널→연산교차로,2023.6.6 22:00,173,197,63,433,1
교대→연산교차로,2023.6.6 23:00,139,0,165,304,1
부산시청→연산교차로,2023.6.6 23:00,287,167,93,547,1
사직운동장→연산교차로,2023.6.6 23:00,93,246,58,397,1
신리→연산교차로,2023.6.6 23:00,179,82,29,290,1
안락→연산교차로,2023.6.6 23:00,220,0,49,269,1
연산터널→연산교차로,2023.6.6 23:00,145,153,73,371,1
교대→연산교차로,2023.6.7 00:00,118,0,160,278,0
부산시청→연산교차로,2023.6.7 00:00,237,141,104,482,0
사직운동장→연산교차로,2023.6.7 00:00,76,219,67,362,0
신리→연산교차로,2023.6.7 00:00,136,83,27,246,0
안락→연산교차로,2023.6.7 00:00,194,0,53,247,0
연산터널→연산교차로,2023.6.7 00:00,143,176,78,397,0
교대→연산교차로,2023.6.7 01:00,102,0,142,244,0
부산시청→연산교차로,2023.6.7 01:00,190,133,81,404,0
사직운동장→연산교차로,2023.6.7 01:00,65,191,51,307,0
신리→연산교차로,2023.6.7 01:00,117,70,18,205,0
안락→연산교차로,2023.6.7 01:00,151,0,41,192,0
연산터널→연산교차로,2023.6.7 01:00,110,122,47,279,0
교대→연산교차로,2023.6.7 02:00,70,0,92,162,0
부산시청→연산교차로,2023.6.7 02:00,171,95,70,336,0
사직운동장→연산교차로,2023.6.7 02:00,56,161,39,256,0
신리→연산교차로,2023.6.7 02:00,88,39,19,146,0
안락→연산교차로,2023.6.7 02:00,132,0,24,156,0
연산터널→연산교차로,2023.6.7 02:00,83,137,46,266,0
교대→연산교차로,2023.6.7 03:00,59,0,87,146,0
부산시청→연산교차로,2023.6.7 03:00,138,77,62,277,0
사직운동장→연산교차로,2023.6.7 03:00,47,139,33,219,0
신리→연산교차로,2023.6.7 03:00,78,40,12,130,0
안락→연산교차로,2023.6.7 03:00,99,0,24,123,0
연산터널→연산교차로,2023.6.7 03:00,87,97,58,242,0
교대→연산교차로,2023.6.7 04:00,61,0,67,128,0
부산시청→연산교차로,2023.6.7 04:00,151,75,52,278,0
사직운동장→연산교차로,2023.6.7 04:00,30,118,25,173,0
신리→연산교차로,2023.6.7 04:00,100,53,9,162,0
안락→연산교차로,2023.6.7 04:00,172,0,38,210,0
연산터널→연산교차로,2023.6.7 04:00,85,105,33,223,0
교대→연산교차로,2023.6.7 05:00,95,0,155,250,0
부산시청→연산교차로,2023.6.7 05:00,230,162,76,468,0
사직운동장→연산교차로,2023.6.7 05:00,56,169,32,257,0
신리→연산교차로,2023.6.7 05:00,200,99,12,311,0
안락→연산교차로,2023.6.7 05:00,323,0,58,381,0
연산터널→연산교차로,2023.6.7 05:00,137,154,29,320,0
교대→연산교차로,2023.6.7 06:00,184,0,262,446,0
부산시청→연산교차로,2023.6.7 06:00,367,245,125,737,0
사직운동장→연산교차로,2023.6.7 06:00,108,298,51,457,0
신리→연산교차로,2023.6.7 06:00,320,154,27,501,0
안락→연산교차로,2023.6.7 06:00,526,0,87,613,0
연산터널→연산교차로,2023.6.7 06:00,226,234,49,509,0
교대→연산교차로,2023.6.7 07:00,274,0,437,711,0
부산시청→연산교차로,2023.6.7 07:00,538,377,229,1144,0
사직운동장→연산교차로,2023.6.7 07:00,234,508,62,804,0
신리→연산교차로,2023.6.7 07:00,481,254,30,765,0
안락→연산교차로,2023.6.7 07:00,590,0,92,682,0
연산터널→연산교차로,2023.6.7 07:00,305,375,49,729,0
교대→연산교차로,2023.6.7 08:00,328,0,492,820,0
부산시청→연산교차로,2023.6.7 08:00,617,401,314,1332,0
사직운동장→연산교차로,2023.6.7 08:00,244,650,65,959,0
신리→연산교차로,2023.6.7 08:00,520,347,30,897,0
안락→연산교차로,2023.6.7 08:00,628,0,112,740,0
연산터널→연산교차로,2023.6.7 08:00,308,372,40,720,0
교대→연산교차로,2023.6.7 09:00,282,0,477,759,0
부산시청→연산교차로,2023.6.7 09:00,511,375,258,1144,0
사직운동장→연산교차로,2023.6.7 09:00,232,561,101,894,0
신리→연산교차로,2023.6.7 09:00,453,348,31,832,0
안락→연산교차로,2023.6.7 09:00,591,0,107,698,0
연산터널→연산교차로,2023.6.7 09:00,303,355,44,702,0
교대→연산교차로,2023.6.7 10:00,305,0,436,741,0
부산시청→연산교차로,2023.6.7 10:00,556,358,274,1188,0
사직운동장→연산교차로,2023.6.7 10:00,334,543,70,947,0
신리→연산교차로,2023.6.7 10:00,469,262,65,796,0
안락→연산교차로,2023.6.7 10:00,560,0,136,696,0
연산터널→연산교차로,2023.6.7 10:00,287,364,31,682,0
교대→연산교차로,2023.6.7 11:00,305,0,446,751,0
부산시청→연산교차로,2023.6.7 11:00,556,340,255,1151,0
사직운동장→연산교차로,2023.6.7 11:00,293,542,94,929,0
신리→연산교차로,2023.6.7 11:00,411,250,65,726,0
안락→연산교차로,2023.6.7 11:00,526,0,123,649,0
연산터널→연산교차로,2023.6.7 11:00,282,278,49,609,0
교대→연산교차로,2023.6.7 12:00,308,0,413,721,0
부산시청→연산교차로,2023.6.7 12:00,511,315,264,1090,0
사직운동장→연산교차로,2023.6.7 12:00,239,524,91,854,0
신리→연산교차로,2023.6.7 12:00,424,238,26,688,0
안락→연산교차로,2023.6.7 12:00,514,0,156,670,0
연산터널→연산교차로,2023.6.7 12:00,244,253,56,553,0
교대→연산교차로,2023.6.7 13:00,330,0,402,732,0
부산시청→연산교차로,2023.6.7 13:00,533,458,266,1257,0
사직운동장→연산교차로,2023.6.7 13:00,341,587,100,1028,0
신리→연산교차로,2023.6.7 13:00,422,271,56,749,0
안락→연산교차로,2023.6.7 13:00,457,0,103,560,0
연산터널→연산교차로,2023.6.7 13:00,237,278,26,541,0
교대→연산교차로,2023.6.7 14:00,349,0,501,850,0
부산시청→연산교차로,2023.6.7 14:00,603,421,306,1330,0
사직운동장→연산교차로,2023.6.7 14:00,347,612,93,1052,0
신리→연산교차로,2023.6.7 14:00,469,269,54,792,0
안락→연산교차로,2023.6.7 14:00,439,0,97,536,0
연산터널→연산교차로,2023.6.7 14:00,245,267,42,554,0
교대→연산교차로,2023.6.7 15:00,340,0,448,788,0
부산시청→연산교차로,2023.6.7 15:00,625,468,292,1385,0
사직운동장→연산교차로,2023.6.7 15:00,308,592,59,959,0
신리→연산교차로,2023.6.7 15:00,480,296,51,827,0
안락→연산교차로,2023.6.7 15:00,435,0,109,544,0
연산터널→연산교차로,2023.6.7 15:00,235,278,40,553,0
교대→연산교차로,2023.6.7 16:00,364,0,474,838,0
부산시청→연산교차로,2023.6.7 16:00,636,530,303,1469,0
사직운동장→연산교차로,2023.6.7 16:00,293,667,55,1015,0
신리→연산교차로,2023.6.7 16:00,518,275,44,837,0
안락→연산교차로,2023.6.7 16:00,462,0,102,564,0
연산터널→연산교차로,2023.6.7 16:00,249,266,31,546,0
교대→연산교차로,2023.6.7 17:00,356,0,534,890,0
부산시청→연산교차로,2023.6.7 17:00,565,481,318,1364,0
사직운동장→연산교차로,2023.6.7 17:00,389,681,61,1131,0
신리→연산교차로,2023.6.7 17:00,521,320,52,893,0
안락→연산교차로,2023.6.7 17:00,474,0,118,592,0
연산터널→연산교차로,2023.6.7 17:00,247,285,39,571,0
교대→연산교차로,2023.6.7 18:00,377,0,618,995,0
부산시청→연산교차로,2023.6.7 18:00,594,573,339,1506,0
사직운동장→연산교차로,2023.6.7 18:00,320,675,38,1033,0
신리→연산교차로,2023.6.7 18:00,519,259,49,827,0
안락→연산교차로,2023.6.7 18:00,454,0,97,551,0
연산터널→연산교차로,2023.6.7 18:00,226,246,59,531,0
교대→연산교차로,2023.6.7 19:00,319,0,402,721,0
부산시청→연산교차로,2023.6.7 19:00,528,393,268,1189,0
사직운동장→연산교차로,2023.6.7 19:00,178,539,86,803,0
신리→연산교차로,2023.6.7 19:00,354,213,37,604,0
안락→연산교차로,2023.6.7 19:00,450,0,94,544,0
연산터널→연산교차로,2023.6.7 19:00,202,238,64,504,0
교대→연산교차로,2023.6.7 20:00,315,0,326,641,0
부산시청→연산교차로,2023.6.7 20:00,510,379,223,1112,0
사직운동장→연산교차로,2023.6.7 20:00,180,468,58,706,0
신리→연산교차로,2023.6.7 20:00,305,182,44,531,0
안락→연산교차로,2023.6.7 20:00,387,0,102,489,0
연산터널→연산교차로,2023.6.7 20:00,204,246,56,506,0
교대→연산교차로,2023.6.7 21:00,277,0,284,561,0
부산시청→연산교차로,2023.6.7 21:00,462,313,206,981,0
사직운동장→연산교차로,2023.6.7 21:00,184,480,89,753,0
신리→연산교차로,2023.6.7 21:00,310,186,35,531,0
안락→연산교차로,2023.6.7 21:00,406,0,102,508,0
연산터널→연산교차로,2023.6.7 21:00,222,258,55,535,0
교대→연산교차로,2023.6.7 22:00,257,0,253,510,0
부산시청→연산교차로,2023.6.7 22:00,394,275,176,845,0
사직운동장→연산교차로,2023.6.7 22:00,223,427,58,708,0
신리→연산교차로,2023.6.7 22:00,264,158,29,451,0
안락→연산교차로,2023.6.7 22:00,386,0,103,489,0
연산터널→연산교차로,2023.6.7 22:00,197,227,72,496,0
교대→연산교차로,2023.6.7 23:00,199,0,168,367,0
부산시청→연산교차로,2023.6.7 23:00,296,198,115,609,0
사직운동장→연산교차로,2023.6.7 23:00,137,275,27,439,0
신리→연산교차로,2023.6.7 23:00,239,134,19,392,0
안락→연산교차로,2023.6.7 23:00,283,0,55,338,0
연산터널→연산교차로,2023.6.7 23:00,171,173,31,375,0
교대→연산교차로,2023.6.8 00:00,131,0,143,274,0
부산시청→연산교차로,2023.6.8 00:00,256,151,116,523,0
사직운동장→연산교차로,2023.6.8 00:00,98,263,44,405,0
신리→연산교차로,2023.6.8 00:00,152,105,16,273,0
안락→연산교차로,2023.6.8 00:00,225,0,62,287,0
연산터널→연산교차로,2023.6.8 00:00,130,157,55,342,0
교대→연산교차로,2023.6.8 01:00,88,0,118,206,0
부산시청→연산교차로,2023.6.8 01:00,190,98,87,375,0
사직운동장→연산교차로,2023.6.8 01:00,62,160,55,277,0
신리→연산교차로,2023.6.8 01:00,104,70,22,196,0
안락→연산교차로,2023.6.8 01:00,159,0,46,205,0
연산터널→연산교차로,2023.6.8 01:00,108,134,43,285,0
교대→연산교차로,2023.6.8 02:00,64,0,95,159,0
부산시청→연산교차로,2023.6.8 02:00,156,88,60,304,0
사직운동장→연산교차로,2023.6.8 02:00,51,130,33,214,0
신리→연산교차로,2023.6.8 02:00,78,37,15,130,0
안락→연산교차로,2023.6.8 02:00,144,0,37,181,0
연산터널→연산교차로,2023.6.8 02:00,83,113,32,228,0
교대→연산교차로,2023.6.8 03:00,62,0,63,125,0
부산시청→연산교차로,2023.6.8 03:00,146,68,57,271,0
사직운동장→연산교차로,2023.6.8 03:00,37,123,19,179,0
신리→연산교차로,2023.6.8 03:00,66,36,11,113,0
안락→연산교차로,2023.6.8 03:00,100,0,28,128,0
연산터널→연산교차로,2023.6.8 03:00,79,88,37,204,0
교대→연산교차로,2023.6.8 04:00,47,0,80,127,0
부산시청→연산교차로,2023.6.8 04:00,155,65,50,270,0
사직운동장→연산교차로,2023.6.8 04:00,40,123,27,190,0
신리→연산교차로,2023.6.8 04:00,96,50,7,153,0
안락→연산교차로,2023.6.8 04:00,183,0,31,214,0
연산터널→연산교차로,2023.6.8 04:00,72,95,30,197,0
교대→연산교차로,2023.6.8 05:00,86,0,137,223,0
부산시청→연산교차로,2023.6.8 05:00,245,168,79,492,0
사직운동장→연산교차로,2023.6.8 05:00,75,165,33,273,0
신리→연산교차로,2023.6.8 05:00,191,96,9,296,0
안락→연산교차로,2023.6.8 05:00,331,0,51,382,0
연산터널→연산교차로,2023.6.8 05:00,153,138,38,329,0
교대→연산교차로,2023.6.8 06:00,176,0,264,440,0
부산시청→연산교차로,2023.6.8 06:00,361,250,133,744,0
사직운동장→연산교차로,2023.6.8 06:00,128,296,35,459,0
신리→연산교차로,2023.6.8 06:00,320,171,22,513,0
안락→연산교차로,2023.6.8 06:00,507,0,86,593,0
연산터널→연산교차로,2023.6.8 06:00,226,235,45,506,0
교대→연산교차로,2023.6.8 07:00,276,0,382,658,0
부산시청→연산교차로,2023.6.8 07:00,527,352,209,1088,0
사직운동장→연산교차로,2023.6.8 07:00,256,459,59,774,0
신리→연산교차로,2023.6.8 07:00,441,242,38,721,0
안락→연산교차로,2023.6.8 07:00,589,0,61,650,0
연산터널→연산교차로,2023.6.8 07:00,289,350,43,682,0
교대→연산교차로,2023.6.8 08:00,318,0,478,796,0
부산시청→연산교차로,2023.6.8 08:00,581,438,300,1319,0
사직운동장→연산교차로,2023.6.8 08:00,303,672,85,1060,0
신리→연산교차로,2023.6.8 08:00,529,353,29,911,0
안락→연산교차로,2023.6.8 08:00,585,0,74,659,0
연산터널→연산교차로,2023.6.8 08:00,326,347,30,703,0
교대→연산교차로,2023.6.8 09:00,290,0,509,799,0
부산시청→연산교차로,2023.6.8 09:00,530,382,287,1199,0
사직운동장→연산교차로,2023.6.8 09:00,340,580,81,1001,0
신리→연산교차로,2023.6.8 09:00,486,333,38,857,0
안락→연산교차로,2023.6.8 09:00,592,0,102,694,0
연산터널→연산교차로,2023.6.8 09:00,300,376,39,715,0
교대→연산교차로,2023.6.8 10:00,299,0,472,771,0
부산시청→연산교차로,2023.6.8 10:00,551,356,255,1162,0
사직운동장→연산교차로,2023.6.8 10:00,329,567,82,978,0
신리→연산교차로,2023.6.8 10:00,492,281,56,829,0
안락→연산교차로,2023.6.8 10:00,589,0,130,719,0
연산터널→연산교차로,2023.6.8 10:00,301,344,38,683,0
교대→연산교차로,2023.6.8 11:00,305,0,405,710,0
부산시청→연산교차로,2023.6.8 11:00,571,375,285,1231,0
사직운동장→연산교차로,2023.6.8 11:00,342,612,88,1042,0
신리→연산교차로,2023.6.8 11:00,421,264,66,751,0
안락→연산교차로,2023.6.8 11:00,525,0,130,655,0
연산터널→연산교차로,2023.6.8 11:00,283,276,37,596,0
교대→연산교차로,2023.6.8 12:00,295,0,370,665,0
부산시청→연산교차로,2023.6.8 12:00,523,347,257,1127,0
사직운동장→연산교차로,2023.6.8 12:00,256,553,73,882,0
신리→연산교차로,2023.6.8 12:00,409,222,42,673,0
안락→연산교차로,2023.6.8 12:00,535,0,118,653,0
연산터널→연산교차로,2023.6.8 12:00,271,277,53,601,0
교대→연산교차로,2023.6.8 13:00,330,0,454,784,0
부산시청→연산교차로,2023.6.8 13:00,581,414,257,1252,0
사직운동장→연산교차로,2023.6.8 13:00,297,583,88,968,0
신리→연산교차로,2023.6.8 13:00,415,282,39,736,0
안락→연산교차로,2023.6.8 13:00,422,0,112,534,0
연산터널→연산교차로,2023.6.8 13:00,236,269,40,545,0
교대→연산교차로,2023.6.8 14:00,343,0,451,794,0
부산시청→연산교차로,2023.6.8 14:00,555,451,292,1298,0
사직운동장→연산교차로,2023.6.8 14:00,338,633,87,1058,0
신리→연산교차로,2023.6.8 14:00,459,249,47,755,0
안락→연산교차로,2023.6.8 14:00,444,0,111,555,0
연산터널→연산교차로,2023.6.8 14:00,225,297,39,561,0
교대→연산교차로,2023.6.8 15:00,339,0,501,840,0
부산시청→연산교차로,2023.6.8 15:00,601,475,305,1381,0
사직운동장→연산교차로,2023.6.8 15:00,335,622,80,1037,0
신리→연산교차로,2023.6.8 15:00,447,264,56,767,0
안락→연산교차로,2023.6.8 15:00,435,0,87,522,0
연산터널→연산교차로,2023.6.8 15:00,236,280,45,561,0
교대→연산교차로,2023.6.8 16:00,366,0,518,884,0
부산시청→연산교차로,2023.6.8 16:00,596,517,328,1441,0
사직운동장→연산교차로,2023.6.8 16:00,369,681,59,1109,0
신리→연산교차로,2023.6.8 16:00,514,282,60,856,0
안락→연산교차로,2023.6.8 16:00,458,0,77,535,0
연산터널→연산교차로,2023.6.8 16:00,239,279,39,557,0
교대→연산교차로,2023.6.8 17:00,383,0,546,929,0
부산시청→연산교차로,2023.6.8 17:00,603,561,286,1450,0
사직운동장→연산교차로,2023.6.8 17:00,298,698,49,1045,0
신리→연산교차로,2023.6.8 17:00,505,311,45,861,0
안락→연산교차로,2023.6.8 17:00,451,0,105,556,0
연산터널→연산교차로,2023.6.8 17:00,260,280,28,568,0
교대→연산교차로,2023.6.8 18:00,369,0,569,938,0
부산시청→연산교차로,2023.6.8 18:00,577,556,351,1484,0
사직운동장→연산교차로,2023.6.8 18:00,280,686,52,1018,0
신리→연산교차로,2023.6.8 18:00,491,278,44,813,0
안락→연산교차로,2023.6.8 18:00,475,0,103,578,0
연산터널→연산교차로,2023.6.8 18:00,236,279,46,561,0
교대→연산교차로,2023.6.8 19:00,304,0,407,711,0
부산시청→연산교차로,2023.6.8 19:00,572,403,255,1230,0
사직운동장→연산교차로,2023.6.8 19:00,184,524,72,780,0
신리→연산교차로,2023.6.8 19:00,366,223,42,631,0
안락→연산교차로,2023.6.8 19:00,442,0,91,533,0
연산터널→연산교차로,2023.6.8 19:00,184,240,69,493,0
교대→연산교차로,2023.6.8 20:00,309,0,311,620,0
부산시청→연산교차로,2023.6.8 20:00,467,367,236,1070,0
사직운동장→연산교차로,2023.6.8 20:00,155,469,80,704,0
신리→연산교차로,2023.6.8 20:00,301,171,35,507,0
안락→연산교차로,2023.6.8 20:00,374,0,100,474,0
연산터널→연산교차로,2023.6.8 20:00,210,277,57,544,0
교대→연산교차로,2023.6.8 21:00,285,0,324,609,0
부산시청→연산교차로,2023.6.8 21:00,479,316,230,1025,0
사직운동장→연산교차로,2023.6.8 21:00,163,454,88,705,0
신리→연산교차로,2023.6.8 21:00,308,193,33,534,0
안락→연산교차로,2023.6.8 21:00,416,0,124,540,0
연산터널→연산교차로,2023.6.8 21:00,249,258,45,552,0
교대→연산교차로,2023.6.8 22:00,229,0,248,477,0
부산시청→연산교차로,2023.6.8 22:00,451,271,160,882,0
사직운동장→연산교차로,2023.6.8 22:00,177,414,65,656,0
신리→연산교차로,2023.6.8 22:00,251,171,27,449,0
안락→연산교차로,2023.6.8 22:00,374,0,103,477,0
연산터널→연산교차로,2023.6.8 22:00,224,218,66,508,0
교대→연산교차로,2023.6.8 23:00,181,0,180,361,0
부산시청→연산교차로,2023.6.8 23:00,365,208,124,697,0
사직운동장→연산교차로,2023.6.8 23:00,185,338,70,593,0
신리→연산교차로,2023.6.8 23:00,188,115,30,333,0
안락→연산교차로,2023.6.8 23:00,296,0,79,375,0
연산터널→연산교차로,2023.6.8 23:00,163,186,45,394,0
교대→연산교차로,2023.6.9 00:00,145,0,146,291,0
부산시청→연산교차로,2023.6.9 00:00,275,149,103,527,0
사직운동장→연산교차로,2023.6.9 00:00,83,216,53,352,0
신리→연산교차로,2023.6.9 00:00,170,117,15,302,0
안락→연산교차로,2023.6.9 00:00,230,0,51,281,0
연산터널→연산교차로,2023.6.9 00:00,133,182,58,373,0
교대→연산교차로,2023.6.9 01:00,103,0,141,244,0
부산시청→연산교차로,2023.6.9 01:00,216,109,95,420,0
사직운동장→연산교차로,2023.6.9 01:00,67,187,48,302,0
신리→연산교차로,2023.6.9 01:00,132,60,20,212,0
안락→연산교차로,2023.6.9 01:00,171,0,57,228,0
연산터널→연산교차로,2023.6.9 01:00,128,163,50,341,0
교대→연산교차로,2023.6.9 02:00,82,0,103,185,0
부산시청→연산교차로,2023.6.9 02:00,178,76,65,319,0
사직운동장→연산교차로,2023.6.9 02:00,60,158,27,245,0
신리→연산교차로,2023.6.9 02:00,92,50,20,162,0
안락→연산교차로,2023.6.9 02:00,122,0,43,165,0
연산터널→연산교차로,2023.6.9 02:00,103,102,41,246,0
교대→연산교차로,2023.6.9 03:00,71,0,71,142,0
부산시청→연산교차로,2023.6.9 03:00,156,69,52,277,0
사직운동장→연산교차로,2023.6.9 03:00,41,120,29,190,0
신리→연산교차로,2023.6.9 03:00,77,52,13,142,0
안락→연산교차로,2023.6.9 03:00,99,0,29,128,0
연산터널→연산교차로,2023.6.9 03:00,72,102,42,216,0
교대→연산교차로,2023.6.9 04:00,56,0,77,133,0
부산시청→연산교차로,2023.6.9 04:00,155,63,56,274,0
사직운동장→연산교차로,2023.6.9 04:00,43,112,33,188,0
신리→연산교차로,2023.6.9 04:00,101,46,5,152,0
안락→연산교차로,2023.6.9 04:00,184,0,35,219,0
연산터널→연산교차로,2023.6.9 04:00,71,102,19,192,0
교대→연산교차로,2023.6.9 05:00,78,0,139,217,0
부산시청→연산교차로,2023.6.9 05:00,267,155,75,497,0
사직운동장→연산교차로,2023.6.9 05:00,57,188,43,288,0
신리→연산교차로,2023.6.9 05:00,221,80,11,312,0
안락→연산교차로,2023.6.9 05:00,330,0,65,395,0
연산터널→연산교차로,2023.6.9 05:00,128,161,34,323,0
교대→연산교차로,2023.6.9 06:00,181,0,254,435,0
부산시청→연산교차로,2023.6.9 06:00,359,249,128,736,0
사직운동장→연산교차로,2023.6.9 06:00,102,255,39,396,0
신리→연산교차로,2023.6.9 06:00,342,164,27,533,0
안락→연산교차로,2023.6.9 06:00,528,0,74,602,0
연산터널→연산교차로,2023.6.9 06:00,218,245,35,498,0
교대→연산교차로,2023.6.9 07:00,288,0,396,684,0
부산시청→연산교차로,2023.6.9 07:00,556,372,207,1135,0
사직운동장→연산교차로,2023.6.9 07:00,203,454,50,707,0
신리→연산교차로,2023.6.9 07:00,452,244,28,724,0
안락→연산교차로,2023.6.9 07:00,641,0,59,700,0
연산터널→연산교차로,2023.6.9 07:00,278,366,44,688,0
교대→연산교차로,2023.6.9 08:00,321,0,454,775,0
부산시청→연산교차로,2023.6.9 08:00,564,403,342,1309,0
사직운동장→연산교차로,2023.6.9 08:00,262,640,46,948,0
신리→연산교차로,2023.6.9 08:00,539,337,42,918,0
안락→연산교차로,2023.6.9 08:00,617,0,88,705,0
연산터널→연산교차로,2023.6.9 08:00,303,364,47,714,0
교대→연산교차로,2023.6.9 09:00,302,0,452,754,0
부산시청→연산교차로,2023.6.9 09:00,523,336,260,1119,0
사직운동장→연산교차로,2023.6.9 09:00,228,560,82,870,0
신리→연산교차로,2023.6.9 09:00,468,334,46,848,0
안락→연산교차로,2023.6.9 09:00,602,0,102,704,0
연산터널→연산교차로,2023.6.9 09:00,303,348,48,699,0
교대→연산교차로,2023.6.9 10:00,310,0,450,760,0
부산시청→연산교차로,2023.6.9 10:00,567,359,282,1208,0
사직운동장→연산교차로,2023.6.9 10:00,315,584,64,963,0
신리→연산교차로,2023.6.9 10:00,484,277,55,816,0
안락→연산교차로,2023.6.9 10:00,570,0,146,716,0
연산터널→연산교차로,2023.6.9 10:00,281,349,60,690,0
교대→연산교차로,2023.6.9 11:00,313,0,482,795,0
부산시청→연산교차로,2023.6.9 11:00,542,379,260,1181,0
사직운동장→연산교차로,2023.6.9 11:00,316,555,77,948,0
신리→연산교차로,2023.6.9 11:00,445,269,63,777,0
안락→연산교차로,2023.6.9 11:00,572,0,140,712,0
연산터널→연산교차로,2023.6.9 11:00,264,285,48,597,0
교대→연산교차로,2023.6.9 12:00,297,0,413,710,0
부산시청→연산교차로,2023.6.9 12:00,576,351,228,1155,0
사직운동장→연산교차로,2023.6.9 12:00,271,567,77,915,0
신리→연산교차로,2023.6.9 12:00,441,243,49,733,0
안락→연산교차로,2023.6.9 12:00,504,0,135,639,0
연산터널→연산교차로,2023.6.9 12:00,266,307,57,630,0
교대→연산교차로,2023.6.9 13:00,333,0,442,775,0
부산시청→연산교차로,2023.6.9 13:00,590,442,258,1290,0
사직운동장→연산교차로,2023.6.9 13:00,303,595,94,992,0
신리→연산교차로,2023.6.9 13:00,409,271,51,731,0
안락→연산교차로,2023.6.9 13:00,425,0,132,557,0
연산터널→연산교차로,2023.6.9 13:00,239,285,48,572,0
교대→연산교차로,2023.6.9 14:00,354,0,440,794,0
부산시청→연산교차로,2023.6.9 14:00,629,443,281,1353,0
사직운동장→연산교차로,2023.6.9 14:00,311,674,80,1065,0
신리→연산교차로,2023.6.9 14:00,479,274,51,804,0
안락→연산교차로,2023.6.9 14:00,459,0,128,587,0
연산터널→연산교차로,2023.6.9 14:00,254,267,48,569,0
교대→연산교차로,2023.6.9 15:00,369,0,497,866,0
부산시청→연산교차로,2023.6.9 15:00,621,489,276,1386,0
사직운동장→연산교차로,2023.6.9 15:00,360,637,76,1073,0
신리→연산교차로,2023.6.9 15:00,515,277,64,856,0
안락→연산교차로,2023.6.9 15:00,425,0,114,539,0
연산터널→연산교차로,2023.6.9 15:00,255,268,34,557,0
교대→연산교차로,2023.6.9 16:00,374,0,438,812,0
부산시청→연산교차로,2023.6.9 16:00,581,491,329,1401,0
사직운동장→연산교차로,2023.6.9 16:00,335,649,48,1032,0
신리→연산교차로,2023.6.9 16:00,470,325,45,840,0
안락→연산교차로,2023.6.9 16:00,414,0,102,516,0
연산터널→연산교차로,2023.6.9 16:00,249,255,41,545,0
교대→연산교차로,2023.6.9 17:00,379,0,536,915,0
부산시청→연산교차로,2023.6.9 17:00,569,532,264,1365,0
사직운동장→연산교차로,2023.6.9 17:00,305,672,71,1048,0
신리→연산교차로,2023.6.9 17:00,502,321,32,855,0
안락→연산교차로,2023.6.9 17:00,467,0,101,568,0
연산터널→연산교차로,2023.6.9 17:00,244,263,46,553,0
교대→연산교차로,2023.6.9 18:00,369,0,590,959,0
부산시청→연산교차로,2023.6.9 18:00,594,546,330,1470,0
사직운동장→연산교차로,2023.6.9 18:00,231,635,73,939,0
신리→연산교차로,2023.6.9 18:00,512,303,43,858,0
안락→연산교차로,2023.6.9 18:00,506,0,91,597,0
연산터널→연산교차로,2023.6.9 18:00,234,258,49,541,0
교대→연산교차로,2023.6.9 19:00,335,0,472,807,0
부산시청→연산교차로,2023.6.9 19:00,561,419,267,1247,0
사직운동장→연산교차로,2023.6.9 19:00,211,584,85,880,0
신리→연산교차로,2023.6.9 19:00,439,280,30,749,0
안락→연산교차로,2023.6.9 19:00,445,0,95,540,0
연산터널→연산교차로,2023.6.9 19:00,213,259,60,532,0
교대→연산교차로,2023.6.9 20:00,335,0,428,763,0
부산시청→연산교차로,2023.6.9 20:00,475,352,264,1091,0
사직운동장→연산교차로,2023.6.9 20:00,221,558,85,864,0
신리→연산교차로,2023.6.9 20:00,331,183,39,553,0
안락→연산교차로,2023.6.9 20:00,445,0,86,531,0
연산터널→연산교차로,2023.6.9 20:00,219,281,48,548,0
교대→연산교차로,2023.6.9 21:00,310,0,371,681,0
부산시청→연산교차로,2023.6.9 21:00,493,348,235,1076,0
사직운동장→연산교차로,2023.6.9 21:00,209,490,96,795,0
신리→연산교차로,2023.6.9 21:00,337,176,34,547,0
안락→연산교차로,2023.6.9 21:00,425,0,128,553,0
연산터널→연산교차로,2023.6.9 21:00,228,274,58,560,0
교대→연산교차로,2023.6.9 22:00,290,0,292,582,0
부산시청→연산교차로,2023.6.9 22:00,435,273,177,885,0
사직운동장→연산교차로,2023.6.9 22:00,272,478,44,794,0
신리→연산교차로,2023.6.9 22:00,297,196,35,528,0
안락→연산교차로,2023.6.9 22:00,393,0,146,539,0
연산터널→연산교차로,2023.6.9 22:00,250,251,54,555,0
교대→연산교차로,2023.6.9 23:00,276,0,223,499,0
부산시청→연산교차로,2023.6.9 23:00,421,237,147,805,0
사직운동장→연산교차로,2023.6.9 23:00,293,479,36,808,0
신리→연산교차로,2023.6.9 23:00,252,165,28,445,0
안락→연산교차로,2023.6.9 23:00,305,0,89,394,0
연산터널→연산교차로,2023.6.9 23:00,180,221,47,448,0
교대→연산교차로,2023.6.10 00:00,203,0,238,441,0
부산시청→연산교차로,2023.6.10 00:00,300,219,133,652,0
사직운동장→연산교차로,2023.6.10 00:00,105,318,90,513,0
신리→연산교차로,2023.6.10 00:00,221,144,31,396,0
안락→연산교차로,2023.6.10 00:00,252,0,90,342,0
연산터널→연산교차로,2023.6.10 00:00,199,213,64,476,0
교대→연산교차로,2023.6.10 01:00,158,0,186,344,0
부산시청→연산교차로,2023.6.10 01:00,273,152,118,543,0
사직운동장→연산교차로,2023.6.10 01:00,88,227,68,383,0
신리→연산교차로,2023.6.10 01:00,149,100,16,265,0
안락→연산교차로,2023.6.10 01:00,248,0,68,316,0
연산터널→연산교차로,2023.6.10 01:00,150,194,77,421,0
교대→연산교차로,2023.6.10 02:00,101,0,109,210,0
부산시청→연산교차로,2023.6.10 02:00,229,118,80,427,0
사직운동장→연산교차로,2023.6.10 02:00,86,209,57,352,0
신리→연산교차로,2023.6.10 02:00,121,73,14,208,0
안락→연산교차로,2023.6.10 02:00,184,0,45,229,0
연산터널→연산교차로,2023.6.10 02:00,121,166,41,328,0
교대→연산교차로,2023.6.10 03:00,110,0,114,224,0
부산시청→연산교차로,2023.6.10 03:00,205,94,58,357,0
사직운동장→연산교차로,2023.6.10 03:00,55,178,43,276,0
신리→연산교차로,2023.6.10 03:00,110,54,11,175,0
안락→연산교차로,2023.6.10 03:00,157,0,43,200,0
연산터널→연산교차로,2023.6.10 03:00,93,136,45,274,0
교대→연산교차로,2023.6.10 04:00,88,0,111,199,0
부산시청→연산교차로,2023.6.10 04:00,196,97,66,359,0
사직운동장→연산교차로,2023.6.10 04:00,49,144,44,237,0
신리→연산교차로,2023.6.10 04:00,100,53,7,160,0
안락→연산교차로,2023.6.10 04:00,212,0,47,259,0
연산터널→연산교차로,2023.6.10 04:00,105,123,39,267,0
교대→연산교차로,2023.6.10 05:00,121,0,161,282,0
부산시청→연산교차로,2023.6.10 05:00,243,163,79,485,0
사직운동장→연산교차로,2023.6.10 05:00,74,185,43,302,0
신리→연산교차로,2023.6.10 05:00,210,100,11,321,0
안락→연산교차로,2023.6.10 05:00,327,0,70,397,0
연산터널→연산교차로,2023.6.10 05:00,141,169,22,332,0
교대→연산교차로,2023.6.10 06:00,171,0,209,380,0
부산시청→연산교차로,2023.6.10 06:00,354,228,97,679,0
사직운동장→연산교차로,2023.6.10 06:00,100,251,61,412,0
신리→연산교차로,2023.6.10 06:00,283,125,15,423,0
안락→연산교차로,2023.6.10 06:00,386,0,87,473,0
연산터널→연산교차로,2023.6.10 06:00,183,199,33,415,0
교대→연산교차로,2023.6.10 07:00,193,0,228,421,0
부산시청→연산교차로,2023.6.10 07:00,365,264,136,765,0
사직운동장→연산교차로,2023.6.10 07:00,134,323,49,506,0
신리→연산교차로,2023.6.10 07:00,317,163,30,510,0
안락→연산교차로,2023.6.10 07:00,473,0,86,559,0
연산터널→연산교차로,2023.6.10 07:00,208,213,49,470,0
교대→연산교차로,2023.6.10 08:00,308,0,388,696,0
부산시청→연산교차로,2023.6.10 08:00,493,376,284,1153,0
사직운동장→연산교차로,2023.6.10 08:00,278,531,68,877,0
신리→연산교차로,2023.6.10 08:00,463,264,50,777,0
안락→연산교차로,2023.6.10 08:00,595,0,100,695,0
연산터널→연산교차로,2023.6.10 08:00,305,330,48,683,0
교대→연산교차로,2023.6.10 09:00,275,0,415,690,0
부산시청→연산교차로,2023.6.10 09:00,579,389,291,1259,0
사직운동장→연산교차로,2023.6.10 09:00,289,625,59,973,0
신리→연산교차로,2023.6.10 09:00,460,307,78,845,0
안락→연산교차로,2023.6.10 09:00,612,0,109,721,0
연산터널→연산교차로,2023.6.10 09:00,297,320,45,662,0
교대→연산교차로,2023.6.10 10:00,290,0,471,761,0
부산시청→연산교차로,2023.6.10 10:00,569,351,287,1207,0
사직운동장→연산교차로,2023.6.10 10:00,328,604,68,1000,0
신리→연산교차로,2023.6.10 10:00,504,312,63,879,0
안락→연산교차로,2023.6.10 10:00,581,0,159,740,0
연산터널→연산교차로,2023.6.10 10:00,290,341,59,690,0
교대→연산교차로,2023.6.10 11:00,301,0,482,783,0
부산시청→연산교차로,2023.6.10 11:00,622,395,308,1325,0
사직운동장→연산교차로,2023.6.10 11:00,374,583,74,1031,0
신리→연산교차로,2023.6.10 11:00,524,283,70,877,0
안락→연산교차로,2023.6.10 11:00,594,0,153,747,0
연산터널→연산교차로,2023.6.10 11:00,300,339,62,701,0
교대→연산교차로,2023.6.10 12:00,318,0,485,803,0
부산시청→연산교차로,2023.6.10 12:00,615,387,251,1253,0
사직운동장→연산교차로,2023.6.10 12:00,309,609,50,968,0
신리→연산교차로,2023.6.10 12:00,523,315,60,898,0
안락→연산교차로,2023.6.10 12:00,588,0,155,743,0
연산터널→연산교차로,2023.6.10 12:00,333,294,50,677,0
교대→연산교차로,2023.6.10 13:00,378,0,488,866,0
부산시청→연산교차로,2023.6.10 13:00,632,479,325,1436,0
사직운동장→연산교차로,2023.6.10 13:00,310,638,65,1013,0
신리→연산교차로,2023.6.10 13:00,478,286,66,830,0
안락→연산교차로,2023.6.10 13:00,490,0,102,592,0
연산터널→연산교차로,2023.6.10 13:00,273,253,35,561,0
교대→연산교차로,2023.6.10 14:00,346,0,471,817,0
부산시청→연산교차로,2023.6.10 14:00,585,427,285,1297,0
사직운동장→연산교차로,2023.6.10 14:00,285,638,75,998,0
신리→연산교차로,2023.6.10 14:00,457,259,64,780,0
안락→연산교차로,2023.6.10 14:00,476,0,85,561,0
연산터널→연산교차로,2023.6.10 14:00,223,287,56,566,0
교대→연산교차로,2023.6.10 15:00,369,0,505,874,0
부산시청→연산교차로,2023.6.10 15:00,623,471,289,1383,0
사직운동장→연산교차로,2023.6.10 15:00,264,648,53,965,0
신리→연산교차로,2023.6.10 15:00,446,254,80,780,0
안락→연산교차로,2023.6.10 15:00,441,0,120,561,0
연산터널→연산교차로,2023.6.10 15:00,225,262,54,541,0
교대→연산교차로,2023.6.10 16:00,344,0,395,739,0
부산시청→연산교차로,2023.6.10 16:00,630,496,275,1401,0
사직운동장→연산교차로,2023.6.10 16:00,346,660,47,1053,0
신리→연산교차로,2023.6.10 16:00,457,232,44,733,0
안락→연산교차로,2023.6.10 16:00,448,0,93,541,0
연산터널→연산교차로,2023.6.10 16:00,217,298,53,568,0
교대→연산교차로,2023.6.10 17:00,333,0,391,724,0
부산시청→연산교차로,2023.6.10 17:00,625,486,275,1386,0
사직운동장→연산교차로,2023.6.10 17:00,268,604,77,949,0
신리→연산교차로,2023.6.10 17:00,413,217,42,672,0
안락→연산교차로,2023.6.10 17:00,472,0,90,562,0
연산터널→연산교차로,2023.6.10 17:00,214,267,51,532,0
교대→연산교차로,2023.6.10 18:00,356,0,423,779,0
부산시청→연산교차로,2023.6.10 18:00,521,410,253,1184,0
사직운동장→연산교차로,2023.6.10 18:00,255,628,61,944,0
신리→연산교차로,2023.6.10 18:00,409,222,45,676,0
안락→연산교차로,2023.6.10 18:00,451,0,103,554,0
연산터널→연산교차로,2023.6.10 18:00,218,267,59,544,0
교대→연산교차로,2023.6.10 19:00,307,0,347,654,0
부산시청→연산교차로,2023.6.10 19:00,511,376,222,1109,0
사직운동장→연산교차로,2023.6.10 19:00,191,472,66,729,0
신리→연산교차로,2023.6.10 19:00,335,196,40,571,0
안락→연산교차로,2023.6.10 19:00,448,0,108,556,0
연산터널→연산교차로,2023.6.10 19:00,218,266,66,550,0
교대→연산교차로,2023.6.10 20:00,305,0,286,591,0
부산시청→연산교차로,2023.6.10 20:00,470,337,237,1044,0
사직운동장→연산교차로,2023.6.10 20:00,182,460,88,730,0
신리→연산교차로,2023.6.10 20:00,330,167,33,530,0
안락→연산교차로,2023.6.10 20:00,405,0,118,523,0
연산터널→연산교차로,2023.6.10 20:00,214,280,59,553,0
교대→연산교차로,2023.6.10 21:00,287,0,315,602,0
부산시청→연산교차로,2023.6.10 21:00,474,333,224,1031,0
사직운동장→연산교차로,2023.6.10 21:00,171,405,80,656,0
신리→연산교차로,2023.6.10 21:00,360,209,33,602,0
안락→연산교차로,2023.6.10 21:00,435,0,128,563,0
연산터널→연산교차로,2023.6.10 21:00,239,275,65,579,0
교대→연산교차로,2023.6.10 22:00,242,0,296,538,0
부산시청→연산교차로,2023.6.10 22:00,398,268,165,831,0
사직운동장→연산교차로,2023.6.10 22:00,142,360,91,593,0
신리→연산교차로,2023.6.10 22:00,307,150,26,483,0
안락→연산교차로,2023.6.10 22:00,391,0,108,499,0
연산터널→연산교차로,2023.6.10 22:00,207,225,72,504,0
교대→연산교차로,2023.6.10 23:00,205,0,262,467,0
부산시청→연산교차로,2023.6.10 23:00,368,227,144,739,0
사직운동장→연산교차로,2023.6.10 23:00,109,316,110,535,0
신리→연산교차로,2023.6.10 23:00,267,145,29,441,0
안락→연산교차로,2023.6.10 23:00,334,0,90,424,0
연산터널→연산교차로,2023.6.10 23:00,208,230,60,498,0
교대→연산교차로,2023.6.11 00:00,201,0,236,437,1
부산시청→연산교차로,2023.6.11 00:00,303,206,131,640,1
사직운동장→연산교차로,2023.6.11 00:00,102,251,78,431,1
신리→연산교차로,2023.6.11 00:00,218,106,30,354,1
안락→연산교차로,2023.6.11 00:00,272,0,72,344,1
연산터널→연산교차로,2023.6.11 00:00,190,197,53,440,1
교대→연산교차로,2023.6.11 01:00,167,0,205,372,1
부산시청→연산교차로,2023.6.11 01:00,289,173,122,584,1
사직운동장→연산교차로,2023.6.11 01:00,81,223,62,366,1
신리→연산교차로,2023.6.11 01:00,181,102,16,299,1
안락→연산교차로,2023.6.11 01:00,214,0,40,254,1
연산터널→연산교차로,2023.6.11 01:00,126,152,44,322,1
교대→연산교차로,2023.6.11 02:00,115,0,190,305,1
부산시청→연산교차로,2023.6.11 02:00,243,146,79,468,1
사직운동장→연산교차로,2023.6.11 02:00,62,196,60,318,1
신리→연산교차로,2023.6.11 02:00,137,79,16,232,1
안락→연산교차로,2023.6.11 02:00,183,0,42,225,1
연산터널→연산교차로,2023.6.11 02:00,137,166,43,346,1
교대→연산교차로,2023.6.11 03:00,93,0,138,231,1
부산시청→연산교차로,2023.6.11 03:00,203,93,67,363,1
사직운동장→연산교차로,2023.6.11 03:00,50,149,46,245,1
신리→연산교차로,2023.6.11 03:00,95,55,11,161,1
안락→연산교차로,2023.6.11 03:00,142,0,34,176,1
연산터널→연산교차로,2023.6.11 03:00,104,128,45,277,1
교대→연산교차로,2023.6.11 04:00,76,0,91,167,1
부산시청→연산교차로,2023.6.11 04:00,161,93,63,317,1
사직운동장→연산교차로,2023.6.11 04:00,50,125,37,212,1
신리→연산교차로,2023.6.11 04:00,84,60,10,154,1
안락→연산교차로,2023.6.11 04:00,144,0,44,188,1
연산터널→연산교차로,2023.6.11 04:00,108,107,23,238,1
교대→연산교차로,2023.6.11 05:00,55,0,104,159,1
부산시청→연산교차로,2023.6.11 05:00,171,93,56,320,1
사직운동장→연산교차로,2023.6.11 05:00,53,116,31,200,1
신리→연산교차로,2023.6.11 05:00,141,56,9,206,1
안락→연산교차로,2023.6.11 05:00,157,0,41,198,1
연산터널→연산교차로,2023.6.11 05:00,93,117,28,238,1
교대→연산교차로,2023.6.11 06:00,97,0,123,220,1
부산시청→연산교차로,2023.6.11 06:00,192,146,71,409,1
사직운동장→연산교차로,2023.6.11 06:00,60,158,40,258,1
신리→연산교차로,2023.6.11 06:00,181,66,6,253,1
안락→연산교차로,2023.6.11 06:00,236,0,48,284,1
연산터널→연산교차로,2023.6.11 06:00,117,106,29,252,1
교대→연산교차로,2023.6.11 07:00,127,0,157,284,1
부산시청→연산교차로,2023.6.11 07:00,230,166,73,469,1
사직운동장→연산교차로,2023.6.11 07:00,64,195,39,298,1
신리→연산교차로,2023.6.11 07:00,185,82,10,277,1
안락→연산교차로,2023.6.11 07:00,255,0,55,310,1
연산터널→연산교차로,2023.6.11 07:00,133,137,30,300,1
교대→연산교차로,2023.6.11 08:00,190,0,163,353,1
부산시청→연산교차로,2023.6.11 08:00,245,220,104,569,1
사직운동장→연산교차로,2023.6.11 08:00,108,276,42,426,1
신리→연산교차로,2023.6.11 08:00,259,137,13,409,1
안락→연산교차로,2023.6.11 08:00,358,0,70,428,1
연산터널→연산교차로,2023.6.11 08:00,166,131,44,341,1
교대→연산교차로,2023.6.11 09:00,199,0,233,432,1
부산시청→연산교차로,2023.6.11 09:00,398,282,147,827,1
사직운동장→연산교차로,2023.6.11 09:00,141,370,37,548,1
신리→연산교차로,2023.6.11 09:00,381,224,12,617,1
안락→연산교차로,2023.6.11 09:00,406,0,97,503,1
연산터널→연산교차로,2023.6.11 09:00,258,212,29,499,1
교대→연산교차로,2023.6.11 10:00,274,0,298,572,1
부산시청→연산교차로,2023.6.11 10:00,454,316,154,924,1
사직운동장→연산교차로,2023.6.11 10:00,187,525,37,749,1
신리→연산교차로,2023.6.11 10:00,407,204,31,642,1
안락→연산교차로,2023.6.11 10:00,508,0,96,604,1
연산터널→연산교차로,2023.6.11 10:00,246,259,38,543,1
교대→연산교차로,2023.6.11 11:00,255,0,368,623,1
부산시청→연산교차로,2023.6.11 11:00,403,325,197,925,1
사직운동장→연산교차로,2023.6.11 11:00,194,483,50,727,1
신리→연산교차로,2023.6.11 11:00,444,185,22,651,1
안락→연산교차로,2023.6.11 11:00,493,0,127,620,1
연산터널→연산교차로,2023.6.11 11:00,258,232,47,537,1
교대→연산교차로,2023.6.11 12:00,285,0,372,657,1
부산시청→연산교차로,2023.6.11 12:00,479,358,192,1029,1
사직운동장→연산교차로,2023.6.11 12:00,191,535,50,776,1
신리→연산교차로,2023.6.11 12:00,412,194,46,652,1
안락→연산교차로,2023.6.11 12:00,544,0,113,657,1
연산터널→연산교차로,2023.6.11 12:00,269,258,37,564,1
교대→연산교차로,2023.6.11 13:00,312,0,380,692,1
부산시청→연산교차로,2023.6.11 13:00,512,364,202,1078,1
사직운동장→연산교차로,2023.6.11 13:00,229,524,53,806,1
신리→연산교차로,2023.6.11 13:00,379,217,25,621,1
안락→연산교차로,2023.6.11 13:00,550,0,119,669,1
연산터널→연산교차로,2023.6.11 13:00,279,260,46,585,1
교대→연산교차로,2023.6.11 14:00,306,0,328,634,1
부산시청→연산교차로,2023.6.11 14:00,527,368,209,1104,1
사직운동장→연산교차로,2023.6.11 14:00,201,521,59,781,1
신리→연산교차로,2023.6.11 14:00,386,202,41,629,1
안락→연산교차로,2023.6.11 14:00,495,0,124,619,1
연산터널→연산교차로,2023.6.11 14:00,248,236,50,534,1
교대→연산교차로,2023.6.11 15:00,291,0,357,648,1
부산시청→연산교차로,2023.6.11 15:00,510,359,205,1074,1
사직운동장→연산교차로,2023.6.11 15:00,229,536,61,826,1
신리→연산교차로,2023.6.11 15:00,423,207,40,670,1
안락→연산교차로,2023.6.11 15:00,501,0,111,612,1
연산터널→연산교차로,2023.6.11 15:00,223,237,44,504,1
교대→연산교차로,2023.6.11 16:00,306,0,318,624,1
부산시청→연산교차로,2023.6.11 16:00,504,311,218,1033,1
사직운동장→연산교차로,2023.6.11 16:00,212,503,48,763,1
신리→연산교차로,2023.6.11 16:00,403,191,30,624,1
안락→연산교차로,2023.6.11 16:00,519,0,117,636,1
연산터널→연산교차로,2023.6.11 16:00,240,260,53,553,1
교대→연산교차로,2023.6.11 17:00,287,0,299,586,1
부산시청→연산교차로,2023.6.11 17:00,487,339,208,1034,1
사직운동장→연산교차로,2023.6.11 17:00,212,505,56,773,1
신리→연산교차로,2023.6.11 17:00,416,182,29,627,1
안락→연산교차로,2023.6.11 17:00,506,0,130,636,1
연산터널→연산교차로,2023.6.11 17:00,247,268,39,554,1
교대→연산교차로,2023.6.11 18:00,298,0,320,618,1
부산시청→연산교차로,2023.6.11 18:00,446,271,205,922,1
사직운동장→연산교차로,2023.6.11 18:00,168,442,61,671,1
신리→연산교차로,2023.6.11 18:00,334,191,31,556,1
안락→연산교차로,2023.6.11 18:00,451,0,107,558,1
연산터널→연산교차로,2023.6.11 18:00,189,225,58,472,1
교대→연산교차로,2023.6.11 19:00,282,0,251,533,1
부산시청→연산교차로,2023.6.11 19:00,421,275,171,867,1
사직운동장→연산교차로,2023.6.11 19:00,130,384,58,572,1
신리→연산교차로,2023.6.11 19:00,307,141,29,477,1
안락→연산교차로,2023.6.11 19:00,390,0,97,487,1
연산터널→연산교차로,2023.6.11 19:00,199,221,50,470,1
교대→연산교차로,2023.6.11 20:00,276,0,225,501,1
부산시청→연산교차로,2023.6.11 20:00,377,264,164,805,1
사직운동장→연산교차로,2023.6.11 20:00,154,365,43,562,1
신리→연산교차로,2023.6.11 20:00,343,154,24,521,1
안락→연산교차로,2023.6.11 20:00,374,0,105,479,1
연산터널→연산교차로,2023.6.11 20:00,201,202,42,445,1
교대→연산교차로,2023.6.11 21:00,253,0,244,497,1
부산시청→연산교차로,2023.6.11 21:00,364,244,152,760,1
사직운동장→연산교차로,2023.6.11 21:00,130,332,59,521,1
신리→연산교차로,2023.6.11 21:00,302,147,29,478,1
안락→연산교차로,2023.6.11 21:00,338,0,81,419,1
연산터널→연산교차로,2023.6.11 21:00,197,202,59,458,1
교대→연산교차로,2023.6.11 22:00,187,0,194,381,1
부산시청→연산교차로,2023.6.11 22:00,341,189,106,636,1
사직운동장→연산교차로,2023.6.11 22:00,93,313,71,477,1
신리→연산교차로,2023.6.11 22:00,237,109,23,369,1
안락→연산교차로,2023.6.11 22:00,255,0,54,309,1
연산터널→연산교차로,2023.6.11 22:00,148,146,48,342,1
교대→연산교차로,2023.6.11 23:00,123,0,151,274,1
부산시청→연산교차로,2023.6.11 23:00,242,143,105,490,1
사직운동장→연산교차로,2023.6.11 23:00,89,230,70,389,1
신리→연산교차로,2023.6.11 23:00,165,90,14,269,1
안락→연산교차로,2023.6.11 23:00,239,0,59,298,1
연산터널→연산교차로,2023.6.11 23:00,131,151,58,340,1
교대→연산교차로,2023.6.12 00:00,100,0,110,210,0
부산시청→연산교차로,2023.6.12 00:00,212,126,89,427,0
사직운동장→연산교차로,2023.6.12 00:00,52,207,46,305,0
신리→연산교차로,2023.6.12 00:00,122,44,12,178,0
안락→연산교차로,2023.6.12 00:00,172,0,41,213,0
연산터널→연산교차로,2023.6.12 00:00,141,137,67,345,0
교대→연산교차로,2023.6.12 01:00,86,0,87,173,0
부산시청→연산교차로,2023.6.12 01:00,154,105,58,317,0
사직운동장→연산교차로,2023.6.12 01:00,42,135,44,221,0
신리→연산교차로,2023.6.12 01:00,79,61,19,159,0
안락→연산교차로,2023.6.12 01:00,124,0,26,150,0
연산터널→연산교차로,2023.6.12 01:00,96,109,57,262,0
교대→연산교차로,2023.6.12 02:00,53,0,59,112,0
부산시청→연산교차로,2023.6.12 02:00,135,66,51,252,0
사직운동장→연산교차로,2023.6.12 02:00,37,118,30,185,0
신리→연산교차로,2023.6.12 02:00,71,36,8,115,0
안락→연산교차로,2023.6.12 02:00,125,0,26,151,0
연산터널→연산교차로,2023.6.12 02:00,86,85,40,211,0
교대→연산교차로,2023.6.12 03:00,52,0,54,106,0
부산시청→연산교차로,2023.6.12 03:00,113,65,41,219,0
사직운동장→연산교차로,2023.6.12 03:00,27,87,34,148,0
신리→연산교차로,2023.6.12 03:00,63,26,9,98,0
안락→연산교차로,2023.6.12 03:00,109,0,17,126,0
연산터널→연산교차로,2023.6.12 03:00,47,88,32,167,0
교대→연산교차로,2023.6.12 04:00,45,0,54,99,0
부산시청→연산교차로,2023.6.12 04:00,136,70,35,241,0
사직운동장→연산교차로,2023.6.12 04:00,28,99,15,142,0
신리→연산교차로,2023.6.12 04:00,88,42,4,134,0
안락→연산교차로,2023.6.12 04:00,185,0,19,204,0
연산터널→연산교차로,2023.6.12 04:00,62,87,17,166,0
교대→연산교차로,2023.6.12 05:00,89,0,155,244,0
부산시청→연산교차로,2023.6.12 05:00,242,161,80,483,0
사직운동장→연산교차로,2023.6.12 05:00,75,143,28,246,0
신리→연산교차로,2023.6.12 05:00,234,81,6,321,0
안락→연산교차로,2023.6.12 05:00,331,0,56,387,0
연산터널→연산교차로,2023.6.12 05:00,134,134,21,289,0
교대→연산교차로,2023.6.12 06:00,172,0,242,414,0
부산시청→연산교차로,2023.6.12 06:00,374,257,159,790,0
사직운동장→연산교차로,2023.6.12 06:00,105,278,57,440,0
신리→연산교차로,2023.6.12 06:00,345,156,23,524,0
안락→연산교차로,2023.6.12 06:00,521,0,81,602,0
연산터널→연산교차로,2023.6.12 06:00,229,248,38,515,0
교대→연산교차로,2023.6.12 07:00,292,0,425,717,0
부산시청→연산교차로,2023.6.12 07:00,565,373,282,1220,0
사직운동장→연산교차로,2023.6.12 07:00,211,468,44,723,0
신리→연산교차로,2023.6.12 07:00,496,262,34,792,0
안락→연산교차로,2023.6.12 07:00,649,0,88,737,0
연산터널→연산교차로,2023.6.12 07:00,294,378,45,717,0
교대→연산교차로,2023.6.12 08:00,326,0,483,809,0
부산시청→연산교차로,2023.6.12 08:00,569,433,408,1410,0
사직운동장→연산교차로,2023.6.12 08:00,287,615,61,963,0
신리→연산교차로,2023.6.12 08:00,531,343,39,913,0
안락→연산교차로,2023.6.12 08:00,619,0,120,739,0
연산터널→연산교차로,2023.6.12 08:00,336,377,34,747,0
교대→연산교차로,2023.6.12 09:00,304,0,510,814,0
부산시청→연산교차로,2023.6.12 09:00,527,376,326,1229,0
사직운동장→연산교차로,2023.6.12 09:00,270,568,86,924,0
신리→연산교차로,2023.6.12 09:00,442,321,56,819,0
안락→연산교차로,2023.6.12 09:00,621,0,102,723,0
연산터널→연산교차로,2023.6.12 09:00,321,369,37,727,0
교대→연산교차로,2023.6.12 10:00,299,0,504,803,0
부산시청→연산교차로,2023.6.12 10:00,519,357,274,1150,0
사직운동장→연산교차로,2023.6.12 10:00,240,566,67,873,0
신리→연산교차로,2023.6.12 10:00,452,283,56,791,0
안락→연산교차로,2023.6.12 10:00,571,0,126,697,0
연산터널→연산교차로,2023.6.12 10:00,299,309,57,665,0
교대→연산교차로,2023.6.12 11:00,296,0,460,756,0
부산시청→연산교차로,2023.6.12 11:00,575,379,267,1221,0
사직운동장→연산교차로,2023.6.12 11:00,300,562,79,941,0
신리→연산교차로,2023.6.12 11:00,481,238,66,785,0
안락→연산교차로,2023.6.12 11:00,524,0,145,669,0
연산터널→연산교차로,2023.6.12 11:00,267,333,62,662,0
교대→연산교차로,2023.6.12 12:00,312,0,425,737,0
부산시청→연산교차로,2023.6.12 12:00,526,353,248,1127,0
사직운동장→연산교차로,2023.6.12 12:00,247,538,77,862,0
신리→연산교차로,2023.6.12 12:00,393,224,48,665,0
안락→연산교차로,2023.6.12 12:00,510,0,143,653,0
연산터널→연산교차로,2023.6.12 12:00,275,273,57,605,0
교대→연산교차로,2023.6.12 13:00,328,0,426,754,0
부산시청→연산교차로,2023.6.12 13:00,561,427,247,1235,0
사직운동장→연산교차로,2023.6.12 13:00,297,572,76,945,0
신리→연산교차로,2023.6.12 13:00,406,256,54,716,0
안락→연산교차로,2023.6.12 13:00,444,0,146,590,0
연산터널→연산교차로,2023.6.12 13:00,227,286,42,555,0
교대→연산교차로,2023.6.12 14:00,349,0,454,803,0
부산시청→연산교차로,2023.6.12 14:00,557,448,297,1302,0
사직운동장→연산교차로,2023.6.12 14:00,279,586,83,948,0
신리→연산교차로,2023.6.12 14:00,430,258,46,734,0
안락→연산교차로,2023.6.12 14:00,435,0,134,569,0
연산터널→연산교차로,2023.6.12 14:00,247,272,48,567,0
교대→연산교차로,2023.6.12 15:00,353,0,522,875,0
부산시청→연산교차로,2023.6.12 15:00,570,464,319,1353,0
사직운동장→연산교차로,2023.6.12 15:00,306,627,106,1039,0
신리→연산교차로,2023.6.12 15:00,446,282,52,780,0
안락→연산교차로,2023.6.12 15:00,439,0,117,556,0
연산터널→연산교차로,2023.6.12 15:00,238,283,49,570,0
교대→연산교차로,2023.6.12 16:00,346,0,497,843,0
부산시청→연산교차로,2023.6.12 16:00,605,516,287,1408,0
사직운동장→연산교차로,2023.6.12 16:00,322,655,68,1045,0
신리→연산교차로,2023.6.12 16:00,532,280,62,874,0
안락→연산교차로,2023.6.12 16:00,455,0,87,542,0
연산터널→연산교차로,2023.6.12 16:00,251,261,42,554,0
교대→연산교차로,2023.6.12 17:00,380,0,540,920,0
부산시청→연산교차로,2023.6.12 17:00,630,547,308,1485,0
사직운동장→연산교차로,2023.6.12 17:00,319,686,56,1061,0
신리→연산교차로,2023.6.12 17:00,529,262,62,853,0
안락→연산교차로,2023.6.12 17:00,461,0,98,559,0
연산터널→연산교차로,2023.6.12 17:00,222,278,52,552,0
교대→연산교차로,2023.6.12 18:00,396,0,570,966,0
부산시청→연산교차로,2023.6.12 18:00,611,567,330,1508,0
사직운동장→연산교차로,2023.6.12 18:00,357,662,52,1071,0
신리→연산교차로,2023.6.12 18:00,506,282,48,836,0
안락→연산교차로,2023.6.12 18:00,463,0,95,558,0
연산터널→연산교차로,2023.6.12 18:00,229,283,49,561,0
교대→연산교차로,2023.6.12 19:00,323,0,373,696,0
부산시청→연산교차로,2023.6.12 19:00,504,381,261,1146,0
사직운동장→연산교차로,2023.6.12 19:00,177,531,79,787,0
신리→연산교차로,2023.6.12 19:00,396,181,37,614,0
안락→연산교차로,2023.6.12 19:00,427,0,102,529,0
연산터널→연산교차로,2023.6.12 19:00,200,230,76,506,0
교대→연산교차로,2023.6.12 20:00,296,0,337,633,0
부산시청→연산교차로,2023.6.12 20:00,477,352,249,1078,0
사직운동장→연산교차로,2023.6.12 20:00,180,485,81,746,0
신리→연산교차로,2023.6.12 20:00,304,183,35,522,0
안락→연산교차로,2023.6.12 20:00,397,0,123,520,0
연산터널→연산교차로,2023.6.12 20:00,206,263,61,530,0
교대→연산교차로,2023.6.12 21:00,277,0,325,602,0
부산시청→연산교차로,2023.6.12 21:00,465,323,232,1020,0
사직운동장→연산교차로,2023.6.12 21:00,188,408,88,684,0
신리→연산교차로,2023.6.12 21:00,295,178,28,501,0
안락→연산교차로,2023.6.12 21:00,393,0,108,501,0
연산터널→연산교차로,2023.6.12 21:00,210,253,65,528,0
교대→연산교차로,2023.6.12 22:00,222,0,239,461,0
부산시청→연산교차로,2023.6.12 22:00,370,248,146,764,0
사직운동장→연산교차로,2023.6.12 22:00,134,366,76,576,0
신리→연산교차로,2023.6.12 22:00,270,150,27,447,0
안락→연산교차로,2023.6.12 22:00,348,0,106,454,0
연산터널→연산교차로,2023.6.12 22:00,207,222,67,496,0
교대→연산교차로,2023.6.12 23:00,175,0,186,361,0
부산시청→연산교차로,2023.6.12 23:00,300,181,128,609,0
사직운동장→연산교차로,2023.6.12 23:00,100,277,74,451,0
신리→연산교차로,2023.6.12 23:00,188,109,21,318,0
안락→연산교차로,2023.6.12 23:00,254,0,62,316,0
연산터널→연산교차로,2023.6.12 23:00,165,192,76,433,0
교대→연산교차로,2023.6.13 00:00,133,0,165,298,0
부산시청→연산교차로,2023.6.13 00:00,225,138,97,460,0
사직운동장→연산교차로,2023.6.13 00:00,71,216,74,361,0
신리→연산교차로,2023.6.13 00:00,152,83,18,253,0
안락→연산교차로,2023.6.13 00:00,179,0,47,226,0
연산터널→연산교차로,2023.6.13 00:00,146,164,57,367,0
교대→연산교차로,2023.6.13 01:00,101,0,105,206,0
부산시청→연산교차로,2023.6.13 01:00,188,105,79,372,0
사직운동장→연산교차로,2023.6.13 01:00,37,153,40,230,0
신리→연산교차로,2023.6.13 01:00,114,58,12,184,0
안락→연산교차로,2023.6.13 01:00,146,0,30,176,0
연산터널→연산교차로,2023.6.13 01:00,99,130,55,284,0
교대→연산교차로,2023.6.13 02:00,65,0,86,151,0
부산시청→연산교차로,2023.6.13 02:00,133,81,70,284,0
사직운동장→연산교차로,2023.6.13 02:00,59,135,33,227,0
신리→연산교차로,2023.6.13 02:00,81,41,9,131,0
안락→연산교차로,2023.6.13 02:00,115,0,33,148,0
연산터널→연산교차로,2023.6.13 02:00,83,119,42,244,0
교대→연산교차로,2023.6.13 03:00,63,0,69,132,0
부산시청→연산교차로,2023.6.13 03:00,134,54,35,223,0
사직운동장→연산교차로,2023.6.13 03:00,27,110,35,172,0
신리→연산교차로,2023.6.13 03:00,78,38,7,123,0
안락→연산교차로,2023.6.13 03:00,115,0,25,140,0
연산터널→연산교차로,2023.6.13 03:00,80,83,58,221,0
교대→연산교차로,2023.6.13 04:00,49,0,72,121,0
부산시청→연산교차로,2023.6.13 04:00,155,84,46,285,0
사직운동장→연산교차로,2023.6.13 04:00,34,106,31,171,0
신리→연산교차로,2023.6.13 04:00,77,50,12,139,0
안락→연산교차로,2023.6.13 04:00,159,0,31,190,0
연산터널→연산교차로,2023.6.13 04:00,92,98,41,231,0
교대→연산교차로,2023.6.13 05:00,99,0,145,244,0
부산시청→연산교차로,2023.6.13 05:00,255,160,84,499,0
사직운동장→연산교차로,2023.6.13 05:00,70,181,35,286,0
신리→연산교차로,2023.6.13 05:00,216,97,17,330,0
안락→연산교차로,2023.6.13 05:00,362,0,58,420,0
연산터널→연산교차로,2023.6.13 05:00,157,141,34,332,0
교대→연산교차로,2023.6.13 06:00,175,0,261,436,0
부산시청→연산교차로,2023.6.13 06:00,395,251,135,781,0
사직운동장→연산교차로,2023.6.13 06:00,118,304,58,480,0
신리→연산교차로,2023.6.13 06:00,353,147,33,533,0
안락→연산교차로,2023.6.13 06:00,498,0,84,582,0
연산터널→연산교차로,2023.6.13 06:00,216,254,39,509,0
교대→연산교차로,2023.6.13 07:00,273,0,421,694,0
부산시청→연산교차로,2023.6.13 07:00,565,381,219,1165,0
사직운동장→연산교차로,2023.6.13 07:00,242,472,60,774,0
신리→연산교차로,2023.6.13 07:00,491,231,39,761,0
안락→연산교차로,2023.6.13 07:00,645,0,85,730,0
연산터널→연산교차로,2023.6.13 07:00,303,369,51,723,0
교대→연산교차로,2023.6.13 08:00,305,0,495,800,0
부산시청→연산교차로,2023.6.13 08:00,583,432,348,1363,0
사직운동장→연산교차로,2023.6.13 08:00,246,639,66,951,0
신리→연산교차로,2023.6.13 08:00,543,343,28,914,0
안락→연산교차로,2023.6.13 08:00,613,0,108,721,0
연산터널→연산교차로,2023.6.13 08:00,320,376,38,734,0
교대→연산교차로,2023.6.13 09:00,295,0,509,804,0
부산시청→연산교차로,2023.6.13 09:00,539,363,288,1190,0
사직운동장→연산교차로,2023.6.13 09:00,255,549,87,891,0
신리→연산교차로,2023.6.13 09:00,460,340,51,851,0
안락→연산교차로,2023.6.13 09:00,616,0,100,716,0
연산터널→연산교차로,2023.6.13 09:00,295,372,43,710,0
교대→연산교차로,2023.6.13 10:00,312,0,526,838,0
부산시청→연산교차로,2023.6.13 10:00,553,378,285,1216,0
사직운동장→연산교차로,2023.6.13 10:00,252,570,76,898,0
신리→연산교차로,2023.6.13 10:00,427,261,66,754,0
안락→연산교차로,2023.6.13 10:00,575,0,121,696,0
연산터널→연산교차로,2023.6.13 10:00,295,339,53,687,0
교대→연산교차로,2023.6.13 11:00,277,0,448,725,0
부산시청→연산교차로,2023.6.13 11:00,576,393,260,1229,0
사직운동장→연산교차로,2023.6.13 11:00,263,552,92,907,0
신리→연산교차로,2023.6.13 11:00,407,242,58,707,0
안락→연산교차로,2023.6.13 11:00,528,0,134,662,0
연산터널→연산교차로,2023.6.13 11:00,285,319,47,651,0
교대→연산교차로,2023.6.13 12:00,295,0,395,690,0
부산시청→연산교차로,2023.6.13 12:00,559,370,249,1178,0
사직운동장→연산교차로,2023.6.13 12:00,227,563,80,870,0
신리→연산교차로,2023.6.13 12:00,380,229,52,661,0
안락→연산교차로,2023.6.13 12:00,484,0,123,607,0
연산터널→연산교차로,2023.6.13 12:00,271,277,49,597,0
교대→연산교차로,2023.6.13 13:00,323,0,460,783,0
부산시청→연산교차로,2023.6.13 13:00,556,440,227,1223,0
사직운동장→연산교차로,2023.6.13 13:00,280,607,88,975,0
신리→연산교차로,2023.6.13 13:00,447,264,54,765,0
안락→연산교차로,2023.6.13 13:00,446,0,117,563,0
연산터널→연산교차로,2023.6.13 13:00,249,205,38,492,0
교대→연산교차로,2023.6.13 14:00,342,0,499,841,0
부산시청→연산교차로,2023.6.13 14:00,552,418,284,1254,0
사직운동장→연산교차로,2023.6.13 14:00,421,604,95,1120,0
신리→연산교차로,2023.6.13 14:00,429,273,60,762,0
안락→연산교차로,2023.6.13 14:00,456,0,113,569,0
연산터널→연산교차로,2023.6.13 14:00,270,266,57,593,0
교대→연산교차로,2023.6.13 15:00,369,0,444,813,0
부산시청→연산교차로,2023.6.13 15:00,578,473,285,1336,0
사직운동장→연산교차로,2023.6.13 15:00,286,613,90,989,0
신리→연산교차로,2023.6.13 15:00,410,256,72,738,0
안락→연산교차로,2023.6.13 15:00,456,0,118,574,0
연산터널→연산교차로,2023.6.13 15:00,229,253,33,515,0
교대→연산교차로,2023.6.13 16:00,353,0,524,877,0
부산시청→연산교차로,2023.6.13 16:00,617,521,282,1420,0
사직운동장→연산교차로,2023.6.13 16:00,416,654,56,1126,0
신리→연산교차로,2023.6.13 16:00,490,269,56,815,0
안락→연산교차로,2023.6.13 16:00,453,0,102,555,0
연산터널→연산교차로,2023.6.13 16:00,233,271,43,547,0
교대→연산교차로,2023.6.13 17:00,366,0,559,925,0
부산시청→연산교차로,2023.6.13 17:00,619,511,338,1468,0
사직운동장→연산교차로,2023.6.13 17:00,340,671,50,1061,0
신리→연산교차로,2023.6.13 17:00,527,306,46,879,0
안락→연산교차로,2023.6.13 17:00,484,0,105,589,0
연산터널→연산교차로,2023.6.13 17:00,248,276,41,565,0
교대→연산교차로,2023.6.13 18:00,379,0,591,970,0
부산시청→연산교차로,2023.6.13 18:00,594,569,330,1493,0
사직운동장→연산교차로,2023.6.13 18:00,266,680,53,999,0
신리→연산교차로,2023.6.13 18:00,538,272,48,858,0
안락→연산교차로,2023.6.13 18:00,492,0,95,587,0
연산터널→연산교차로,2023.6.13 18:00,207,292,53,552,0
교대→연산교차로,2023.6.13 19:00,55,0,80,135,0
부산시청→연산교차로,2023.6.13 19:00,108,80,60,248,0
사직운동장→연산교차로,2023.6.13 19:00,35,87,10,132,0
신리→연산교차로,2023.6.13 19:00,68,41,8,117,0
안락→연산교차로,2023.6.13 19:00,93,0,19,112,0
연산터널→연산교차로,2023.6.13 19:00,42,50,10,102,0
교대→연산교차로,2023.6.13 20:00,273,0,255,528,0
부산시청→연산교차로,2023.6.13 20:00,392,308,177,877,0
사직운동장→연산교차로,2023.6.13 20:00,145,391,66,602,0
신리→연산교차로,2023.6.13 20:00,278,144,27,449,0
안락→연산교차로,2023.6.13 20:00,312,0,70,382,0
연산터널→연산교차로,2023.6.13 20:00,168,214,39,421,0
교대→연산교차로,2023.6.13 21:00,276,0,266,542,0
부산시청→연산교차로,2023.6.13 21:00,499,343,260,1102,0
사직운동장→연산교차로,2023.6.13 21:00,191,471,88,750,0
신리→연산교차로,2023.6.13 21:00,273,169,29,471,0
안락→연산교차로,2023.6.13 21:00,405,0,108,513,0
연산터널→연산교차로,2023.6.13 21:00,235,250,48,533,0
교대→연산교차로,2023.6.13 22:00,231,0,248,479,0
부산시청→연산교차로,2023.6.13 22:00,365,262,183,810,0
사직운동장→연산교차로,2023.6.13 22:00,196,431,78,705,0
신리→연산교차로,2023.6.13 22:00,248,158,24,430,0
안락→연산교차로,2023.6.13 22:00,360,0,99,459,0
연산터널→연산교차로,2023.6.13 22:00,227,240,61,528,0
교대→연산교차로,2023.6.13 23:00,187,0,179,366,0
부산시청→연산교차로,2023.6.13 23:00,326,187,105,618,0
사직운동장→연산교차로,2023.6.13 23:00,210,377,67,654,0
신리→연산교차로,2023.6.13 23:00,198,114,21,333,0
안락→연산교차로,2023.6.13 23:00,293,0,88,381,0
연산터널→연산교차로,2023.6.13 23:00,163,186,60,409,0
교대→연산교차로,2023.6.14 00:00,118,0,160,278,0
부산시청→연산교차로,2023.6.14 00:00,237,141,104,482,0
사직운동장→연산교차로,2023.6.14 00:00,76,219,67,362,0
신리→연산교차로,2023.6.14 00:00,136,83,27,246,0
안락→연산교차로,2023.6.14 00:00,194,0,53,247,0
연산터널→연산교차로,2023.6.14 00:00,143,176,78,397,0
교대→연산교차로,2023.6.14 01:00,102,0,142,244,0
부산시청→연산교차로,2023.6.14 01:00,190,133,81,404,0
사직운동장→연산교차로,2023.6.14 01:00,65,191,51,307,0
신리→연산교차로,2023.6.14 01:00,117,70,18,205,0
안락→연산교차로,2023.6.14 01:00,151,0,41,192,0
연산터널→연산교차로,2023.6.14 01:00,110,122,47,279,0
교대→연산교차로,2023.6.14 02:00,70,0,92,162,0
부산시청→연산교차로,2023.6.14 02:00,171,95,70,336,0
사직운동장→연산교차로,2023.6.14 02:00,56,161,39,256,0
신리→연산교차로,2023.6.14 02:00,88,39,19,146,0
안락→연산교차로,2023.6.14 02:00,132,0,24,156,0
연산터널→연산교차로,2023.6.14 02:00,83,137,46,266,0
교대→연산교차로,2023.6.14 03:00,59,0,87,146,0
부산시청→연산교차로,2023.6.14 03:00,138,77,62,277,0
사직운동장→연산교차로,2023.6.14 03:00,47,139,33,219,0
신리→연산교차로,2023.6.14 03:00,78,40,12,130,0
안락→연산교차로,2023.6.14 03:00,99,0,24,123,0
연산터널→연산교차로,2023.6.14 03:00,87,97,58,242,0
교대→연산교차로,2023.6.14 04:00,61,0,67,128,0
부산시청→연산교차로,2023.6.14 04:00,151,75,52,278,0
사직운동장→연산교차로,2023.6.14 04:00,30,118,25,173,0
신리→연산교차로,2023.6.14 04:00,100,53,9,162,0
안락→연산교차로,2023.6.14 04:00,172,0,38,210,0
연산터널→연산교차로,2023.6.14 04:00,85,105,33,223,0
교대→연산교차로,2023.6.14 05:00,95,0,155,250,0
부산시청→연산교차로,2023.6.14 05:00,230,162,76,468,0
사직운동장→연산교차로,2023.6.14 05:00,56,169,32,257,0
신리→연산교차로,2023.6.14 05:00,200,99,12,311,0
안락→연산교차로,2023.6.14 05:00,323,0,58,381,0
연산터널→연산교차로,2023.6.14 05:00,137,154,29,320,0
교대→연산교차로,2023.6.14 06:00,184,0,262,446,0
부산시청→연산교차로,2023.6.14 06:00,367,245,125,737,0
사직운동장→연산교차로,2023.6.14 06:00,108,298,51,457,0
신리→연산교차로,2023.6.14 06:00,320,154,27,501,0
안락→연산교차로,2023.6.14 06:00,526,0,87,613,0
연산터널→연산교차로,2023.6.14 06:00,226,234,49,509,0
교대→연산교차로,2023.6.14 07:00,274,0,437,711,0
부산시청→연산교차로,2023.6.14 07:00,538,377,229,1144,0
사직운동장→연산교차로,2023.6.14 07:00,234,508,62,804,0
신리→연산교차로,2023.6.14 07:00,481,254,30,765,0
안락→연산교차로,2023.6.14 07:00,590,0,92,682,0
연산터널→연산교차로,2023.6.14 07:00,305,375,49,729,0
교대→연산교차로,2023.6.14 08:00,328,0,492,820,0
부산시청→연산교차로,2023.6.14 08:00,617,401,314,1332,0
사직운동장→연산교차로,2023.6.14 08:00,244,650,65,959,0
신리→연산교차로,2023.6.14 08:00,520,347,30,897,0
안락→연산교차로,2023.6.14 08:00,628,0,112,740,0
연산터널→연산교차로,2023.6.14 08:00,308,372,40,720,0
교대→연산교차로,2023.6.14 09:00,282,0,477,759,0
부산시청→연산교차로,2023.6.14 09:00,511,375,258,1144,0
사직운동장→연산교차로,2023.6.14 09:00,232,561,101,894,0
신리→연산교차로,2023.6.14 09:00,453,348,31,832,0
안락→연산교차로,2023.6.14 09:00,591,0,107,698,0
연산터널→연산교차로,2023.6.14 09:00,303,355,44,702,0
교대→연산교차로,2023.6.14 10:00,305,0,436,741,0
부산시청→연산교차로,2023.6.14 10:00,556,358,274,1188,0
사직운동장→연산교차로,2023.6.14 10:00,334,543,70,947,0
신리→연산교차로,2023.6.14 10:00,469,262,65,796,0
안락→연산교차로,2023.6.14 10:00,560,0,136,696,0
연산터널→연산교차로,2023.6.14 10:00,287,364,31,682,0
교대→연산교차로,2023.6.14 11:00,305,0,446,751,0
부산시청→연산교차로,2023.6.14 11:00,556,340,255,1151,0
사직운동장→연산교차로,2023.6.14 11:00,293,542,94,929,0
신리→연산교차로,2023.6.14 11:00,411,250,65,726,0
안락→연산교차로,2023.6.14 11:00,526,0,123,649,0
연산터널→연산교차로,2023.6.14 11:00,282,278,49,609,0
교대→연산교차로,2023.6.14 12:00,308,0,413,721,0
부산시청→연산교차로,2023.6.14 12:00,511,315,264,1090,0
사직운동장→연산교차로,2023.6.14 12:00,239,524,91,854,0
신리→연산교차로,2023.6.14 12:00,424,238,26,688,0
안락→연산교차로,2023.6.14 12:00,514,0,156,670,0
연산터널→연산교차로,2023.6.14 12:00,244,253,56,553,0
교대→연산교차로,2023.6.14 13:00,330,0,402,732,0
부산시청→연산교차로,2023.6.14 13:00,533,458,266,1257,0
사직운동장→연산교차로,2023.6.14 13:00,341,587,100,1028,0
신리→연산교차로,2023.6.14 13:00,422,271,56,749,0
안락→연산교차로,2023.6.14 13:00,457,0,103,560,0
연산터널→연산교차로,2023.6.14 13:00,237,278,26,541,0
교대→연산교차로,2023.6.14 14:00,349,0,501,850,0
부산시청→연산교차로,2023.6.14 14:00,603,421,306,1330,0
사직운동장→연산교차로,2023.6.14 14:00,347,612,93,1052,0
신리→연산교차로,2023.6.14 14:00,469,269,54,792,0
안락→연산교차로,2023.6.14 14:00,439,0,97,536,0
연산터널→연산교차로,2023.6.14 14:00,245,267,42,554,0
교대→연산교차로,2023.6.14 15:00,340,0,448,788,0
부산시청→연산교차로,2023.6.14 15:00,625,468,292,1385,0
사직운동장→연산교차로,2023.6.14 15:00,308,592,59,959,0
신리→연산교차로,2023.6.14 15:00,480,296,51,827,0
안락→연산교차로,2023.6.14 15:00,435,0,109,544,0
연산터널→연산교차로,2023.6.14 15:00,235,278,40,553,0
교대→연산교차로,2023.6.14 16:00,364,0,474,838,0
부산시청→연산교차로,2023.6.14 16:00,636,530,303,1469,0
사직운동장→연산교차로,2023.6.14 16:00,293,667,55,1015,0
신리→연산교차로,2023.6.14 16:00,518,275,44,837,0
안락→연산교차로,2023.6.14 16:00,462,0,102,564,0
연산터널→연산교차로,2023.6.14 16:00,249,266,31,546,0
교대→연산교차로,2023.6.14 17:00,356,0,534,890,0
부산시청→연산교차로,2023.6.14 17:00,565,481,318,1364,0
사직운동장→연산교차로,2023.6.14 17:00,389,681,61,1131,0
신리→연산교차로,2023.6.14 17:00,521,320,52,893,0
안락→연산교차로,2023.6.14 17:00,474,0,118,592,0
연산터널→연산교차로,2023.6.14 17:00,247,285,39,571,0
교대→연산교차로,2023.6.14 18:00,377,0,618,995,0
부산시청→연산교차로,2023.6.14 18:00,594,573,339,1506,0
사직운동장→연산교차로,2023.6.14 18:00,320,675,38,1033,0
신리→연산교차로,2023.6.14 18:00,519,259,49,827,0
안락→연산교차로,2023.6.14 18:00,454,0,97,551,0
연산터널→연산교차로,2023.6.14 18:00,226,246,59,531,0
교대→연산교차로,2023.6.14 19:00,319,0,402,721,0
부산시청→연산교차로,2023.6.14 19:00,528,393,268,1189,0
사직운동장→연산교차로,2023.6.14 19:00,178,539,86,803,0
신리→연산교차로,2023.6.14 19:00,354,213,37,604,0
안락→연산교차로,2023.6.14 19:00,450,0,94,544,0
연산터널→연산교차로,2023.6.14 19:00,202,238,64,504,0
교대→연산교차로,2023.6.14 20:00,315,0,326,641,0
부산시청→연산교차로,2023.6.14 20:00,510,379,223,1112,0
사직운동장→연산교차로,2023.6.14 20:00,180,468,58,706,0
신리→연산교차로,2023.6.14 20:00,305,182,44,531,0
안락→연산교차로,2023.6.14 20:00,387,0,102,489,0
연산터널→연산교차로,2023.6.14 20:00,204,246,56,506,0
교대→연산교차로,2023.6.14 21:00,277,0,284,561,0
부산시청→연산교차로,2023.6.14 21:00,462,313,206,981,0
사직운동장→연산교차로,2023.6.14 21:00,184,480,89,753,0
신리→연산교차로,2023.6.14 21:00,310,186,35,531,0
안락→연산교차로,2023.6.14 21:00,406,0,102,508,0
연산터널→연산교차로,2023.6.14 21:00,222,258,55,535,0
교대→연산교차로,2023.6.14 22:00,257,0,253,510,0
부산시청→연산교차로,2023.6.14 22:00,394,275,176,845,0
사직운동장→연산교차로,2023.6.14 22:00,223,427,58,708,0
신리→연산교차로,2023.6.14 22:00,264,158,29,451,0
안락→연산교차로,2023.6.14 22:00,386,0,103,489,0
연산터널→연산교차로,2023.6.14 22:00,197,227,72,496,0
교대→연산교차로,2023.6.14 23:00,199,0,168,367,0
부산시청→연산교차로,2023.6.14 23:00,296,198,115,609,0
사직운동장→연산교차로,2023.6.14 23:00,137,275,27,439,0
신리→연산교차로,2023.6.14 23:00,239,134,19,392,0
안락→연산교차로,2023.6.14 23:00,283,0,55,338,0
연산터널→연산교차로,2023.6.14 23:00,171,173,31,375,0
교대→연산교차로,2023.6.15 00:00,131,0,143,274,0
부산시청→연산교차로,2023.6.15 00:00,256,151,116,523,0
사직운동장→연산교차로,2023.6.15 00:00,98,263,44,405,0
신리→연산교차로,2023.6.15 00:00,152,105,16,273,0
안락→연산교차로,2023.6.15 00:00,225,0,62,287,0
연산터널→연산교차로,2023.6.15 00:00,130,157,55,342,0
교대→연산교차로,2023.6.15 01:00,88,0,118,206,0
부산시청→연산교차로,2023.6.15 01:00,190,98,87,375,0
사직운동장→연산교차로,2023.6.15 01:00,62,160,55,277,0
신리→연산교차로,2023.6.15 01:00,104,70,22,196,0
안락→연산교차로,2023.6.15 01:00,159,0,46,205,0
연산터널→연산교차로,2023.6.15 01:00,108,134,43,285,0
교대→연산교차로,2023.6.15 02:00,64,0,95,159,0
부산시청→연산교차로,2023.6.15 02:00,156,88,60,304,0
사직운동장→연산교차로,2023.6.15 02:00,51,130,33,214,0
신리→연산교차로,2023.6.15 02:00,78,37,15,130,0
안락→연산교차로,2023.6.15 02:00,144,0,37,181,0
연산터널→연산교차로,2023.6.15 02:00,83,113,32,228,0
교대→연산교차로,2023.6.15 03:00,62,0,63,125,0
부산시청→연산교차로,2023.6.15 03:00,146,68,57,271,0
사직운동장→연산교차로,2023.6.15 03:00,37,123,19,179,0
신리→연산교차로,2023.6.15 03:00,66,36,11,113,0
안락→연산교차로,2023.6.15 03:00,100,0,28,128,0
연산터널→연산교차로,2023.6.15 03:00,79,88,37,204,0
교대→연산교차로,2023.6.15 04:00,47,0,80,127,0
부산시청→연산교차로,2023.6.15 04:00,155,65,50,270,0
사직운동장→연산교차로,2023.6.15 04:00,40,123,27,190,0
신리→연산교차로,2023.6.15 04:00,96,50,7,153,0
안락→연산교차로,2023.6.15 04:00,183,0,31,214,0
연산터널→연산교차로,2023.6.15 04:00,72,95,30,197,0
교대→연산교차로,2023.6.15 05:00,86,0,137,223,0
부산시청→연산교차로,2023.6.15 05:00,245,168,79,492,0
사직운동장→연산교차로,2023.6.15 05:00,75,165,33,273,0
신리→연산교차로,2023.6.15 05:00,191,96,9,296,0
안락→연산교차로,2023.6.15 05:00,331,0,51,382,0
연산터널→연산교차로,2023.6.15 05:00,153,138,38,329,0
교대→연산교차로,2023.6.15 06:00,176,0,264,440,0
부산시청→연산교차로,2023.6.15 06:00,361,250,133,744,0
사직운동장→연산교차로,2023.6.15 06:00,128,296,35,459,0
신리→연산교차로,2023.6.15 06:00,320,171,22,513,0
안락→연산교차로,2023.6.15 06:00,507,0,86,593,0
연산터널→연산교차로,2023.6.15 06:00,226,235,45,506,0
교대→연산교차로,2023.6.15 07:00,276,0,382,658,0
부산시청→연산교차로,2023.6.15 07:00,527,352,209,1088,0
사직운동장→연산교차로,2023.6.15 07:00,256,459,59,774,0
신리→연산교차로,2023.6.15 07:00,441,242,38,721,0
안락→연산교차로,2023.6.15 07:00,589,0,61,650,0
연산터널→연산교차로,2023.6.15 07:00,289,350,43,682,0
교대→연산교차로,2023.6.15 08:00,318,0,478,796,0
부산시청→연산교차로,2023.6.15 08:00,581,438,300,1319,0
사직운동장→연산교차로,2023.6.15 08:00,303,672,85,1060,0
신리→연산교차로,2023.6.15 08:00,529,353,29,911,0
안락→연산교차로,2023.6.15 08:00,585,0,74,659,0
연산터널→연산교차로,2023.6.15 08:00,326,347,30,703,0
교대→연산교차로,2023.6.15 09:00,290,0,509,799,0
부산시청→연산교차로,2023.6.15 09:00,530,382,287,1199,0
사직운동장→연산교차로,2023.6.15 09:00,340,580,81,1001,0
신리→연산교차로,2023.6.15 09:00,486,333,38,857,0
안락→연산교차로,2023.6.15 09:00,592,0,102,694,0
연산터널→연산교차로,2023.6.15 09:00,300,376,39,715,0
교대→연산교차로,2023.6.15 10:00,299,0,472,771,0
부산시청→연산교차로,2023.6.15 10:00,551,356,255,1162,0
사직운동장→연산교차로,2023.6.15 10:00,329,567,82,978,0
신리→연산교차로,2023.6.15 10:00,492,281,56,829,0
안락→연산교차로,2023.6.15 10:00,589,0,130,719,0
연산터널→연산교차로,2023.6.15 10:00,301,344,38,683,0
교대→연산교차로,2023.6.15 11:00,305,0,405,710,0
부산시청→연산교차로,2023.6.15 11:00,571,375,285,1231,0
사직운동장→연산교차로,2023.6.15 11:00,342,612,88,1042,0
신리→연산교차로,2023.6.15 11:00,421,264,66,751,0
안락→연산교차로,2023.6.15 11:00,525,0,130,655,0
연산터널→연산교차로,2023.6.15 11:00,283,276,37,596,0
교대→연산교차로,2023.6.15 12:00,295,0,370,665,0
부산시청→연산교차로,2023.6.15 12:00,523,347,257,1127,0
사직운동장→연산교차로,2023.6.15 12:00,256,553,73,882,0
신리→연산교차로,2023.6.15 12:00,409,222,42,673,0
안락→연산교차로,2023.6.15 12:00,535,0,118,653,0
연산터널→연산교차로,2023.6.15 12:00,271,277,53,601,0
교대→연산교차로,2023.6.15 13:00,330,0,454,784,0
부산시청→연산교차로,2023.6.15 13:00,581,414,257,1252,0
사직운동장→연산교차로,2023.6.15 13:00,297,583,88,968,0
신리→연산교차로,2023.6.15 13:00,415,282,39,736,0
안락→연산교차로,2023.6.15 13:00,422,0,112,534,0
연산터널→연산교차로,2023.6.15 13:00,236,269,40,545,0
교대→연산교차로,2023.6.15 14:00,343,0,451,794,0
부산시청→연산교차로,2023.6.15 14:00,555,451,292,1298,0
사직운동장→연산교차로,2023.6.15 14:00,338,633,87,1058,0
신리→연산교차로,2023.6.15 14:00,459,249,47,755,0
안락→연산교차로,2023.6.15 14:00,444,0,111,555,0
연산터널→연산교차로,2023.6.15 14:00,225,297,39,561,0
교대→연산교차로,2023.6.15 15:00,339,0,501,840,0
부산시청→연산교차로,2023.6.15 15:00,601,475,305,1381,0
사직운동장→연산교차로,2023.6.15 15:00,335,622,80,1037,0
신리→연산교차로,2023.6.15 15:00,447,264,56,767,0
안락→연산교차로,2023.6.15 15:00,435,0,87,522,0
연산터널→연산교차로,2023.6.15 15:00,236,280,45,561,0
교대→연산교차로,2023.6.15 16:00,366,0,518,884,0
부산시청→연산교차로,2023.6.15 16:00,596,517,328,1441,0
사직운동장→연산교차로,2023.6.15 16:00,369,681,59,1109,0
신리→연산교차로,2023.6.15 16:00,514,282,60,856,0
안락→연산교차로,2023.6.15 16:00,458,0,77,535,0
연산터널→연산교차로,2023.6.15 16:00,239,279,39,557,0
교대→연산교차로,2023.6.15 17:00,383,0,546,929,0
부산시청→연산교차로,2023.6.15 17:00,603,561,286,1450,0
사직운동장→연산교차로,2023.6.15 17:00,298,698,49,1045,0
신리→연산교차로,2023.6.15 17:00,505,311,45,861,0
안락→연산교차로,2023.6.15 17:00,451,0,105,556,0
연산터널→연산교차로,2023.6.15 17:00,260,280,28,568,0
교대→연산교차로,2023.6.15 18:00,369,0,569,938,0
부산시청→연산교차로,2023.6.15 18:00,577,556,351,1484,0
사직운동장→연산교차로,2023.6.15 18:00,280,686,52,1018,0
신리→연산교차로,2023.6.15 18:00,491,278,44,813,0
안락→연산교차로,2023.6.15 18:00,475,0,103,578,0
연산터널→연산교차로,2023.6.15 18:00,236,279,46,561,0
교대→연산교차로,2023.6.15 19:00,304,0,407,711,0
부산시청→연산교차로,2023.6.15 19:00,572,403,255,1230,0
사직운동장→연산교차로,2023.6.15 19:00,184,524,72,780,0
신리→연산교차로,2023.6.15 19:00,366,223,42,631,0
안락→연산교차로,2023.6.15 19:00,442,0,91,533,0
연산터널→연산교차로,2023.6.15 19:00,184,240,69,493,0
교대→연산교차로,2023.6.15 20:00,309,0,311,620,0
부산시청→연산교차로,2023.6.15 20:00,467,367,236,1070,0
사직운동장→연산교차로,2023.6.15 20:00,155,469,80,704,0
신리→연산교차로,2023.6.15 20:00,301,171,35,507,0
안락→연산교차로,2023.6.15 20:00,374,0,100,474,0
연산터널→연산교차로,2023.6.15 20:00,210,277,57,544,0
교대→연산교차로,2023.6.15 21:00,285,0,324,609,0
부산시청→연산교차로,2023.6.15 21:00,479,316,230,1025,0
사직운동장→연산교차로,2023.6.15 21:00,163,454,88,705,0
신리→연산교차로,2023.6.15 21:00,308,193,33,534,0
안락→연산교차로,2023.6.15 21:00,416,0,124,540,0
연산터널→연산교차로,2023.6.15 21:00,249,258,45,552,0
교대→연산교차로,2023.6.15 22:00,229,0,248,477,0
부산시청→연산교차로,2023.6.15 22:00,451,271,160,882,0
사직운동장→연산교차로,2023.6.15 22:00,177,414,65,656,0
신리→연산교차로,2023.6.15 22:00,251,171,27,449,0
안락→연산교차로,2023.6.15 22:00,374,0,103,477,0
연산터널→연산교차로,2023.6.15 22:00,224,218,66,508,0
교대→연산교차로,2023.6.15 23:00,181,0,180,361,0
부산시청→연산교차로,2023.6.15 23:00,365,208,124,697,0
사직운동장→연산교차로,2023.6.15 23:00,185,338,70,593,0
신리→연산교차로,2023.6.15 23:00,188,115,30,333,0
안락→연산교차로,2023.6.15 23:00,296,0,79,375,0
연산터널→연산교차로,2023.6.15 23:00,163,186,45,394,0
교대→연산교차로,2023.6.16 00:00,145,0,146,291,0
부산시청→연산교차로,2023.6.16 00:00,275,149,103,527,0
사직운동장→연산교차로,2023.6.16 00:00,83,216,53,352,0
신리→연산교차로,2023.6.16 00:00,170,117,15,302,0
안락→연산교차로,2023.6.16 00:00,230,0,51,281,0
연산터널→연산교차로,2023.6.16 00:00,133,182,58,373,0
교대→연산교차로,2023.6.16 01:00,103,0,141,244,0
부산시청→연산교차로,2023.6.16 01:00,216,109,95,420,0
사직운동장→연산교차로,2023.6.16 01:00,67,187,48,302,0
신리→연산교차로,2023.6.16 01:00,132,60,20,212,0
안락→연산교차로,2023.6.16 01:00,171,0,57,228,0
연산터널→연산교차로,2023.6.16 01:00,128,163,50,341,0
교대→연산교차로,2023.6.16 02:00,82,0,103,185,0
부산시청→연산교차로,2023.6.16 02:00,178,76,65,319,0
사직운동장→연산교차로,2023.6.16 02:00,60,158,27,245,0
신리→연산교차로,2023.6.16 02:00,92,50,20,162,0
안락→연산교차로,2023.6.16 02:00,122,0,43,165,0
연산터널→연산교차로,2023.6.16 02:00,103,102,41,246,0
교대→연산교차로,2023.6.16 03:00,71,0,71,142,0
부산시청→연산교차로,2023.6.16 03:00,156,69,52,277,0
사직운동장→연산교차로,2023.6.16 03:00,41,120,29,190,0
신리→연산교차로,2023.6.16 03:00,77,52,13,142,0
안락→연산교차로,2023.6.16 03:00,99,0,29,128,0
연산터널→연산교차로,2023.6.16 03:00,72,102,42,216,0
교대→연산교차로,2023.6.16 04:00,56,0,77,133,0
부산시청→연산교차로,2023.6.16 04:00,155,63,56,274,0
사직운동장→연산교차로,2023.6.16 04:00,43,112,33,188,0
신리→연산교차로,2023.6.16 04:00,101,46,5,152,0
안락→연산교차로,2023.6.16 04:00,184,0,35,219,0
연산터널→연산교차로,2023.6.16 04:00,71,102,19,192,0
교대→연산교차로,2023.6.16 05:00,78,0,139,217,0
부산시청→연산교차로,2023.6.16 05:00,267,155,75,497,0
사직운동장→연산교차로,2023.6.16 05:00,57,188,43,288,0
신리→연산교차로,2023.6.16 05:00,221,80,11,312,0
안락→연산교차로,2023.6.16 05:00,330,0,65,395,0
연산터널→연산교차로,2023.6.16 05:00,128,161,34,323,0
교대→연산교차로,2023.6.16 06:00,181,0,254,435,0
부산시청→연산교차로,2023.6.16 06:00,359,249,128,736,0
사직운동장→연산교차로,2023.6.16 06:00,102,255,39,396,0
신리→연산교차로,2023.6.16 06:00,342,164,27,533,0
안락→연산교차로,2023.6.16 06:00,528,0,74,602,0
연산터널→연산교차로,2023.6.16 06:00,218,245,35,498,0
교대→연산교차로,2023.6.16 07:00,288,0,396,684,0
부산시청→연산교차로,2023.6.16 07:00,556,372,207,1135,0
사직운동장→연산교차로,2023.6.16 07:00,203,454,50,707,0
신리→연산교차로,2023.6.16 07:00,452,244,28,724,0
안락→연산교차로,2023.6.16 07:00,641,0,59,700,0
연산터널→연산교차로,2023.6.16 07:00,278,366,44,688,0
교대→연산교차로,2023.6.16 08:00,321,0,454,775,0
부산시청→연산교차로,2023.6.16 08:00,564,403,342,1309,0
사직운동장→연산교차로,2023.6.16 08:00,262,640,46,948,0
신리→연산교차로,2023.6.16 08:00,539,337,42,918,0
안락→연산교차로,2023.6.16 08:00,617,0,88,705,0
연산터널→연산교차로,2023.6.16 08:00,303,364,47,714,0
교대→연산교차로,2023.6.16 09:00,302,0,452,754,0
부산시청→연산교차로,2023.6.16 09:00,523,336,260,1119,0
사직운동장→연산교차로,2023.6.16 09:00,228,560,82,870,0
신리→연산교차로,2023.6.16 09:00,468,334,46,848,0
안락→연산교차로,2023.6.16 09:00,602,0,102,704,0
연산터널→연산교차로,2023.6.16 09:00,303,348,48,699,0
교대→연산교차로,2023.6.16 10:00,310,0,450,760,0
부산시청→연산교차로,2023.6.16 10:00,567,359,282,1208,0
사직운동장→연산교차로,2023.6.16 10:00,315,584,64,963,0
신리→연산교차로,2023.6.16 10:00,484,277,55,816,0
안락→연산교차로,2023.6.16 10:00,570,0,146,716,0
연산터널→연산교차로,2023.6.16 10:00,281,349,60,690,0
교대→연산교차로,2023.6.16 11:00,313,0,482,795,0
부산시청→연산교차로,2023.6.16 11:00,542,379,260,1181,0
사직운동장→연산교차로,2023.6.16 11:00,316,555,77,948,0
신리→연산교차로,2023.6.16 11:00,445,269,63,777,0
안락→연산교차로,2023.6.16 11:00,572,0,140,712,0
연산터널→연산교차로,2023.6.16 11:00,264,285,48,597,0
교대→연산교차로,2023.6.16 12:00,297,0,413,710,0
부산시청→연산교차로,2023.6.16 12:00,576,351,228,1155,0
사직운동장→연산교차로,2023.6.16 12:00,271,567,77,915,0
신리→연산교차로,2023.6.16 12:00,441,243,49,733,0
안락→연산교차로,2023.6.16 12:00,504,0,135,639,0
연산터널→연산교차로,2023.6.16 12:00,266,307,57,630,0
교대→연산교차로,2023.6.16 13:00,333,0,442,775,0
부산시청→연산교차로,2023.6.16 13:00,590,442,258,1290,0
사직운동장→연산교차로,2023.6.16 13:00,303,595,94,992,0
신리→연산교차로,2023.6.16 13:00,409,271,51,731,0
안락→연산교차로,2023.6.16 13:00,425,0,132,557,0
연산터널→연산교차로,2023.6.16 13:00,239,285,48,572,0
교대→연산교차로,2023.6.16 14:00,354,0,440,794,0
부산시청→연산교차로,2023.6.16 14:00,629,443,281,1353,0
사직운동장→연산교차로,2023.6.16 14:00,311,674,80,1065,0
신리→연산교차로,2023.6.16 14:00,479,274,51,804,0
안락→연산교차로,2023.6.16 14:00,459,0,128,587,0
연산터널→연산교차로,2023.6.16 14:00,254,267,48,569,0
교대→연산교차로,2023.6.16 15:00,369,0,497,866,0
부산시청→연산교차로,2023.6.16 15:00,621,489,276,1386,0
사직운동장→연산교차로,2023.6.16 15:00,360,637,76,1073,0
신리→연산교차로,2023.6.16 15:00,515,277,64,856,0
안락→연산교차로,2023.6.16 15:00,425,0,114,539,0
연산터널→연산교차로,2023.6.16 15:00,255,268,34,557,0
교대→연산교차로,2023.6.16 16:00,374,0,438,812,0
부산시청→연산교차로,2023.6.16 16:00,581,491,329,1401,0
사직운동장→연산교차로,2023.6.16 16:00,335,649,48,1032,0
신리→연산교차로,2023.6.16 16:00,470,325,45,840,0
안락→연산교차로,2023.6.16 16:00,414,0,102,516,0
연산터널→연산교차로,2023.6.16 16:00,249,255,41,545,0
교대→연산교차로,2023.6.16 17:00,379,0,536,915,0
부산시청→연산교차로,2023.6.16 17:00,569,532,264,1365,0
사직운동장→연산교차로,2023.6.16 17:00,305,672,71,1048,0
신리→연산교차로,2023.6.16 17:00,502,321,32,855,0
안락→연산교차로,2023.6.16 17:00,467,0,101,568,0
연산터널→연산교차로,2023.6.16 17:00,244,263,46,553,0
교대→연산교차로,2023.6.16 18:00,369,0,590,959,0
부산시청→연산교차로,2023.6.16 18:00,594,546,330,1470,0
사직운동장→연산교차로,2023.6.16 18:00,231,635,73,939,0
신리→연산교차로,2023.6.16 18:00,512,303,43,858,0
안락→연산교차로,2023.6.16 18:00,506,0,91,597,0
연산터널→연산교차로,2023.6.16 18:00,234,258,49,541,0
교대→연산교차로,2023.6.16 19:00,335,0,472,807,0
부산시청→연산교차로,2023.6.16 19:00,561,419,267,1247,0
사직운동장→연산교차로,2023.6.16 19:00,211,584,85,880,0
신리→연산교차로,2023.6.16 19:00,439,280,30,749,0
안락→연산교차로,2023.6.16 19:00,445,0,95,540,0
연산터널→연산교차로,2023.6.16 19:00,213,259,60,532,0
교대→연산교차로,2023.6.16 20:00,335,0,428,763,0
부산시청→연산교차로,2023.6.16 20:00,475,352,264,1091,0
사직운동장→연산교차로,2023.6.16 20:00,221,558,85,864,0
신리→연산교차로,2023.6.16 20:00,331,183,39,553,0
안락→연산교차로,2023.6.16 20:00,445,0,86,531,0
연산터널→연산교차로,2023.6.16 20:00,219,281,48,548,0
교대→연산교차로,2023.6.16 21:00,310,0,371,681,0
부산시청→연산교차로,2023.6.16 21:00,493,348,235,1076,0
사직운동장→연산교차로,2023.6.16 21:00,209,490,96,795,0
신리→연산교차로,2023.6.16 21:00,337,176,34,547,0
안락→연산교차로,2023.6.16 21:00,425,0,128,553,0
연산터널→연산교차로,2023.6.16 21:00,228,274,58,560,0
교대→연산교차로,2023.6.16 22:00,290,0,292,582,0
부산시청→연산교차로,2023.6.16 22:00,435,273,177,885,0
사직운동장→연산교차로,2023.6.16 22:00,272,478,44,794,0
신리→연산교차로,2023.6.16 22:00,297,196,35,528,0
안락→연산교차로,2023.6.16 22:00,393,0,146,539,0
연산터널→연산교차로,2023.6.16 22:00,250,251,54,555,0
교대→연산교차로,2023.6.16 23:00,276,0,223,499,0
부산시청→연산교차로,2023.6.16 23:00,421,237,147,805,0
사직운동장→연산교차로,2023.6.16 23:00,293,479,36,808,0
신리→연산교차로,2023.6.16 23:00,252,165,28,445,0
안락→연산교차로,2023.6.16 23:00,305,0,89,394,0
연산터널→연산교차로,2023.6.16 23:00,180,221,47,448,0
교대→연산교차로,2023.6.17 00:00,219,0,194,413,0
부산시청→연산교차로,2023.6.17 00:00,330,183,113,626,0
사직운동장→연산교차로,2023.6.17 00:00,145,279,57,481,0
신리→연산교차로,2023.6.17 00:00,269,139,22,430,0
안락→연산교차로,2023.6.17 00:00,264,0,78,342,0
연산터널→연산교차로,2023.6.17 00:00,139,209,51,399,0
교대→연산교차로,2023.6.17 01:00,179,0,193,372,0
부산시청→연산교차로,2023.6.17 01:00,283,187,98,568,0
사직운동장→연산교차로,2023.6.17 01:00,113,236,65,414,0
신리→연산교차로,2023.6.17 01:00,206,112,12,330,0
안락→연산교차로,2023.6.17 01:00,233,0,66,299,0
연산터널→연산교차로,2023.6.17 01:00,159,188,59,406,0
교대→연산교차로,2023.6.17 02:00,128,0,141,269,0
부산시청→연산교차로,2023.6.17 02:00,249,127,94,470,0
사직운동장→연산교차로,2023.6.17 02:00,76,196,58,330,0
신리→연산교차로,2023.6.17 02:00,124,79,22,225,0
안락→연산교차로,2023.6.17 02:00,187,0,52,239,0
연산터널→연산교차로,2023.6.17 02:00,130,164,48,342,0
교대→연산교차로,2023.6.17 03:00,93,0,139,232,0
부산시청→연산교차로,2023.6.17 03:00,204,102,62,368,0
사직운동장→연산교차로,2023.6.17 03:00,62,153,39,254,0
신리→연산교차로,2023.6.17 03:00,116,55,11,182,0
안락→연산교차로,2023.6.17 03:00,148,0,47,195,0
연산터널→연산교차로,2023.6.17 03:00,102,139,47,288,0
교대→연산교차로,2023.6.17 04:00,92,0,110,202,0
부산시청→연산교차로,2023.6.17 04:00,174,95,61,330,0
사직운동장→연산교차로,2023.6.17 04:00,53,150,46,249,0
신리→연산교차로,2023.6.17 04:00,103,64,12,179,0
안락→연산교차로,2023.6.17 04:00,198,0,42,240,0
연산터널→연산교차로,2023.6.17 04:00,94,121,35,250,0
교대→연산교차로,2023.6.17 05:00,104,0,166,270,0
부산시청→연산교차로,2023.6.17 05:00,250,165,63,478,0
사직운동장→연산교차로,2023.6.17 05:00,70,166,35,271,0
신리→연산교차로,2023.6.17 05:00,223,84,12,319,0
안락→연산교차로,2023.6.17 05:00,315,0,63,378,0
연산터널→연산교차로,2023.6.17 05:00,137,118,22,277,0
교대→연산교차로,2023.6.17 06:00,155,0,195,350,0
부산시청→연산교차로,2023.6.17 06:00,345,232,112,689,0
사직운동장→연산교차로,2023.6.17 06:00,99,256,39,394,0
신리→연산교차로,2023.6.17 06:00,259,125,19,403,0
안락→연산교차로,2023.6.17 06:00,413,0,95,508,0
연산터널→연산교차로,2023.6.17 06:00,179,176,35,390,0
교대→연산교차로,2023.6.17 07:00,190,0,211,401,0
부산시청→연산교차로,2023.6.17 07:00,403,286,138,827,0
사직운동장→연산교차로,2023.6.17 07:00,160,321,45,526,0
신리→연산교차로,2023.6.17 07:00,326,182,24,532,0
안락→연산교차로,2023.6.17 07:00,427,0,64,491,0
연산터널→연산교차로,2023.6.17 07:00,186,197,41,424,0
교대→연산교차로,2023.6.17 08:00,280,0,322,602,0
부산시청→연산교차로,2023.6.17 08:00,482,339,255,1076,0
사직운동장→연산교차로,2023.6.17 08:00,246,521,47,814,0
신리→연산교차로,2023.6.17 08:00,421,235,42,698,0
안락→연산교차로,2023.6.17 08:00,584,0,84,668,0
연산터널→연산교차로,2023.6.17 08:00,290,320,38,648,0
교대→연산교차로,2023.6.17 09:00,297,0,358,655,0
부산시청→연산교차로,2023.6.17 09:00,498,353,264,1115,0
사직운동장→연산교차로,2023.6.17 09:00,248,611,66,925,0
신리→연산교차로,2023.6.17 09:00,501,282,61,844,0
안락→연산교차로,2023.6.17 09:00,589,0,102,691,0
연산터널→연산교차로,2023.6.17 09:00,324,331,49,704,0
교대→연산교차로,2023.6.17 10:00,310,0,446,756,0
부산시청→연산교차로,2023.6.17 10:00,642,378,281,1301,0
사직운동장→연산교차로,2023.6.17 10:00,312,622,56,990,0
신리→연산교차로,2023.6.17 10:00,524,321,74,919,0
안락→연산교차로,2023.6.17 10:00,601,0,126,727,0
연산터널→연산교차로,2023.6.17 10:00,322,307,52,681,0
교대→연산교차로,2023.6.17 11:00,224,0,353,577,0
부산시청→연산교차로,2023.6.17 11:00,467,283,186,936,0
사직운동장→연산교차로,2023.6.17 11:00,267,460,49,776,0
신리→연산교차로,2023.6.17 11:00,381,220,56,657,0
안락→연산교차로,2023.6.17 11:00,445,0,121,566,0
연산터널→연산교차로,2023.6.17 11:00,231,251,36,518,0
교대→연산교차로,2023.6.17 12:00,325,0,502,827,0
부산시청→연산교차로,2023.6.17 12:00,619,397,264,1280,0
사직운동장→연산교차로,2023.6.17 12:00,283,600,55,938,0
신리→연산교차로,2023.6.17 12:00,510,282,70,862,0
안락→연산교차로,2023.6.17 12:00,598,0,126,724,0
연산터널→연산교차로,2023.6.17 12:00,319,329,60,708,0
교대→연산교차로,2023.6.17 13:00,361,0,466,827,0
부산시청→연산교차로,2023.6.17 13:00,663,470,289,1422,0
사직운동장→연산교차로,2023.6.17 13:00,292,676,37,1005,0
신리→연산교차로,2023.6.17 13:00,501,277,63,841,0
안락→연산교차로,2023.6.17 13:00,485,0,117,602,0
연산터널→연산교차로,2023.6.17 13:00,241,290,44,575,0
교대→연산교차로,2023.6.17 14:00,347,0,471,818,0
부산시청→연산교차로,2023.6.17 14:00,608,449,264,1321,0
사직운동장→연산교차로,2023.6.17 14:00,365,688,50,1103,0
신리→연산교차로,2023.6.17 14:00,439,251,65,755,0
안락→연산교차로,2023.6.17 14:00,468,0,116,584,0
연산터널→연산교차로,2023.6.17 14:00,247,272,48,567,0
교대→연산교차로,2023.6.17 15:00,354,0,458,812,0
부산시청→연산교차로,2023.6.17 15:00,588,438,267,1293,0
사직운동장→연산교차로,2023.6.17 15:00,268,644,61,973,0
신리→연산교차로,2023.6.17 15:00,482,249,56,787,0
안락→연산교차로,2023.6.17 15:00,462,0,82,544,0
연산터널→연산교차로,2023.6.17 15:00,239,284,35,558,0
교대→연산교차로,2023.6.17 16:00,357,0,395,752,0
부산시청→연산교차로,2023.6.17 16:00,612,487,279,1378,0
사직운동장→연산교차로,2023.6.17 16:00,285,695,65,1045,0
신리→연산교차로,2023.6.17 16:00,507,202,42,751,0
안락→연산교차로,2023.6.17 16:00,466,0,102,568,0
연산터널→연산교차로,2023.6.17 16:00,259,253,53,565,0
교대→연산교차로,2023.6.17 17:00,344,0,374,718,0
부산시청→연산교차로,2023.6.17 17:00,607,451,243,1301,0
사직운동장→연산교차로,2023.6.17 17:00,278,639,52,969,0
신리→연산교차로,2023.6.17 17:00,475,250,35,760,0
안락→연산교차로,2023.6.17 17:00,471,0,98,569,0
연산터널→연산교차로,2023.6.17 17:00,227,281,41,549,0
교대→연산교차로,2023.6.17 18:00,336,0,372,708,0
부산시청→연산교차로,2023.6.17 18:00,545,384,258,1187,0
사직운동장→연산교차로,2023.6.17 18:00,242,564,67,873,0
신리→연산교차로,2023.6.17 18:00,401,219,35,655,0
안락→연산교차로,2023.6.17 18:00,476,0,107,583,0
연산터널→연산교차로,2023.6.17 18:00,249,285,59,593,0
교대→연산교차로,2023.6.17 19:00,305,0,334,639,0
부산시청→연산교차로,2023.6.17 19:00,480,339,225,1044,0
사직운동장→연산교차로,2023.6.17 19:00,187,506,75,768,0
신리→연산교차로,2023.6.17 19:00,317,174,25,516,0
안락→연산교차로,2023.6.17 19:00,424,0,135,559,0
연산터널→연산교차로,2023.6.17 19:00,214,269,64,547,0
교대→연산교차로,2023.6.17 20:00,301,0,301,602,0
부산시청→연산교차로,2023.6.17 20:00,455,307,212,974,0
사직운동장→연산교차로,2023.6.17 20:00,194,489,84,767,0
신리→연산교차로,2023.6.17 20:00,338,170,31,539,0
안락→연산교차로,2023.6.17 20:00,401,0,136,537,0
연산터널→연산교차로,2023.6.17 20:00,230,260,44,534,0
교대→연산교차로,2023.6.17 21:00,278,0,289,567,0
부산시청→연산교차로,2023.6.17 21:00,450,314,215,979,0
사직운동장→연산교차로,2023.6.17 21:00,165,424,90,679,0
신리→연산교차로,2023.6.17 21:00,344,193,17,554,0
안락→연산교차로,2023.6.17 21:00,413,0,120,533,0
연산터널→연산교차로,2023.6.17 21:00,225,251,66,542,0
교대→연산교차로,2023.6.17 22:00,254,0,275,529,0
부산시청→연산교차로,2023.6.17 22:00,413,243,181,837,0
사직운동장→연산교차로,2023.6.17 22:00,135,360,91,586,0
신리→연산교차로,2023.6.17 22:00,330,182,24,536,0
안락→연산교차로,2023.6.17 22:00,372,0,102,474,0
연산터널→연산교차로,2023.6.17 22:00,200,224,74,498,0
교대→연산교차로,2023.6.17 23:00,42,0,50,92,0
부산시청→연산교차로,2023.6.17 23:00,52,25,23,100,0
사직운동장→연산교차로,2023.6.17 23:00,16,66,14,96,0
신리→연산교차로,2023.6.17 23:00,33,27,6,66,0
안락→연산교차로,2023.6.17 23:00,49,0,23,72,0
연산터널→연산교차로,2023.6.17 23:00,32,38,15,85,0
교대→연산교차로,2023.6.18 00:00,201,0,236,437,1
부산시청→연산교차로,2023.6.18 00:00,303,206,131,640,1
사직운동장→연산교차로,2023.6.18 00:00,102,251,78,431,1
신리→연산교차로,2023.6.18 00:00,218,106,30,354,1
안락→연산교차로,2023.6.18 00:00,272,0,72,344,1
연산터널→연산교차로,2023.6.18 00:00,190,197,53,440,1
교대→연산교차로,2023.6.18 01:00,167,0,205,372,1
부산시청→연산교차로,2023.6.18 01:00,289,173,122,584,1
사직운동장→연산교차로,2023.6.18 01:00,81,223,62,366,1
신리→연산교차로,2023.6.18 01:00,181,102,16,299,1
안락→연산교차로,2023.6.18 01:00,214,0,40,254,1
연산터널→연산교차로,2023.6.18 01:00,126,152,44,322,1
교대→연산교차로,2023.6.18 02:00,115,0,190,305,1
부산시청→연산교차로,2023.6.18 02:00,243,146,79,468,1
사직운동장→연산교차로,2023.6.18 02:00,62,196,60,318,1
신리→연산교차로,2023.6.18 02:00,137,79,16,232,1
안락→연산교차로,2023.6.18 02:00,183,0,42,225,1
연산터널→연산교차로,2023.6.18 02:00,137,166,43,346,1
교대→연산교차로,2023.6.18 03:00,93,0,138,231,1
부산시청→연산교차로,2023.6.18 03:00,203,93,67,363,1
사직운동장→연산교차로,2023.6.18 03:00,50,149,46,245,1
신리→연산교차로,2023.6.18 03:00,95,55,11,161,1
안락→연산교차로,2023.6.18 03:00,142,0,34,176,1
연산터널→연산교차로,2023.6.18 03:00,104,128,45,277,1
교대→연산교차로,2023.6.18 04:00,76,0,91,167,1
부산시청→연산교차로,2023.6.18 04:00,161,93,63,317,1
사직운동장→연산교차로,2023.6.18 04:00,50,125,37,212,1
신리→연산교차로,2023.6.18 04:00,84,60,10,154,1
안락→연산교차로,2023.6.18 04:00,144,0,44,188,1
연산터널→연산교차로,2023.6.18 04:00,108,107,23,238,1
교대→연산교차로,2023.6.18 05:00,55,0,104,159,1
부산시청→연산교차로,2023.6.18 05:00,171,93,56,320,1
사직운동장→연산교차로,2023.6.18 05:00,53,116,31,200,1
신리→연산교차로,2023.6.18 05:00,141,56,9,206,1
안락→연산교차로,2023.6.18 05:00,157,0,41,198,1
연산터널→연산교차로,2023.6.18 05:00,93,117,28,238,1
교대→연산교차로,2023.6.18 06:00,97,0,123,220,1
부산시청→연산교차로,2023.6.18 06:00,192,146,71,409,1
사직운동장→연산교차로,2023.6.18 06:00,60,158,40,258,1
신리→연산교차로,2023.6.18 06:00,181,66,6,253,1
안락→연산교차로,2023.6.18 06:00,236,0,48,284,1
연산터널→연산교차로,2023.6.18 06:00,117,106,29,252,1
교대→연산교차로,2023.6.18 07:00,127,0,157,284,1
부산시청→연산교차로,2023.6.18 07:00,230,166,73,469,1
사직운동장→연산교차로,2023.6.18 07:00,64,195,39,298,1
신리→연산교차로,2023.6.18 07:00,185,82,10,277,1
안락→연산교차로,2023.6.18 07:00,255,0,55,310,1
연산터널→연산교차로,2023.6.18 07:00,133,137,30,300,1
교대→연산교차로,2023.6.18 08:00,190,0,163,353,1
부산시청→연산교차로,2023.6.18 08:00,245,220,104,569,1
사직운동장→연산교차로,2023.6.18 08:00,108,276,42,426,1
신리→연산교차로,2023.6.18 08:00,259,137,13,409,1
안락→연산교차로,2023.6.18 08:00,358,0,70,428,1
연산터널→연산교차로,2023.6.18 08:00,166,131,44,341,1
교대→연산교차로,2023.6.18 09:00,199,0,233,432,1
부산시청→연산교차로,2023.6.18 09:00,398,282,147,827,1
사직운동장→연산교차로,2023.6.18 09:00,141,370,37,548,1
신리→연산교차로,2023.6.18 09:00,381,224,12,617,1
안락→연산교차로,2023.6.18 09:00,406,0,97,503,1
연산터널→연산교차로,2023.6.18 09:00,258,212,29,499,1
교대→연산교차로,2023.6.18 10:00,274,0,298,572,1
부산시청→연산교차로,2023.6.18 10:00,454,316,154,924,1
사직운동장→연산교차로,2023.6.18 10:00,187,525,37,749,1
신리→연산교차로,2023.6.18 10:00,407,204,31,642,1
안락→연산교차로,2023.6.18 10:00,508,0,96,604,1
연산터널→연산교차로,2023.6.18 10:00,246,259,38,543,1
교대→연산교차로,2023.6.18 11:00,255,0,368,623,1
부산시청→연산교차로,2023.6.18 11:00,403,325,197,925,1
사직운동장→연산교차로,2023.6.18 11:00,194,483,50,727,1
신리→연산교차로,2023.6.18 11:00,444,185,22,651,1
안락→연산교차로,2023.6.18 11:00,493,0,127,620,1
연산터널→연산교차로,2023.6.18 11:00,258,232,47,537,1
교대→연산교차로,2023.6.18 12:00,285,0,372,657,1
부산시청→연산교차로,2023.6.18 12:00,479,358,192,1029,1
사직운동장→연산교차로,2023.6.18 12:00,191,535,50,776,1
신리→연산교차로,2023.6.18 12:00,412,194,46,652,1
안락→연산교차로,2023.6.18 12:00,544,0,113,657,1
연산터널→연산교차로,2023.6.18 12:00,269,258,37,564,1
교대→연산교차로,2023.6.18 13:00,312,0,380,692,1
부산시청→연산교차로,2023.6.18 13:00,512,364,202,1078,1
사직운동장→연산교차로,2023.6.18 13:00,229,524,53,806,1
신리→연산교차로,2023.6.18 13:00,379,217,25,621,1
안락→연산교차로,2023.6.18 13:00,550,0,119,669,1
연산터널→연산교차로,2023.6.18 13:00,279,260,46,585,1
교대→연산교차로,2023.6.18 14:00,306,0,328,634,1
부산시청→연산교차로,2023.6.18 14:00,527,368,209,1104,1
사직운동장→연산교차로,2023.6.18 14:00,201,521,59,781,1
신리→연산교차로,2023.6.18 14:00,386,202,41,629,1
안락→연산교차로,2023.6.18 14:00,495,0,124,619,1
연산터널→연산교차로,2023.6.18 14:00,248,236,50,534,1
교대→연산교차로,2023.6.18 15:00,291,0,357,648,1
부산시청→연산교차로,2023.6.18 15:00,510,359,205,1074,1
사직운동장→연산교차로,2023.6.18 15:00,229,536,61,826,1
신리→연산교차로,2023.6.18 15:00,423,207,40,670,1
안락→연산교차로,2023.6.18 15:00,501,0,111,612,1
연산터널→연산교차로,2023.6.18 15:00,223,237,44,504,1
교대→연산교차로,2023.6.18 16:00,306,0,318,624,1
부산시청→연산교차로,2023.6.18 16:00,504,311,218,1033,1
사직운동장→연산교차로,2023.6.18 16:00,212,503,48,763,1
신리→연산교차로,2023.6.18 16:00,403,191,30,624,1
안락→연산교차로,2023.6.18 16:00,519,0,117,636,1
연산터널→연산교차로,2023.6.18 16:00,240,260,53,553,1
교대→연산교차로,2023.6.18 17:00,287,0,299,586,1
부산시청→연산교차로,2023.6.18 17:00,487,339,208,1034,1
사직운동장→연산교차로,2023.6.18 17:00,212,505,56,773,1
신리→연산교차로,2023.6.18 17:00,416,182,29,627,1
안락→연산교차로,2023.6.18 17:00,506,0,130,636,1
연산터널→연산교차로,2023.6.18 17:00,247,268,39,554,1
교대→연산교차로,2023.6.18 18:00,298,0,320,618,1
부산시청→연산교차로,2023.6.18 18:00,446,271,205,922,1
사직운동장→연산교차로,2023.6.18 18:00,168,442,61,671,1
신리→연산교차로,2023.6.18 18:00,334,191,31,556,1
안락→연산교차로,2023.6.18 18:00,451,0,107,558,1
연산터널→연산교차로,2023.6.18 18:00,189,225,58,472,1
교대→연산교차로,2023.6.18 19:00,282,0,251,533,1
부산시청→연산교차로,2023.6.18 19:00,421,275,171,867,1
사직운동장→연산교차로,2023.6.18 19:00,130,384,58,572,1
신리→연산교차로,2023.6.18 19:00,307,141,29,477,1
안락→연산교차로,2023.6.18 19:00,390,0,97,487,1
연산터널→연산교차로,2023.6.18 19:00,199,221,50,470,1
교대→연산교차로,2023.6.18 20:00,276,0,225,501,1
부산시청→연산교차로,2023.6.18 20:00,377,264,164,805,1
사직운동장→연산교차로,2023.6.18 20:00,154,365,43,562,1
신리→연산교차로,2023.6.18 20:00,343,154,24,521,1
안락→연산교차로,2023.6.18 20:00,374,0,105,479,1
연산터널→연산교차로,2023.6.18 20:00,201,202,42,445,1
교대→연산교차로,2023.6.18 21:00,253,0,244,497,1
부산시청→연산교차로,2023.6.18 21:00,364,244,152,760,1
사직운동장→연산교차로,2023.6.18 21:00,130,332,59,521,1
신리→연산교차로,2023.6.18 21:00,302,147,29,478,1
안락→연산교차로,2023.6.18 21:00,338,0,81,419,1
연산터널→연산교차로,2023.6.18 21:00,197,202,59,458,1
교대→연산교차로,2023.6.18 22:00,187,0,194,381,1
부산시청→연산교차로,2023.6.18 22:00,341,189,106,636,1
사직운동장→연산교차로,2023.6.18 22:00,93,313,71,477,1
신리→연산교차로,2023.6.18 22:00,237,109,23,369,1
안락→연산교차로,2023.6.18 22:00,255,0,54,309,1
연산터널→연산교차로,2023.6.18 22:00,148,146,48,342,1
교대→연산교차로,2023.6.18 23:00,123,0,151,274,1
부산시청→연산교차로,2023.6.18 23:00,242,143,105,490,1
사직운동장→연산교차로,2023.6.18 23:00,89,230,70,389,1
신리→연산교차로,2023.6.18 23:00,165,90,14,269,1
안락→연산교차로,2023.6.18 23:00,239,0,59,298,1
연산터널→연산교차로,2023.6.18 23:00,131,151,58,340,1
교대→연산교차로,2023.6.19 00:00,94,0,130,224,0
부산시청→연산교차로,2023.6.19 00:00,193,114,81,388,0
사직운동장→연산교차로,2023.6.19 00:00,55,167,54,276,0
신리→연산교차로,2023.6.19 00:00,124,87,19,230,0
안락→연산교차로,2023.6.19 00:00,171,0,38,209,0
연산터널→연산교차로,2023.6.19 00:00,123,132,49,304,0
교대→연산교차로,2023.6.19 01:00,80,0,90,170,0
부산시청→연산교차로,2023.6.19 01:00,165,100,61,326,0
사직운동장→연산교차로,2023.6.19 01:00,33,120,49,202,0
신리→연산교차로,2023.6.19 01:00,94,47,18,159,0
안락→연산교차로,2023.6.19 01:00,137,0,37,174,0
연산터널→연산교차로,2023.6.19 01:00,76,99,38,213,0
교대→연산교차로,2023.6.19 02:00,50,0,67,117,0
부산시청→연산교차로,2023.6.19 02:00,123,57,49,229,0
사직운동장→연산교차로,2023.6.19 02:00,47,99,33,179,0
신리→연산교차로,2023.6.19 02:00,69,28,12,109,0
안락→연산교차로,2023.6.19 02:00,130,0,25,155,0
연산터널→연산교차로,2023.6.19 02:00,76,77,35,188,0
교대→연산교차로,2023.6.19 03:00,36,0,52,88,0
부산시청→연산교차로,2023.6.19 03:00,116,63,38,217,0
사직운동장→연산교차로,2023.6.19 03:00,35,102,26,163,0
신리→연산교차로,2023.6.19 03:00,52,26,11,89,0
안락→연산교차로,2023.6.19 03:00,90,0,15,105,0
연산터널→연산교차로,2023.6.19 03:00,48,70,32,150,0
교대→연산교차로,2023.6.19 04:00,43,0,69,112,0
부산시청→연산교차로,2023.6.19 04:00,130,67,41,238,0
사직운동장→연산교차로,2023.6.19 04:00,18,85,25,128,0
신리→연산교차로,2023.6.19 04:00,85,56,6,147,0
안락→연산교차로,2023.6.19 04:00,169,0,31,200,0
연산터널→연산교차로,2023.6.19 04:00,63,69,23,155,0
교대→연산교차로,2023.6.19 05:00,98,0,144,242,0
부산시청→연산교차로,2023.6.19 05:00,236,167,72,475,0
사직운동장→연산교차로,2023.6.19 05:00,62,180,26,268,0
신리→연산교차로,2023.6.19 05:00,228,79,9,316,0
안락→연산교차로,2023.6.19 05:00,323,0,55,378,0
연산터널→연산교차로,2023.6.19 05:00,128,143,20,291,0
교대→연산교차로,2023.6.19 06:00,171,0,247,418,0
부산시청→연산교차로,2023.6.19 06:00,391,263,141,795,0
사직운동장→연산교차로,2023.6.19 06:00,114,289,44,447,0
신리→연산교차로,2023.6.19 06:00,341,174,24,539,0
안락→연산교차로,2023.6.19 06:00,546,0,72,618,0
연산터널→연산교차로,2023.6.19 06:00,245,244,33,522,0
교대→연산교차로,2023.6.19 07:00,254,0,412,666,0
부산시청→연산교차로,2023.6.19 07:00,591,374,269,1234,0
사직운동장→연산교차로,2023.6.19 07:00,221,511,50,782,0
신리→연산교차로,2023.6.19 07:00,465,242,30,737,0
안락→연산교차로,2023.6.19 07:00,650,0,60,710,0
연산터널→연산교차로,2023.6.19 07:00,283,388,42,713,0
교대→연산교차로,2023.6.19 08:00,336,0,498,834,0
부산시청→연산교차로,2023.6.19 08:00,567,428,411,1406,0
사직운동장→연산교차로,2023.6.19 08:00,273,651,73,997,0
신리→연산교차로,2023.6.19 08:00,527,344,33,904,0
안락→연산교차로,2023.6.19 08:00,624,0,110,734,0
연산터널→연산교차로,2023.6.19 08:00,331,370,42,743,0
교대→연산교차로,2023.6.19 09:00,296,0,520,816,0
부산시청→연산교차로,2023.6.19 09:00,510,390,279,1179,0
사직운동장→연산교차로,2023.6.19 09:00,275,585,93,953,0
신리→연산교차로,2023.6.19 09:00,441,329,49,819,0
안락→연산교차로,2023.6.19 09:00,636,0,94,730,0
연산터널→연산교차로,2023.6.19 09:00,296,370,45,711,0
교대→연산교차로,2023.6.19 10:00,311,0,436,747,0
부산시청→연산교차로,2023.6.19 10:00,518,357,265,1140,0
사직운동장→연산교차로,2023.6.19 10:00,317,539,58,914,0
신리→연산교차로,2023.6.19 10:00,495,273,61,829,0
안락→연산교차로,2023.6.19 10:00,599,0,143,742,0
연산터널→연산교차로,2023.6.19 10:00,284,327,55,666,0
교대→연산교차로,2023.6.19 11:00,302,0,468,770,0
부산시청→연산교차로,2023.6.19 11:00,546,354,267,1167,0
사직운동장→연산교차로,2023.6.19 11:00,303,576,85,964,0
신리→연산교차로,2023.6.19 11:00,446,260,62,768,0
안락→연산교차로,2023.6.19 11:00,529,0,145,674,0
연산터널→연산교차로,2023.6.19 11:00,281,327,64,672,0
교대→연산교차로,2023.6.19 12:00,300,0,343,643,0
부산시청→연산교차로,2023.6.19 12:00,563,343,258,1164,0
사직운동장→연산교차로,2023.6.19 12:00,275,543,89,907,0
신리→연산교차로,2023.6.19 12:00,428,262,56,746,0
안락→연산교차로,2023.6.19 12:00,479,0,144,623,0
연산터널→연산교차로,2023.6.19 12:00,274,292,49,615,0
교대→연산교차로,2023.6.19 13:00,315,0,407,722,0
부산시청→연산교차로,2023.6.19 13:00,585,393,329,1307,0
사직운동장→연산교차로,2023.6.19 13:00,305,552,91,948,0
신리→연산교차로,2023.6.19 13:00,425,263,51,739,0
안락→연산교차로,2023.6.19 13:00,447,0,127,574,0
연산터널→연산교차로,2023.6.19 13:00,257,278,37,572,0
교대→연산교차로,2023.6.19 14:00,340,0,452,792,0
부산시청→연산교차로,2023.6.19 14:00,594,431,265,1290,0
사직운동장→연산교차로,2023.6.19 14:00,270,611,97,978,0
신리→연산교차로,2023.6.19 14:00,441,270,57,768,0
안락→연산교차로,2023.6.19 14:00,469,0,125,594,0
연산터널→연산교차로,2023.6.19 14:00,255,273,44,572,0
교대→연산교차로,2023.6.19 15:00,347,0,475,822,0
부산시청→연산교차로,2023.6.19 15:00,569,475,305,1349,0
사직운동장→연산교차로,2023.6.19 15:00,294,614,84,992,0
신리→연산교차로,2023.6.19 15:00,459,271,57,787,0
안락→연산교차로,2023.6.19 15:00,446,0,123,569,0
연산터널→연산교차로,2023.6.19 15:00,233,292,45,570,0
교대→연산교차로,2023.6.19 16:00,367,0,480,847,0
부산시청→연산교차로,2023.6.19 16:00,609,496,344,1449,0
사직운동장→연산교차로,2023.6.19 16:00,264,678,68,1010,0
신리→연산교차로,2023.6.19 16:00,545,283,45,873,0
안락→연산교차로,2023.6.19 16:00,466,0,120,586,0
연산터널→연산교차로,2023.6.19 16:00,235,281,53,569,0
교대→연산교차로,2023.6.19 17:00,369,0,531,900,0
부산시청→연산교차로,2023.6.19 17:00,619,555,288,1462,0
사직운동장→연산교차로,2023.6.19 17:00,328,689,36,1053,0
신리→연산교차로,2023.6.19 17:00,563,286,49,898,0
안락→연산교차로,2023.6.19 17:00,473,0,98,571,0
연산터널→연산교차로,2023.6.19 17:00,214,286,46,546,0
교대→연산교차로,2023.6.19 18:00,380,0,538,918,0
부산시청→연산교차로,2023.6.19 18:00,613,570,348,1531,0
사직운동장→연산교차로,2023.6.19 18:00,335,646,42,1023,0
신리→연산교차로,2023.6.19 18:00,531,232,67,830,0
안락→연산교차로,2023.6.19 18:00,482,0,96,578,0
연산터널→연산교차로,2023.6.19 18:00,235,286,46,567,0
교대→연산교차로,2023.6.19 19:00,292,0,392,684,0
부산시청→연산교차로,2023.6.19 19:00,510,393,274,1177,0
사직운동장→연산교차로,2023.6.19 19:00,201,480,72,753,0
신리→연산교차로,2023.6.19 19:00,364,206,45,615,0
안락→연산교차로,2023.6.19 19:00,426,0,108,534,0
연산터널→연산교차로,2023.6.19 19:00,199,243,51,493,0
교대→연산교차로,2023.6.19 20:00,268,0,322,590,0
부산시청→연산교차로,2023.6.19 20:00,452,356,224,1032,0
사직운동장→연산교차로,2023.6.19 20:00,165,490,106,761,0
신리→연산교차로,2023.6.19 20:00,278,196,36,510,0
안락→연산교차로,2023.6.19 20:00,382,0,103,485,0
연산터널→연산교차로,2023.6.19 20:00,196,238,63,497,0
교대→연산교차로,2023.6.19 21:00,270,0,300,570,0
부산시청→연산교차로,2023.6.19 21:00,483,328,224,1035,0
사직운동장→연산교차로,2023.6.19 21:00,174,465,79,718,0
신리→연산교차로,2023.6.19 21:00,277,176,39,492,0
안락→연산교차로,2023.6.19 21:00,397,0,93,490,0
연산터널→연산교차로,2023.6.19 21:00,209,262,67,538,0
교대→연산교차로,2023.6.19 22:00,239,0,257,496,0
부산시청→연산교차로,2023.6.19 22:00,402,248,162,812,0
사직운동장→연산교차로,2023.6.19 22:00,162,331,87,580,0
신리→연산교차로,2023.6.19 22:00,260,142,25,427,0
안락→연산교차로,2023.6.19 22:00,317,0,84,401,0
연산터널→연산교차로,2023.6.19 22:00,201,214,49,464,0
교대→연산교차로,2023.6.19 23:00,179,0,198,377,0
부산시청→연산교차로,2023.6.19 23:00,297,169,103,569,0
사직운동장→연산교차로,2023.6.19 23:00,108,279,76,463,0
신리→연산교차로,2023.6.19 23:00,216,113,27,356,0
안락→연산교차로,2023.6.19 23:00,226,0,61,287,0
연산터널→연산교차로,2023.6.19 23:00,155,164,100,419,0
교대→연산교차로,2023.6.20 00:00,135,0,190,325,0
부산시청→연산교차로,2023.6.20 00:00,222,141,106,469,0
사직운동장→연산교차로,2023.6.20 00:00,69,239,64,372,0
신리→연산교차로,2023.6.20 00:00,146,70,11,227,0
안락→연산교차로,2023.6.20 00:00,194,0,53,247,0
연산터널→연산교차로,2023.6.20 00:00,141,160,74,375,0
교대→연산교차로,2023.6.20 01:00,100,0,114,214,0
부산시청→연산교차로,2023.6.20 01:00,177,89,76,342,0
사직운동장→연산교차로,2023.6.20 01:00,51,175,58,284,0
신리→연산교차로,2023.6.20 01:00,102,59,10,171,0
안락→연산교차로,2023.6.20 01:00,140,0,28,168,0
연산터널→연산교차로,2023.6.20 01:00,101,101,61,263,0
교대→연산교차로,2023.6.20 02:00,74,0,89,163,0
부산시청→연산교차로,2023.6.20 02:00,143,78,68,289,0
사직운동장→연산교차로,2023.6.20 02:00,52,135,42,229,0
신리→연산교차로,2023.6.20 02:00,86,40,17,143,0
안락→연산교차로,2023.6.20 02:00,112,0,26,138,0
연산터널→연산교차로,2023.6.20 02:00,81,109,46,236,0
교대→연산교차로,2023.6.20 03:00,49,0,87,136,0
부산시청→연산교차로,2023.6.20 03:00,149,66,44,259,0
사직운동장→연산교차로,2023.6.20 03:00,33,130,34,197,0
신리→연산교차로,2023.6.20 03:00,70,25,9,104,0
안락→연산교차로,2023.6.20 03:00,105,0,34,139,0
연산터널→연산교차로,2023.6.20 03:00,81,92,50,223,0
교대→연산교차로,2023.6.20 04:00,50,0,83,133,0
부산시청→연산교차로,2023.6.20 04:00,161,81,43,285,0
사직운동장→연산교차로,2023.6.20 04:00,38,132,31,201,0
신리→연산교차로,2023.6.20 04:00,97,43,10,150,0
안락→연산교차로,2023.6.20 04:00,162,0,30,192,0
연산터널→연산교차로,2023.6.20 04:00,92,102,42,236,0
교대→연산교차로,2023.6.20 05:00,114,0,137,251,0
부산시청→연산교차로,2023.6.20 05:00,230,146,73,449,0
사직운동장→연산교차로,2023.6.20 05:00,64,197,30,291,0
신리→연산교차로,2023.6.20 05:00,250,90,9,349,0
안락→연산교차로,2023.6.20 05:00,368,0,62,430,0
연산터널→연산교차로,2023.6.20 05:00,152,138,38,328,0
교대→연산교차로,2023.6.20 06:00,168,0,242,410,0
부산시청→연산교차로,2023.6.20 06:00,359,257,111,727,0
사직운동장→연산교차로,2023.6.20 06:00,86,314,54,454,0
신리→연산교차로,2023.6.20 06:00,332,157,30,519,0
안락→연산교차로,2023.6.20 06:00,511,0,96,607,0
연산터널→연산교차로,2023.6.20 06:00,245,268,34,547,0
교대→연산교차로,2023.6.20 07:00,264,0,401,665,0
부산시청→연산교차로,2023.6.20 07:00,551,370,225,1146,0
사직운동장→연산교차로,2023.6.20 07:00,218,496,60,774,0
신리→연산교차로,2023.6.20 07:00,468,247,37,752,0
안락→연산교차로,2023.6.20 07:00,640,0,68,708,0
연산터널→연산교차로,2023.6.20 07:00,281,374,41,696,0
교대→연산교차로,2023.6.20 08:00,323,0,472,795,0
부산시청→연산교차로,2023.6.20 08:00,579,427,333,1339,0
사직운동장→연산교차로,2023.6.20 08:00,291,640,76,1007,0
신리→연산교차로,2023.6.20 08:00,528,333,28,889,0
안락→연산교차로,2023.6.20 08:00,659,0,96,755,0
연산터널→연산교차로,2023.6.20 08:00,304,390,34,728,0
교대→연산교차로,2023.6.20 09:00,306,0,543,849,0
부산시청→연산교차로,2023.6.20 09:00,534,379,282,1195,0
사직운동장→연산교차로,2023.6.20 09:00,248,583,97,928,0
신리→연산교차로,2023.6.20 09:00,492,340,55,887,0
안락→연산교차로,2023.6.20 09:00,627,0,92,719,0
연산터널→연산교차로,2023.6.20 09:00,296,384,40,720,0
교대→연산교차로,2023.6.20 10:00,285,0,462,747,0
부산시청→연산교차로,2023.6.20 10:00,556,368,258,1182,0
사직운동장→연산교차로,2023.6.20 10:00,277,563,55,895,0
신리→연산교차로,2023.6.20 10:00,425,305,58,788,0
안락→연산교차로,2023.6.20 10:00,605,0,141,746,0
연산터널→연산교차로,2023.6.20 10:00,304,344,45,693,0
교대→연산교차로,2023.6.20 11:00,300,0,418,718,0
부산시청→연산교차로,2023.6.20 11:00,577,380,260,1217,0
사직운동장→연산교차로,2023.6.20 11:00,318,575,70,963,0
신리→연산교차로,2023.6.20 11:00,462,250,51,763,0
안락→연산교차로,2023.6.20 11:00,568,0,148,716,0
연산터널→연산교차로,2023.6.20 11:00,288,350,53,691,0
교대→연산교차로,2023.6.20 12:00,294,0,410,704,0
부산시청→연산교차로,2023.6.20 12:00,538,364,229,1131,0
사직운동장→연산교차로,2023.6.20 12:00,282,515,59,856,0
신리→연산교차로,2023.6.20 12:00,435,208,51,694,0
안락→연산교차로,2023.6.20 12:00,500,0,139,639,0
연산터널→연산교차로,2023.6.20 12:00,268,266,62,596,0
교대→연산교차로,2023.6.20 13:00,325,0,462,787,0
부산시청→연산교차로,2023.6.20 13:00,582,387,262,1231,0
사직운동장→연산교차로,2023.6.20 13:00,275,546,108,929,0
신리→연산교차로,2023.6.20 13:00,408,234,53,695,0
안락→연산교차로,2023.6.20 13:00,481,0,110,591,0
연산터널→연산교차로,2023.6.20 13:00,238,291,40,569,0
교대→연산교차로,2023.6.20 14:00,351,0,432,783,0
부산시청→연산교차로,2023.6.20 14:00,629,433,281,1343,0
사직운동장→연산교차로,2023.6.20 14:00,321,606,100,1027,0
신리→연산교차로,2023.6.20 14:00,482,270,50,802,0
안락→연산교차로,2023.6.20 14:00,446,0,130,576,0
연산터널→연산교차로,2023.6.20 14:00,229,283,61,573,0
교대→연산교차로,2023.6.20 15:00,362,0,526,888,0
부산시청→연산교차로,2023.6.20 15:00,577,502,301,1380,0
사직운동장→연산교차로,2023.6.20 15:00,288,651,99,1038,0
신리→연산교차로,2023.6.20 15:00,433,259,49,741,0
안락→연산교차로,2023.6.20 15:00,481,0,107,588,0
연산터널→연산교차로,2023.6.20 15:00,234,265,44,543,0
교대→연산교차로,2023.6.20 16:00,366,0,511,877,0
부산시청→연산교차로,2023.6.20 16:00,644,507,292,1443,0
사직운동장→연산교차로,2023.6.20 16:00,327,664,64,1055,0
신리→연산교차로,2023.6.20 16:00,547,288,65,900,0
안락→연산교차로,2023.6.20 16:00,481,0,108,589,0
연산터널→연산교차로,2023.6.20 16:00,240,296,32,568,0
교대→연산교차로,2023.6.20 17:00,374,0,514,888,0
부산시청→연산교차로,2023.6.20 17:00,655,545,295,1495,0
사직운동장→연산교차로,2023.6.20 17:00,334,709,67,1110,0
신리→연산교차로,2023.6.20 17:00,554,289,61,904,0
안락→연산교차로,2023.6.20 17:00,464,0,108,572,0
연산터널→연산교차로,2023.6.20 17:00,248,254,43,545,0
교대→연산교차로,2023.6.20 18:00,368,0,571,939,0
부산시청→연산교차로,2023.6.20 18:00,608,562,349,1519,0
사직운동장→연산교차로,2023.6.20 18:00,345,652,68,1065,0
신리→연산교차로,2023.6.20 18:00,546,252,44,842,0
안락→연산교차로,2023.6.20 18:00,488,0,108,596,0
연산터널→연산교차로,2023.6.20 18:00,237,274,73,584,0
교대→연산교차로,2023.6.20 19:00,304,0,365,669,0
부산시청→연산교차로,2023.6.20 19:00,532,407,260,1199,0
사직운동장→연산교차로,2023.6.20 19:00,225,529,68,822,0
신리→연산교차로,2023.6.20 19:00,354,207,47,608,0
안락→연산교차로,2023.6.20 19:00,441,0,101,542,0
연산터널→연산교차로,2023.6.20 19:00,226,257,56,539,0
교대→연산교차로,2023.6.20 20:00,318,0,318,636,0
부산시청→연산교차로,2023.6.20 20:00,521,365,258,1144,0
사직운동장→연산교차로,2023.6.20 20:00,171,505,88,764,0
신리→연산교차로,2023.6.20 20:00,298,165,34,497,0
안락→연산교차로,2023.6.20 20:00,389,0,99,488,0
연산터널→연산교차로,2023.6.20 20:00,225,232,60,517,0
교대→연산교차로,2023.6.20 21:00,279,0,315,594,0
부산시청→연산교차로,2023.6.20 21:00,496,335,223,1054,0
사직운동장→연산교차로,2023.6.20 21:00,175,432,85,692,0
신리→연산교차로,2023.6.20 21:00,254,164,29,447,0
안락→연산교차로,2023.6.20 21:00,452,0,113,565,0
연산터널→연산교차로,2023.6.20 21:00,248,282,69,599,0
교대→연산교차로,2023.6.20 22:00,242,0,234,476,0
부산시청→연산교차로,2023.6.20 22:00,403,270,170,843,0
사직운동장→연산교차로,2023.6.20 22:00,141,371,88,600,0
신리→연산교차로,2023.6.20 22:00,264,148,18,430,0
안락→연산교차로,2023.6.20 22:00,359,0,92,451,0
연산터널→연산교차로,2023.6.20 22:00,226,257,68,551,0
교대→연산교차로,2023.6.20 23:00,192,0,170,362,0
부산시청→연산교차로,2023.6.20 23:00,329,229,140,698,0
사직운동장→연산교차로,2023.6.20 23:00,107,261,65,433,0
신리→연산교차로,2023.6.20 23:00,185,118,25,328,0
안락→연산교차로,2023.6.20 23:00,255,0,76,331,0
연산터널→연산교차로,2023.6.20 23:00,144,183,53,380,0
교대→연산교차로,2023.6.21 00:00,124,0,161,285,0
부산시청→연산교차로,2023.6.21 00:00,252,158,94,504,0
사직운동장→연산교차로,2023.6.21 00:00,64,224,62,350,0
신리→연산교차로,2023.6.21 00:00,148,88,14,250,0
안락→연산교차로,2023.6.21 00:00,208,0,65,273,0
연산터널→연산교차로,2023.6.21 00:00,140,190,60,390,0
교대→연산교차로,2023.6.21 01:00,86,0,112,198,0
부산시청→연산교차로,2023.6.21 01:00,195,122,66,383,0
사직운동장→연산교차로,2023.6.21 01:00,79,170,11,260,0
신리→연산교차로,2023.6.21 01:00,107,80,18,205,0
안락→연산교차로,2023.6.21 01:00,126,0,49,175,0
연산터널→연산교차로,2023.6.21 01:00,115,138,28,281,0
교대→연산교차로,2023.6.21 02:00,78,0,86,164,0
부산시청→연산교차로,2023.6.21 02:00,177,96,67,340,0
사직운동장→연산교차로,2023.6.21 02:00,60,137,5,202,0
신리→연산교차로,2023.6.21 02:00,78,42,9,129,0
안락→연산교차로,2023.6.21 02:00,118,0,38,156,0
연산터널→연산교차로,2023.6.21 02:00,94,120,14,228,0
교대→연산교차로,2023.6.21 03:00,55,0,54,109,0
부산시청→연산교차로,2023.6.21 03:00,134,61,41,236,0
사직운동장→연산교차로,2023.6.21 03:00,42,109,13,164,0
신리→연산교차로,2023.6.21 03:00,75,46,7,128,0
안락→연산교차로,2023.6.21 03:00,107,0,26,133,0
연산터널→연산교차로,2023.6.21 03:00,76,95,16,187,0
교대→연산교차로,2023.6.21 04:00,40,0,54,94,0
부산시청→연산교차로,2023.6.21 04:00,94,53,46,193,0
사직운동장→연산교차로,2023.6.21 04:00,38,117,7,162,0
신리→연산교차로,2023.6.21 04:00,73,36,3,112,0
안락→연산교차로,2023.6.21 04:00,144,0,29,173,0
연산터널→연산교차로,2023.6.21 04:00,66,73,8,147,0
교대→연산교차로,2023.6.21 05:00,100,0,111,211,0
부산시청→연산교차로,2023.6.21 05:00,179,128,48,355,0
사직운동장→연산교차로,2023.6.21 05:00,46,147,26,219,0
신리→연산교차로,2023.6.21 05:00,159,78,8,245,0
안락→연산교차로,2023.6.21 05:00,283,0,39,322,0
연산터널→연산교차로,2023.6.21 05:00,125,132,20,277,0
교대→연산교차로,2023.6.21 06:00,153,0,235,388,0
부산시청→연산교차로,2023.6.21 06:00,347,233,124,704,0
사직운동장→연산교차로,2023.6.21 06:00,93,261,46,400,0
신리→연산교차로,2023.6.21 06:00,314,155,21,490,0
안락→연산교차로,2023.6.21 06:00,475,0,73,548,0
연산터널→연산교차로,2023.6.21 06:00,202,201,32,435,0
교대→연산교차로,2023.6.21 07:00,251,0,384,635,0
부산시청→연산교차로,2023.6.21 07:00,520,358,173,1051,0
사직운동장→연산교차로,2023.6.21 07:00,195,459,54,708,0
신리→연산교차로,2023.6.21 07:00,487,229,23,739,0
안락→연산교차로,2023.6.21 07:00,611,0,79,690,0
연산터널→연산교차로,2023.6.21 07:00,289,344,42,675,0
교대→연산교차로,2023.6.21 08:00,307,0,440,747,0
부산시청→연산교차로,2023.6.21 08:00,559,427,307,1293,0
사직운동장→연산교차로,2023.6.21 08:00,234,635,53,922,0
신리→연산교차로,2023.6.21 08:00,510,320,22,852,0
안락→연산교차로,2023.6.21 08:00,617,0,121,738,0
연산터널→연산교차로,2023.6.21 08:00,299,356,34,689,0
교대→연산교차로,2023.6.21 09:00,279,0,480,759,0
부산시청→연산교차로,2023.6.21 09:00,513,363,302,1178,0
사직운동장→연산교차로,2023.6.21 09:00,238,591,88,917,0
신리→연산교차로,2023.6.21 09:00,407,330,40,777,0
안락→연산교차로,2023.6.21 09:00,566,0,101,667,0
연산터널→연산교차로,2023.6.21 09:00,262,352,39,653,0
교대→연산교차로,2023.6.21 10:00,277,0,508,785,0
부산시청→연산교차로,2023.6.21 10:00,508,358,254,1120,0
사직운동장→연산교차로,2023.6.21 10:00,223,552,66,841,0
신리→연산교차로,2023.6.21 10:00,448,290,51,789,0
안락→연산교차로,2023.6.21 10:00,526,0,113,639,0
연산터널→연산교차로,2023.6.21 10:00,281,336,38,655,0
교대→연산교차로,2023.6.21 11:00,300,0,466,766,0
부산시청→연산교차로,2023.6.21 11:00,586,369,265,1220,0
사직운동장→연산교차로,2023.6.21 11:00,321,553,72,946,0
신리→연산교차로,2023.6.21 11:00,425,252,56,733,0
안락→연산교차로,2023.6.21 11:00,526,0,143,669,0
연산터널→연산교차로,2023.6.21 11:00,280,318,54,652,0
교대→연산교차로,2023.6.21 12:00,275,0,423,698,0
부산시청→연산교차로,2023.6.21 12:00,527,355,220,1102,0
사직운동장→연산교차로,2023.6.21 12:00,251,540,74,865,0
신리→연산교차로,2023.6.21 12:00,405,230,56,691,0
안락→연산교차로,2023.6.21 12:00,506,0,132,638,0
연산터널→연산교차로,2023.6.21 12:00,265,247,44,556,0
교대→연산교차로,2023.6.21 13:00,330,0,447,777,0
부산시청→연산교차로,2023.6.21 13:00,558,438,268,1264,0
사직운동장→연산교차로,2023.6.21 13:00,302,587,81,970,0
신리→연산교차로,2023.6.21 13:00,454,256,52,762,0
안락→연산교차로,2023.6.21 13:00,453,0,125,578,0
연산터널→연산교차로,2023.6.21 13:00,253,287,33,573,0
교대→연산교차로,2023.6.21 14:00,343,0,473,816,0
부산시청→연산교차로,2023.6.21 14:00,542,430,284,1256,0
사직운동장→연산교차로,2023.6.21 14:00,276,561,95,932,0
신리→연산교차로,2023.6.21 14:00,472,301,60,833,0
안락→연산교차로,2023.6.21 14:00,438,0,125,563,0
연산터널→연산교차로,2023.6.21 14:00,254,262,52,568,0
교대→연산교차로,2023.6.21 15:00,344,0,445,789,0
부산시청→연산교차로,2023.6.21 15:00,535,440,270,1245,0
사직운동장→연산교차로,2023.6.21 15:00,342,608,72,1022,0
신리→연산교차로,2023.6.21 15:00,460,275,55,790,0
안락→연산교차로,2023.6.21 15:00,449,0,112,561,0
연산터널→연산교차로,2023.6.21 15:00,237,294,43,574,0
교대→연산교차로,2023.6.21 16:00,360,0,457,817,0
부산시청→연산교차로,2023.6.21 16:00,515,471,271,1257,0
사직운동장→연산교차로,2023.6.21 16:00,307,631,67,1005,0
신리→연산교차로,2023.6.21 16:00,487,286,59,832,0
안락→연산교차로,2023.6.21 16:00,478,0,104,582,0
연산터널→연산교차로,2023.6.21 16:00,271,276,42,589,0
교대→연산교차로,2023.6.21 17:00,369,0,510,879,0
부산시청→연산교차로,2023.6.21 17:00,547,502,257,1306,0
사직운동장→연산교차로,2023.6.21 17:00,344,699,44,1087,0
신리→연산교차로,2023.6.21 17:00,502,286,50,838,0
안락→연산교차로,2023.6.21 17:00,451,0,97,548,0
연산터널→연산교차로,2023.6.21 17:00,224,267,39,530,0
교대→연산교차로,2023.6.21 18:00,383,0,559,942,0
부산시청→연산교차로,2023.6.21 18:00,592,572,348,1512,0
사직운동장→연산교차로,2023.6.21 18:00,341,691,39,1071,0
신리→연산교차로,2023.6.21 18:00,512,235,52,799,0
안락→연산교차로,2023.6.21 18:00,476,0,101,577,0
연산터널→연산교차로,2023.6.21 18:00,242,277,55,574,0
교대→연산교차로,2023.6.21 19:00,325,0,354,679,0
부산시청→연산교차로,2023.6.21 19:00,496,422,244,1162,0
사직운동장→연산교차로,2023.6.21 19:00,199,543,73,815,0
신리→연산교차로,2023.6.21 19:00,334,204,38,576,0
안락→연산교차로,2023.6.21 19:00,390,0,76,466,0
연산터널→연산교차로,2023.6.21 19:00,210,262,41,513,0
교대→연산교차로,2023.6.21 20:00,297,0,309,606,0
부산시청→연산교차로,2023.6.21 20:00,498,361,233,1092,0
사직운동장→연산교차로,2023.6.21 20:00,183,471,88,742,0
신리→연산교차로,2023.6.21 20:00,323,176,36,535,0
안락→연산교차로,2023.6.21 20:00,402,0,97,499,0
연산터널→연산교차로,2023.6.21 20:00,192,256,47,495,0
교대→연산교차로,2023.6.21 21:00,267,0,287,554,0
부산시청→연산교차로,2023.6.21 21:00,514,313,193,1020,0
사직운동장→연산교차로,2023.6.21 21:00,169,452,95,716,0
신리→연산교차로,2023.6.21 21:00,307,184,29,520,0
안락→연산교차로,2023.6.21 21:00,401,0,119,520,0
연산터널→연산교차로,2023.6.21 21:00,224,244,68,536,0
교대→연산교차로,2023.6.21 22:00,255,0,235,490,0
부산시청→연산교차로,2023.6.21 22:00,416,267,177,860,0
사직운동장→연산교차로,2023.6.21 22:00,167,317,79,563,0
신리→연산교차로,2023.6.21 22:00,264,131,27,422,0
안락→연산교차로,2023.6.21 22:00,365,0,99,464,0
연산터널→연산교차로,2023.6.21 22:00,186,197,66,449,0
교대→연산교차로,2023.6.21 23:00,182,0,206,388,0
부산시청→연산교차로,2023.6.21 23:00,345,188,130,663,0
사직운동장→연산교차로,2023.6.21 23:00,106,284,75,465,0
신리→연산교차로,2023.6.21 23:00,202,130,23,355,0
안락→연산교차로,2023.6.21 23:00,257,0,63,320,0
연산터널→연산교차로,2023.6.21 23:00,163,214,85,462,0
교대→연산교차로,2023.6.22 00:00,143,0,169,312,0
부산시청→연산교차로,2023.6.22 00:00,267,153,113,533,0
사직운동장→연산교차로,2023.6.22 00:00,98,218,60,376,0
신리→연산교차로,2023.6.22 00:00,159,90,20,269,0
안락→연산교차로,2023.6.22 00:00,210,0,57,267,0
연산터널→연산교차로,2023.6.22 00:00,132,156,72,360,0
교대→연산교차로,2023.6.22 01:00,102,0,128,230,0
부산시청→연산교차로,2023.6.22 01:00,208,119,88,415,0
사직운동장→연산교차로,2023.6.22 01:00,61,162,55,278,0
신리→연산교차로,2023.6.22 01:00,98,63,20,181,0
안락→연산교차로,2023.6.22 01:00,148,0,39,187,0
연산터널→연산교차로,2023.6.22 01:00,122,135,71,328,0
교대→연산교차로,2023.6.22 02:00,80,0,91,171,0
부산시청→연산교차로,2023.6.22 02:00,146,85,76,307,0
사직운동장→연산교차로,2023.6.22 02:00,40,170,35,245,0
신리→연산교차로,2023.6.22 02:00,100,46,16,162,0
안락→연산교차로,2023.6.22 02:00,122,0,31,153,0
연산터널→연산교차로,2023.6.22 02:00,102,119,43,264,0
교대→연산교차로,2023.6.22 03:00,59,0,94,153,0
부산시청→연산교차로,2023.6.22 03:00,142,62,54,258,0
사직운동장→연산교차로,2023.6.22 03:00,43,134,21,198,0
신리→연산교차로,2023.6.22 03:00,78,43,10,131,0
안락→연산교차로,2023.6.22 03:00,126,0,32,158,0
연산터널→연산교차로,2023.6.22 03:00,71,98,35,204,0
교대→연산교차로,2023.6.22 04:00,50,0,79,129,0
부산시청→연산교차로,2023.6.22 04:00,175,80,50,305,0
사직운동장→연산교차로,2023.6.22 04:00,36,119,28,183,0
신리→연산교차로,2023.6.22 04:00,95,54,12,161,0
안락→연산교차로,2023.6.22 04:00,153,0,34,187,0
연산터널→연산교차로,2023.6.22 04:00,89,107,22,218,0
교대→연산교차로,2023.6.22 05:00,123,0,142,265,0
부산시청→연산교차로,2023.6.22 05:00,246,164,76,486,0
사직운동장→연산교차로,2023.6.22 05:00,72,187,33,292,0
신리→연산교차로,2023.6.22 05:00,213,97,14,324,0
안락→연산교차로,2023.6.22 05:00,336,0,71,407,0
연산터널→연산교차로,2023.6.22 05:00,154,152,39,345,0
교대→연산교차로,2023.6.22 06:00,173,0,257,430,0
부산시청→연산교차로,2023.6.22 06:00,351,246,113,710,0
사직운동장→연산교차로,2023.6.22 06:00,128,314,40,482,0
신리→연산교차로,2023.6.22 06:00,331,176,24,531,0
안락→연산교차로,2023.6.22 06:00,468,0,89,557,0
연산터널→연산교차로,2023.6.22 06:00,239,229,41,509,0
교대→연산교차로,2023.6.22 07:00,275,0,402,677,0
부산시청→연산교차로,2023.6.22 07:00,538,380,207,1125,0
사직운동장→연산교차로,2023.6.22 07:00,218,466,58,742,0
신리→연산교차로,2023.6.22 07:00,452,259,42,753,0
안락→연산교차로,2023.6.22 07:00,622,0,78,700,0
연산터널→연산교차로,2023.6.22 07:00,299,370,59,728,0
교대→연산교차로,2023.6.22 08:00,317,0,483,800,0
부산시청→연산교차로,2023.6.22 08:00,587,440,353,1380,0
사직운동장→연산교차로,2023.6.22 08:00,284,635,62,981,0
신리→연산교차로,2023.6.22 08:00,515,354,35,904,0
안락→연산교차로,2023.6.22 08:00,638,0,119,757,0
연산터널→연산교차로,2023.6.22 08:00,324,374,51,749,0
교대→연산교차로,2023.6.22 09:00,272,0,504,776,0
부산시청→연산교차로,2023.6.22 09:00,529,348,256,1133,0
사직운동장→연산교차로,2023.6.22 09:00,250,557,89,896,0
신리→연산교차로,2023.6.22 09:00,461,342,51,854,0
안락→연산교차로,2023.6.22 09:00,569,0,128,697,0
연산터널→연산교차로,2023.6.22 09:00,290,364,36,690,0
교대→연산교차로,2023.6.22 10:00,292,0,454,746,0
부산시청→연산교차로,2023.6.22 10:00,554,376,269,1199,0
사직운동장→연산교차로,2023.6.22 10:00,287,549,67,903,0
신리→연산교차로,2023.6.22 10:00,464,280,65,809,0
안락→연산교차로,2023.6.22 10:00,568,0,131,699,0
연산터널→연산교차로,2023.6.22 10:00,303,347,47,697,0
교대→연산교차로,2023.6.22 11:00,295,0,426,721,0
부산시청→연산교차로,2023.6.22 11:00,598,382,256,1236,0
사직운동장→연산교차로,2023.6.22 11:00,286,583,77,946,0
신리→연산교차로,2023.6.22 11:00,426,261,65,752,0
안락→연산교차로,2023.6.22 11:00,535,0,180,715,0
연산터널→연산교차로,2023.6.22 11:00,245,306,47,598,0
교대→연산교차로,2023.6.22 12:00,296,0,383,679,0
부산시청→연산교차로,2023.6.22 12:00,534,340,215,1089,0
사직운동장→연산교차로,2023.6.22 12:00,245,528,75,848,0
신리→연산교차로,2023.6.22 12:00,389,224,37,650,0
안락→연산교차로,2023.6.22 12:00,505,0,140,645,0
연산터널→연산교차로,2023.6.22 12:00,283,245,46,574,0
교대→연산교차로,2023.6.22 13:00,316,0,409,725,0
부산시청→연산교차로,2023.6.22 13:00,525,419,273,1217,0
사직운동장→연산교차로,2023.6.22 13:00,284,622,83,989,0
신리→연산교차로,2023.6.22 13:00,461,248,60,769,0
안락→연산교차로,2023.6.22 13:00,451,0,112,563,0
연산터널→연산교차로,2023.6.22 13:00,247,244,45,536,0
교대→연산교차로,2023.6.22 14:00,356,0,489,845,0
부산시청→연산교차로,2023.6.22 14:00,525,420,267,1212,0
사직운동장→연산교차로,2023.6.22 14:00,285,624,78,987,0
신리→연산교차로,2023.6.22 14:00,472,273,53,798,0
안락→연산교차로,2023.6.22 14:00,450,0,98,548,0
연산터널→연산교차로,2023.6.22 14:00,250,266,49,565,0
교대→연산교차로,2023.6.22 15:00,361,0,521,882,0
부산시청→연산교차로,2023.6.22 15:00,603,474,283,1360,0
사직운동장→연산교차로,2023.6.22 15:00,321,636,89,1046,0
신리→연산교차로,2023.6.22 15:00,440,258,45,743,0
안락→연산교차로,2023.6.22 15:00,439,0,86,525,0
연산터널→연산교차로,2023.6.22 15:00,196,283,49,528,0
교대→연산교차로,2023.6.22 16:00,365,0,523,888,0
부산시청→연산교차로,2023.6.22 16:00,615,502,312,1429,0
사직운동장→연산교차로,2023.6.22 16:00,299,614,73,986,0
신리→연산교차로,2023.6.22 16:00,519,263,53,835,0
안락→연산교차로,2023.6.22 16:00,450,0,120,570,0
연산터널→연산교차로,2023.6.22 16:00,243,264,49,556,0
교대→연산교차로,2023.6.22 17:00,366,0,507,873,0
부산시청→연산교차로,2023.6.22 17:00,633,586,321,1540,0
사직운동장→연산교차로,2023.6.22 17:00,306,662,52,1020,0
신리→연산교차로,2023.6.22 17:00,540,264,66,870,0
안락→연산교차로,2023.6.22 17:00,468,0,97,565,0
연산터널→연산교차로,2023.6.22 17:00,224,263,35,522,0
교대→연산교차로,2023.6.22 18:00,371,0,590,961,0
부산시청→연산교차로,2023.6.22 18:00,613,558,367,1538,0
사직운동장→연산교차로,2023.6.22 18:00,301,677,52,1030,0
신리→연산교차로,2023.6.22 18:00,508,247,55,810,0
안락→연산교차로,2023.6.22 18:00,501,0,85,586,0
연산터널→연산교차로,2023.6.22 18:00,232,268,46,546,0
교대→연산교차로,2023.6.22 19:00,341,0,381,722,0
부산시청→연산교차로,2023.6.22 19:00,542,404,234,1180,0
사직운동장→연산교차로,2023.6.22 19:00,204,517,68,789,0
신리→연산교차로,2023.6.22 19:00,352,212,49,613,0
안락→연산교차로,2023.6.22 19:00,455,0,85,540,0
연산터널→연산교차로,2023.6.22 19:00,215,244,58,517,0
교대→연산교차로,2023.6.22 20:00,314,0,341,655,0
부산시청→연산교차로,2023.6.22 20:00,520,334,207,1061,0
사직운동장→연산교차로,2023.6.22 20:00,186,468,86,740,0
신리→연산교차로,2023.6.22 20:00,307,187,33,527,0
안락→연산교차로,2023.6.22 20:00,417,0,87,504,0
연산터널→연산교차로,2023.6.22 20:00,197,236,59,492,0
교대→연산교차로,2023.6.22 21:00,297,0,310,607,0
부산시청→연산교차로,2023.6.22 21:00,503,360,227,1090,0
사직운동장→연산교차로,2023.6.22 21:00,182,480,90,752,0
신리→연산교차로,2023.6.22 21:00,301,193,26,520,0
안락→연산교차로,2023.6.22 21:00,435,0,113,548,0
연산터널→연산교차로,2023.6.22 21:00,237,247,56,540,0
교대→연산교차로,2023.6.22 22:00,250,0,256,506,0
부산시청→연산교차로,2023.6.22 22:00,426,270,190,886,0
사직운동장→연산교차로,2023.6.22 22:00,173,382,78,633,0
신리→연산교차로,2023.6.22 22:00,280,162,32,474,0
안락→연산교차로,2023.6.22 22:00,362,0,85,447,0
연산터널→연산교차로,2023.6.22 22:00,206,253,52,511,0
교대→연산교차로,2023.6.22 23:00,197,0,220,417,0
부산시청→연산교차로,2023.6.22 23:00,316,199,143,658,0
사직운동장→연산교차로,2023.6.22 23:00,143,287,81,511,0
신리→연산교차로,2023.6.22 23:00,215,129,32,376,0
안락→연산교차로,2023.6.22 23:00,274,0,74,348,0
연산터널→연산교차로,2023.6.22 23:00,159,211,76,446,0
교대→연산교차로,2023.6.23 00:00,151,0,204,355,0
부산시청→연산교차로,2023.6.23 00:00,249,152,118,519,0
사직운동장→연산교차로,2023.6.23 00:00,95,259,84,438,0
신리→연산교차로,2023.6.23 00:00,171,94,26,291,0
안락→연산교차로,2023.6.23 00:00,220,0,63,283,0
연산터널→연산교차로,2023.6.23 00:00,161,188,80,429,0
교대→연산교차로,2023.6.23 01:00,119,0,146,265,0
부산시청→연산교차로,2023.6.23 01:00,210,114,96,420,0
사직운동장→연산교차로,2023.6.23 01:00,71,180,48,299,0
신리→연산교차로,2023.6.23 01:00,141,79,19,239,0
안락→연산교차로,2023.6.23 01:00,168,0,53,221,0
연산터널→연산교차로,2023.6.23 01:00,122,140,51,313,0
교대→연산교차로,2023.6.23 02:00,98,0,106,204,0
부산시청→연산교차로,2023.6.23 02:00,191,92,68,351,0
사직운동장→연산교차로,2023.6.23 02:00,52,156,37,245,0
신리→연산교차로,2023.6.23 02:00,102,59,14,175,0
안락→연산교차로,2023.6.23 02:00,152,0,32,184,0
연산터널→연산교차로,2023.6.23 02:00,111,138,32,281,0
교대→연산교차로,2023.6.23 03:00,73,0,89,162,0
부산시청→연산교차로,2023.6.23 03:00,137,70,51,258,0
사직운동장→연산교차로,2023.6.23 03:00,42,141,39,222,0
신리→연산교차로,2023.6.23 03:00,81,60,10,151,0
안락→연산교차로,2023.6.23 03:00,116,0,37,153,0
연산터널→연산교차로,2023.6.23 03:00,77,106,42,225,0
교대→연산교차로,2023.6.23 04:00,56,0,81,137,0
부산시청→연산교차로,2023.6.23 04:00,175,79,54,308,0
사직운동장→연산교차로,2023.6.23 04:00,30,108,32,170,0
신리→연산교차로,2023.6.23 04:00,98,49,9,156,0
안락→연산교차로,2023.6.23 04:00,176,0,23,199,0
연산터널→연산교차로,2023.6.23 04:00,78,105,24,207,0
교대→연산교차로,2023.6.23 05:00,114,0,146,260,0
부산시청→연산교차로,2023.6.23 05:00,248,144,71,463,0
사직운동장→연산교차로,2023.6.23 05:00,62,192,31,285,0
신리→연산교차로,2023.6.23 05:00,226,101,15,342,0
안락→연산교차로,2023.6.23 05:00,366,0,54,420,0
연산터널→연산교차로,2023.6.23 05:00,156,145,35,336,0
교대→연산교차로,2023.6.23 06:00,177,0,237,414,0
부산시청→연산교차로,2023.6.23 06:00,372,255,136,763,0
사직운동장→연산교차로,2023.6.23 06:00,102,286,37,425,0
신리→연산교차로,2023.6.23 06:00,314,154,30,498,0
안락→연산교차로,2023.6.23 06:00,537,0,84,621,0
연산터널→연산교차로,2023.6.23 06:00,230,250,37,517,0
교대→연산교차로,2023.6.23 07:00,251,0,378,629,0
부산시청→연산교차로,2023.6.23 07:00,525,368,235,1128,0
사직운동장→연산교차로,2023.6.23 07:00,207,496,52,755,0
신리→연산교차로,2023.6.23 07:00,479,250,33,762,0
안락→연산교차로,2023.6.23 07:00,636,0,80,716,0
연산터널→연산교차로,2023.6.23 07:00,292,381,45,718,0
교대→연산교차로,2023.6.23 08:00,299,0,514,813,0
부산시청→연산교차로,2023.6.23 08:00,601,442,336,1379,0
사직운동장→연산교차로,2023.6.23 08:00,266,616,77,959,0
신리→연산교차로,2023.6.23 08:00,491,346,30,867,0
안락→연산교차로,2023.6.23 08:00,622,0,96,718,0
연산터널→연산교차로,2023.6.23 08:00,306,390,28,724,0
교대→연산교차로,2023.6.23 09:00,294,0,511,805,0
부산시청→연산교차로,2023.6.23 09:00,479,357,283,1119,0
사직운동장→연산교차로,2023.6.23 09:00,290,573,76,939,0
신리→연산교차로,2023.6.23 09:00,471,329,34,834,0
안락→연산교차로,2023.6.23 09:00,623,0,99,722,0
연산터널→연산교차로,2023.6.23 09:00,292,374,44,710,0
교대→연산교차로,2023.6.23 10:00,290,0,493,783,0
부산시청→연산교차로,2023.6.23 10:00,566,361,284,1211,0
사직운동장→연산교차로,2023.6.23 10:00,329,607,77,1013,0
신리→연산교차로,2023.6.23 10:00,454,266,68,788,0
안락→연산교차로,2023.6.23 10:00,591,0,140,731,0
연산터널→연산교차로,2023.6.23 10:00,307,334,35,676,0
교대→연산교차로,2023.6.23 11:00,306,0,464,770,0
부산시청→연산교차로,2023.6.23 11:00,602,384,270,1256,0
사직운동장→연산교차로,2023.6.23 11:00,340,574,64,978,0
신리→연산교차로,2023.6.23 11:00,448,246,77,771,0
안락→연산교차로,2023.6.23 11:00,568,0,149,717,0
연산터널→연산교차로,2023.6.23 11:00,296,293,59,648,0
교대→연산교차로,2023.6.23 12:00,305,0,378,683,0
부산시청→연산교차로,2023.6.23 12:00,575,367,249,1191,0
사직운동장→연산교차로,2023.6.23 12:00,296,556,85,937,0
신리→연산교차로,2023.6.23 12:00,403,249,58,710,0
안락→연산교차로,2023.6.23 12:00,540,0,133,673,0
연산터널→연산교차로,2023.6.23 12:00,255,294,36,585,0
교대→연산교차로,2023.6.23 13:00,321,0,418,739,0
부산시청→연산교차로,2023.6.23 13:00,579,464,290,1333,0
사직운동장→연산교차로,2023.6.23 13:00,327,605,94,1026,0
신리→연산교차로,2023.6.23 13:00,454,262,50,766,0
안락→연산교차로,2023.6.23 13:00,472,0,92,564,0
연산터널→연산교차로,2023.6.23 13:00,245,263,43,551,0
교대→연산교차로,2023.6.23 14:00,363,0,464,827,0
부산시청→연산교차로,2023.6.23 14:00,580,409,269,1258,0
사직운동장→연산교차로,2023.6.23 14:00,316,641,92,1049,0
신리→연산교차로,2023.6.23 14:00,430,283,62,775,0
안락→연산교차로,2023.6.23 14:00,448,0,118,566,0
연산터널→연산교차로,2023.6.23 14:00,235,276,58,569,0
교대→연산교차로,2023.6.23 15:00,368,0,484,852,0
부산시청→연산교차로,2023.6.23 15:00,615,473,335,1423,0
사직운동장→연산교차로,2023.6.23 15:00,314,614,92,1020,0
신리→연산교차로,2023.6.23 15:00,464,247,50,761,0
안락→연산교차로,2023.6.23 15:00,474,0,111,585,0
연산터널→연산교차로,2023.6.23 15:00,222,279,63,564,0
교대→연산교차로,2023.6.23 16:00,378,0,503,881,0
부산시청→연산교차로,2023.6.23 16:00,628,516,291,1435,0
사직운동장→연산교차로,2023.6.23 16:00,309,651,62,1022,0
신리→연산교차로,2023.6.23 16:00,480,304,59,843,0
안락→연산교차로,2023.6.23 16:00,454,0,104,558,0
연산터널→연산교차로,2023.6.23 16:00,231,270,48,549,0
교대→연산교차로,2023.6.23 17:00,387,0,502,889,0
부산시청→연산교차로,2023.6.23 17:00,619,572,302,1493,0
사직운동장→연산교차로,2023.6.23 17:00,315,659,41,1015,0
신리→연산교차로,2023.6.23 17:00,526,276,43,845,0
안락→연산교차로,2023.6.23 17:00,475,0,88,563,0
연산터널→연산교차로,2023.6.23 17:00,229,276,41,546,0
교대→연산교차로,2023.6.23 18:00,381,0,560,941,0
부산시청→연산교차로,2023.6.23 18:00,642,576,305,1523,0
사직운동장→연산교차로,2023.6.23 18:00,330,673,39,1042,0
신리→연산교차로,2023.6.23 18:00,527,260,47,834,0
안락→연산교차로,2023.6.23 18:00,486,0,92,578,0
연산터널→연산교차로,2023.6.23 18:00,225,288,46,559,0
교대→연산교차로,2023.6.23 19:00,366,0,453,819,0
부산시청→연산교차로,2023.6.23 19:00,549,436,274,1259,0
사직운동장→연산교차로,2023.6.23 19:00,210,551,61,822,0
신리→연산교차로,2023.6.23 19:00,418,202,43,663,0
안락→연산교차로,2023.6.23 19:00,452,0,101,553,0
연산터널→연산교차로,2023.6.23 19:00,209,268,62,539,0
교대→연산교차로,2023.6.23 20:00,331,0,383,714,0
부산시청→연산교차로,2023.6.23 20:00,526,348,258,1132,0
사직운동장→연산교차로,2023.6.23 20:00,197,517,91,805,0
신리→연산교차로,2023.6.23 20:00,372,188,44,604,0
안락→연산교차로,2023.6.23 20:00,438,0,88,526,0
연산터널→연산교차로,2023.6.23 20:00,229,266,50,545,0
교대→연산교차로,2023.6.23 21:00,297,0,360,657,0
부산시청→연산교차로,2023.6.23 21:00,522,336,248,1106,0
사직운동장→연산교차로,2023.6.23 21:00,171,460,79,710,0
신리→연산교차로,2023.6.23 21:00,322,194,28,544,0
안락→연산교차로,2023.6.23 21:00,432,0,113,545,0
연산터널→연산교차로,2023.6.23 21:00,230,302,46,578,0
교대→연산교차로,2023.6.23 22:00,282,0,319,601,0
부산시청→연산교차로,2023.6.23 22:00,439,307,186,932,0
사직운동장→연산교차로,2023.6.23 22:00,168,397,90,655,0
신리→연산교차로,2023.6.23 22:00,309,185,30,524,0
안락→연산교차로,2023.6.23 22:00,375,0,114,489,0
연산터널→연산교차로,2023.6.23 22:00,226,282,68,576,0
교대→연산교차로,2023.6.23 23:00,256,0,264,520,0
부산시청→연산교차로,2023.6.23 23:00,398,218,160,776,0
사직운동장→연산교차로,2023.6.23 23:00,182,355,50,587,0
신리→연산교차로,2023.6.23 23:00,279,150,27,456,0
안락→연산교차로,2023.6.23 23:00,328,0,85,413,0
연산터널→연산교차로,2023.6.23 23:00,172,246,65,483,0
교대→연산교차로,2023.6.24 00:00,229,0,245,474,0
부산시청→연산교차로,2023.6.24 00:00,334,170,120,624,0
사직운동장→연산교차로,2023.6.24 00:00,131,297,42,470,0
신리→연산교차로,2023.6.24 00:00,217,156,29,402,0
안락→연산교차로,2023.6.24 00:00,275,0,79,354,0
연산터널→연산교차로,2023.6.24 00:00,176,233,51,460,0
교대→연산교차로,2023.6.24 01:00,160,0,260,420,0
부산시청→연산교차로,2023.6.24 01:00,288,204,131,623,0
사직운동장→연산교차로,2023.6.24 01:00,105,217,30,352,0
신리→연산교차로,2023.6.24 01:00,172,116,20,308,0
안락→연산교차로,2023.6.24 01:00,238,0,67,305,0
연산터널→연산교차로,2023.6.24 01:00,158,201,38,397,0
교대→연산교차로,2023.6.24 02:00,121,0,221,342,0
부산시청→연산교차로,2023.6.24 02:00,238,126,82,446,0
사직운동장→연산교차로,2023.6.24 02:00,83,201,16,300,0
신리→연산교차로,2023.6.24 02:00,145,60,23,228,0
안락→연산교차로,2023.6.24 02:00,200,0,45,245,0
연산터널→연산교차로,2023.6.24 02:00,145,168,39,352,0
교대→연산교차로,2023.6.24 03:00,113,0,166,279,0
부산시청→연산교차로,2023.6.24 03:00,199,99,70,368,0
사직운동장→연산교차로,2023.6.24 03:00,77,145,16,238,0
신리→연산교차로,2023.6.24 03:00,144,71,13,228,0
안락→연산교차로,2023.6.24 03:00,172,0,43,215,0
연산터널→연산교차로,2023.6.24 03:00,104,132,36,272,0
교대→연산교차로,2023.6.24 04:00,82,0,125,207,0
부산시청→연산교차로,2023.6.24 04:00,214,89,54,357,0
사직운동장→연산교차로,2023.6.24 04:00,71,146,14,231,0
신리→연산교차로,2023.6.24 04:00,104,55,8,167,0
안락→연산교차로,2023.6.24 04:00,180,0,37,217,0
연산터널→연산교차로,2023.6.24 04:00,106,122,35,263,0
교대→연산교차로,2023.6.24 05:00,117,0,154,271,0
부산시청→연산교차로,2023.6.24 05:00,261,170,71,502,0
사직운동장→연산교차로,2023.6.24 05:00,71,171,50,292,0
신리→연산교차로,2023.6.24 05:00,205,85,10,300,0
안락→연산교차로,2023.6.24 05:00,339,0,51,390,0
연산터널→연산교차로,2023.6.24 05:00,147,151,34,332,0
교대→연산교차로,2023.6.24 06:00,152,0,203,355,0
부산시청→연산교차로,2023.6.24 06:00,340,243,97,680,0
사직운동장→연산교차로,2023.6.24 06:00,105,240,47,392,0
신리→연산교차로,2023.6.24 06:00,255,128,17,400,0
안락→연산교차로,2023.6.24 06:00,426,0,89,515,0
연산터널→연산교차로,2023.6.24 06:00,205,194,55,454,0
교대→연산교차로,2023.6.24 07:00,174,0,232,406,0
부산시청→연산교차로,2023.6.24 07:00,387,255,130,772,0
사직운동장→연산교차로,2023.6.24 07:00,167,316,59,542,0
신리→연산교차로,2023.6.24 07:00,302,158,18,478,0
안락→연산교차로,2023.6.24 07:00,437,0,99,536,0
연산터널→연산교차로,2023.6.24 07:00,186,176,39,401,0
교대→연산교차로,2023.6.24 08:00,271,0,336,607,0
부산시청→연산교차로,2023.6.24 08:00,462,311,230,1003,0
사직운동장→연산교차로,2023.6.24 08:00,251,490,80,821,0
신리→연산교차로,2023.6.24 08:00,422,248,40,710,0
안락→연산교차로,2023.6.24 08:00,540,0,114,654,0
연산터널→연산교차로,2023.6.24 08:00,282,317,42,641,0
교대→연산교차로,2023.6.24 09:00,287,0,358,645,0
부산시청→연산교차로,2023.6.24 09:00,509,341,275,1125,0
사직운동장→연산교차로,2023.6.24 09:00,249,543,79,871,0
신리→연산교차로,2023.6.24 09:00,506,306,59,871,0
안락→연산교차로,2023.6.24 09:00,605,0,127,732,0
연산터널→연산교차로,2023.6.24 09:00,286,339,66,691,0
교대→연산교차로,2023.6.24 10:00,316,0,442,758,0
부산시청→연산교차로,2023.6.24 10:00,584,374,244,1202,0
사직운동장→연산교차로,2023.6.24 10:00,295,619,87,1001,0
신리→연산교차로,2023.6.24 10:00,528,294,68,890,0
안락→연산교차로,2023.6.24 10:00,618,0,135,753,0
연산터널→연산교차로,2023.6.24 10:00,320,344,45,709,0
교대→연산교차로,2023.6.24 11:00,314,0,440,754,0
부산시청→연산교차로,2023.6.24 11:00,614,385,250,1249,0
사직운동장→연산교차로,2023.6.24 11:00,316,598,65,979,0
신리→연산교차로,2023.6.24 11:00,525,283,69,877,0
안락→연산교차로,2023.6.24 11:00,611,0,167,778,0
연산터널→연산교차로,2023.6.24 11:00,310,342,54,706,0
교대→연산교차로,2023.6.24 12:00,316,0,450,766,0
부산시청→연산교차로,2023.6.24 12:00,596,389,281,1266,0
사직운동장→연산교차로,2023.6.24 12:00,278,614,46,938,0
신리→연산교차로,2023.6.24 12:00,537,282,82,901,0
안락→연산교차로,2023.6.24 12:00,562,0,187,749,0
연산터널→연산교차로,2023.6.24 12:00,306,333,57,696,0
교대→연산교차로,2023.6.24 13:00,375,0,519,894,0
부산시청→연산교차로,2023.6.24 13:00,700,456,312,1468,0
사직운동장→연산교차로,2023.6.24 13:00,339,663,49,1051,0
신리→연산교차로,2023.6.24 13:00,495,286,66,847,0
안락→연산교차로,2023.6.24 13:00,489,0,110,599,0
연산터널→연산교차로,2023.6.24 13:00,224,283,40,547,0
교대→연산교차로,2023.6.24 14:00,370,0,524,894,0
부산시청→연산교차로,2023.6.24 14:00,651,449,309,1409,0
사직운동장→연산교차로,2023.6.24 14:00,277,654,57,988,0
신리→연산교차로,2023.6.24 14:00,452,274,79,805,0
안락→연산교차로,2023.6.24 14:00,440,0,115,555,0
연산터널→연산교차로,2023.6.24 14:00,230,291,48,569,0
교대→연산교차로,2023.6.24 15:00,355,0,412,767,0
부산시청→연산교차로,2023.6.24 15:00,642,485,311,1438,0
사직운동장→연산교차로,2023.6.24 15:00,333,642,55,1030,0
신리→연산교차로,2023.6.24 15:00,474,259,56,789,0
안락→연산교차로,2023.6.24 15:00,463,0,105,568,0
연산터널→연산교차로,2023.6.24 15:00,233,273,40,546,0
교대→연산교차로,2023.6.24 16:00,358,0,456,814,0
부산시청→연산교차로,2023.6.24 16:00,627,467,326,1420,0
사직운동장→연산교차로,2023.6.24 16:00,319,671,48,1038,0
신리→연산교차로,2023.6.24 16:00,447,259,53,759,0
안락→연산교차로,2023.6.24 16:00,486,0,96,582,0
연산터널→연산교차로,2023.6.24 16:00,239,299,35,573,0
교대→연산교차로,2023.6.24 17:00,334,0,385,719,0
부산시청→연산교차로,2023.6.24 17:00,623,469,318,1410,0
사직운동장→연산교차로,2023.6.24 17:00,266,632,52,950,0
신리→연산교차로,2023.6.24 17:00,447,243,53,743,0
안락→연산교차로,2023.6.24 17:00,497,0,84,581,0
연산터널→연산교차로,2023.6.24 17:00,235,269,54,558,0
교대→연산교차로,2023.6.24 18:00,370,0,441,811,0
부산시청→연산교차로,2023.6.24 18:00,585,403,267,1255,0
사직운동장→연산교차로,2023.6.24 18:00,246,664,68,978,0
신리→연산교차로,2023.6.24 18:00,420,217,34,671,0
안락→연산교차로,2023.6.24 18:00,472,0,93,565,0
연산터널→연산교차로,2023.6.24 18:00,225,271,56,552,0
교대→연산교차로,2023.6.24 19:00,321,0,397,718,0
부산시청→연산교차로,2023.6.24 19:00,508,325,214,1047,0
사직운동장→연산교차로,2023.6.24 19:00,225,505,63,793,0
신리→연산교차로,2023.6.24 19:00,327,202,35,564,0
안락→연산교차로,2023.6.24 19:00,453,0,114,567,0
연산터널→연산교차로,2023.6.24 19:00,209,287,55,551,0
교대→연산교차로,2023.6.24 20:00,319,0,318,637,0
부산시청→연산교차로,2023.6.24 20:00,472,341,227,1040,0
사직운동장→연산교차로,2023.6.24 20:00,197,465,79,741,0
신리→연산교차로,2023.6.24 20:00,364,189,34,587,0
안락→연산교차로,2023.6.24 20:00,413,0,108,521,0
연산터널→연산교차로,2023.6.24 20:00,224,262,57,543,0
교대→연산교차로,2023.6.24 21:00,298,0,343,641,0
부산시청→연산교차로,2023.6.24 21:00,497,375,202,1074,0
사직운동장→연산교차로,2023.6.24 21:00,189,400,74,663,0
신리→연산교차로,2023.6.24 21:00,328,183,24,535,0
안락→연산교차로,2023.6.24 21:00,428,0,116,544,0
연산터널→연산교차로,2023.6.24 21:00,251,252,53,556,0
교대→연산교차로,2023.6.24 22:00,272,0,272,544,0
부산시청→연산교차로,2023.6.24 22:00,445,253,205,903,0
사직운동장→연산교차로,2023.6.24 22:00,150,352,87,589,0
신리→연산교차로,2023.6.24 22:00,329,180,20,529,0
안락→연산교차로,2023.6.24 22:00,388,0,120,508,0
연산터널→연산교차로,2023.6.24 22:00,228,251,63,542,0
교대→연산교차로,2023.6.24 23:00,236,0,248,484,0
부산시청→연산교차로,2023.6.24 23:00,350,228,143,721,0
사직운동장→연산교차로,2023.6.24 23:00,122,323,92,537,0
신리→연산교차로,2023.6.24 23:00,293,145,20,458,0
안락→연산교차로,2023.6.24 23:00,324,0,88,412,0
연산터널→연산교차로,2023.6.24 23:00,179,209,58,446,0
교대→연산교차로,2023.6.25 00:00,159,0,250,409,1
부산시청→연산교차로,2023.6.25 00:00,330,186,137,653,1
사직운동장→연산교차로,2023.6.25 00:00,85,274,71,430,1
신리→연산교차로,2023.6.25 00:00,234,148,17,399,1
안락→연산교차로,2023.6.25 00:00,268,0,61,329,1
연산터널→연산교차로,2023.6.25 00:00,154,185,53,392,1
교대→연산교차로,2023.6.25 01:00,123,0,209,332,1
부산시청→연산교차로,2023.6.25 01:00,288,180,105,573,1
사직운동장→연산교차로,2023.6.25 01:00,79,198,86,363,1
신리→연산교차로,2023.6.25 01:00,208,100,15,323,1
안락→연산교차로,2023.6.25 01:00,238,0,60,298,1
연산터널→연산교차로,2023.6.25 01:00,107,180,48,335,1
교대→연산교차로,2023.6.25 02:00,130,0,188,318,1
부산시청→연산교차로,2023.6.25 02:00,260,126,95,481,1
사직운동장→연산교차로,2023.6.25 02:00,66,187,69,322,1
신리→연산교차로,2023.6.25 02:00,153,90,22,265,1
안락→연산교차로,2023.6.25 02:00,194,0,51,245,1
연산터널→연산교차로,2023.6.25 02:00,117,165,34,316,1
교대→연산교차로,2023.6.25 03:00,85,0,169,254,1
부산시청→연산교차로,2023.6.25 03:00,215,115,69,399,1
사직운동장→연산교차로,2023.6.25 03:00,53,150,54,257,1
신리→연산교차로,2023.6.25 03:00,119,81,11,211,1
안락→연산교차로,2023.6.25 03:00,139,0,34,173,1
연산터널→연산교차로,2023.6.25 03:00,89,122,47,258,1
교대→연산교차로,2023.6.25 04:00,83,0,107,190,1
부산시청→연산교차로,2023.6.25 04:00,144,79,49,272,1
사직운동장→연산교차로,2023.6.25 04:00,53,110,44,207,1
신리→연산교차로,2023.6.25 04:00,94,56,10,160,1
안락→연산교차로,2023.6.25 04:00,130,0,37,167,1
연산터널→연산교차로,2023.6.25 04:00,72,95,23,190,1
교대→연산교차로,2023.6.25 05:00,85,0,111,196,1
부산시청→연산교차로,2023.6.25 05:00,200,121,69,390,1
사직운동장→연산교차로,2023.6.25 05:00,38,124,33,195,1
신리→연산교차로,2023.6.25 05:00,143,64,7,214,1
안락→연산교차로,2023.6.25 05:00,207,0,31,238,1
연산터널→연산교차로,2023.6.25 05:00,98,121,23,242,1
교대→연산교차로,2023.6.25 06:00,111,0,151,262,1
부산시청→연산교차로,2023.6.25 06:00,219,147,73,439,1
사직운동장→연산교차로,2023.6.25 06:00,67,158,44,269,1
신리→연산교차로,2023.6.25 06:00,168,70,13,251,1
안락→연산교차로,2023.6.25 06:00,257,0,57,314,1
연산터널→연산교차로,2023.6.25 06:00,131,124,31,286,1
교대→연산교차로,2023.6.25 07:00,130,0,167,297,1
부산시청→연산교차로,2023.6.25 07:00,233,197,82,512,1
사직운동장→연산교차로,2023.6.25 07:00,79,184,46,309,1
신리→연산교차로,2023.6.25 07:00,214,81,17,312,1
안락→연산교차로,2023.6.25 07:00,249,0,51,300,1
연산터널→연산교차로,2023.6.25 07:00,133,128,25,286,1
교대→연산교차로,2023.6.25 08:00,169,0,196,365,1
부산시청→연산교차로,2023.6.25 08:00,293,210,154,657,1
사직운동장→연산교차로,2023.6.25 08:00,130,344,41,515,1
신리→연산교차로,2023.6.25 08:00,255,131,39,425,1
안락→연산교차로,2023.6.25 08:00,346,0,78,424,1
연산터널→연산교차로,2023.6.25 08:00,171,144,24,339,1
교대→연산교차로,2023.6.25 09:00,224,0,250,474,1
부산시청→연산교차로,2023.6.25 09:00,379,310,173,862,1
사직운동장→연산교차로,2023.6.25 09:00,160,441,57,658,1
신리→연산교차로,2023.6.25 09:00,390,216,31,637,1
안락→연산교차로,2023.6.25 09:00,459,0,97,556,1
연산터널→연산교차로,2023.6.25 09:00,265,235,35,535,1
교대→연산교차로,2023.6.25 10:00,298,0,325,623,1
부산시청→연산교차로,2023.6.25 10:00,429,317,205,951,1
사직운동장→연산교차로,2023.6.25 10:00,185,524,55,764,1
신리→연산교차로,2023.6.25 10:00,453,195,45,693,1
안락→연산교차로,2023.6.25 10:00,500,0,100,600,1
연산터널→연산교차로,2023.6.25 10:00,254,279,52,585,1
교대→연산교차로,2023.6.25 11:00,285,0,367,652,1
부산시청→연산교차로,2023.6.25 11:00,455,334,222,1011,1
사직운동장→연산교차로,2023.6.25 11:00,206,513,69,788,1
신리→연산교차로,2023.6.25 11:00,452,202,47,701,1
안락→연산교차로,2023.6.25 11:00,541,0,116,657,1
연산터널→연산교차로,2023.6.25 11:00,257,251,46,554,1
교대→연산교차로,2023.6.25 12:00,309,0,331,640,1
부산시청→연산교차로,2023.6.25 12:00,503,362,204,1069,1
사직운동장→연산교차로,2023.6.25 12:00,254,533,48,835,1
신리→연산교차로,2023.6.25 12:00,411,232,35,678,1
안락→연산교차로,2023.6.25 12:00,491,0,141,632,1
연산터널→연산교차로,2023.6.25 12:00,296,272,63,631,1
교대→연산교차로,2023.6.25 13:00,309,0,382,691,1
부산시청→연산교차로,2023.6.25 13:00,550,351,255,1156,1
사직운동장→연산교차로,2023.6.25 13:00,290,568,55,913,1
신리→연산교차로,2023.6.25 13:00,446,228,52,726,1
안락→연산교차로,2023.6.25 13:00,542,0,138,680,1
연산터널→연산교차로,2023.6.25 13:00,267,267,44,578,1
교대→연산교차로,2023.6.25 14:00,316,0,320,636,1
부산시청→연산교차로,2023.6.25 14:00,530,360,254,1144,1
사직운동장→연산교차로,2023.6.25 14:00,220,554,56,830,1
신리→연산교차로,2023.6.25 14:00,464,220,50,734,1
안락→연산교차로,2023.6.25 14:00,577,0,137,714,1
연산터널→연산교차로,2023.6.25 14:00,257,249,34,540,1
교대→연산교차로,2023.6.25 15:00,309,0,343,652,1
부산시청→연산교차로,2023.6.25 15:00,546,364,197,1107,1
사직운동장→연산교차로,2023.6.25 15:00,227,539,51,817,1
신리→연산교차로,2023.6.25 15:00,390,206,43,639,1
안락→연산교차로,2023.6.25 15:00,550,0,119,669,1
연산터널→연산교차로,2023.6.25 15:00,286,276,40,602,1
교대→연산교차로,2023.6.25 16:00,300,0,328,628,1
부산시청→연산교차로,2023.6.25 16:00,556,359,236,1151,1
사직운동장→연산교차로,2023.6.25 16:00,286,549,58,893,1
신리→연산교차로,2023.6.25 16:00,472,203,31,706,1
안락→연산교차로,2023.6.25 16:00,525,0,120,645,1
연산터널→연산교차로,2023.6.25 16:00,269,276,52,597,1
교대→연산교차로,2023.6.25 17:00,310,0,350,660,1
부산시청→연산교차로,2023.6.25 17:00,522,359,216,1097,1
사직운동장→연산교차로,2023.6.25 17:00,214,506,53,773,1
신리→연산교차로,2023.6.25 17:00,434,211,31,676,1
안락→연산교차로,2023.6.25 17:00,546,0,131,677,1
연산터널→연산교차로,2023.6.25 17:00,271,268,58,597,1
교대→연산교차로,2023.6.25 18:00,287,0,292,579,1
부산시청→연산교차로,2023.6.25 18:00,468,312,169,949,1
사직운동장→연산교차로,2023.6.25 18:00,209,449,46,704,1
신리→연산교차로,2023.6.25 18:00,339,206,35,580,1
안락→연산교차로,2023.6.25 18:00,493,0,145,638,1
연산터널→연산교차로,2023.6.25 18:00,201,256,53,510,1
교대→연산교차로,2023.6.25 19:00,281,0,287,568,1
부산시청→연산교차로,2023.6.25 19:00,386,280,167,833,1
사직운동장→연산교차로,2023.6.25 19:00,155,425,41,621,1
신리→연산교차로,2023.6.25 19:00,326,146,37,509,1
안락→연산교차로,2023.6.25 19:00,400,0,119,519,1
연산터널→연산교차로,2023.6.25 19:00,236,259,47,542,1
교대→연산교차로,2023.6.25 20:00,264,0,242,506,1
부산시청→연산교차로,2023.6.25 20:00,359,277,150,786,1
사직운동장→연산교차로,2023.6.25 20:00,180,331,17,528,1
신리→연산교차로,2023.6.25 20:00,311,164,16,491,1
안락→연산교차로,2023.6.25 20:00,363,0,106,469,1
연산터널→연산교차로,2023.6.25 20:00,206,217,23,446,1
교대→연산교차로,2023.6.25 21:00,232,0,203,435,1
부산시청→연산교차로,2023.6.25 21:00,322,246,150,718,1
사직운동장→연산교차로,2023.6.25 21:00,141,312,28,481,1
신리→연산교차로,2023.6.25 21:00,255,150,24,429,1
안락→연산교차로,2023.6.25 21:00,316,0,64,380,1
연산터널→연산교차로,2023.6.25 21:00,191,175,33,399,1
교대→연산교차로,2023.6.25 22:00,159,0,134,293,1
부산시청→연산교차로,2023.6.25 22:00,288,183,98,569,1
사직운동장→연산교차로,2023.6.25 22:00,89,221,30,340,1
신리→연산교차로,2023.6.25 22:00,180,95,12,287,1
안락→연산교차로,2023.6.25 22:00,261,0,61,322,1
연산터널→연산교차로,2023.6.25 22:00,120,138,35,293,1
교대→연산교차로,2023.6.25 23:00,107,0,126,233,1
부산시청→연산교차로,2023.6.25 23:00,201,117,83,401,1
사직운동장→연산교차로,2023.6.25 23:00,77,173,34,284,1
신리→연산교차로,2023.6.25 23:00,138,83,18,239,1
안락→연산교차로,2023.6.25 23:00,197,0,42,239,1
연산터널→연산교차로,2023.6.25 23:00,104,129,42,275,1
교대→연산교차로,2023.6.26 00:00,83,0,117,200,0
부산시청→연산교차로,2023.6.26 00:00,185,121,80,386,0
사직운동장→연산교차로,2023.6.26 00:00,78,163,29,270,0
신리→연산교차로,2023.6.26 00:00,117,52,13,182,0
안락→연산교차로,2023.6.26 00:00,154,0,43,197,0
연산터널→연산교차로,2023.6.26 00:00,103,126,26,255,0
교대→연산교차로,2023.6.26 01:00,64,0,105,169,0
부산시청→연산교차로,2023.6.26 01:00,148,80,50,278,0
사직운동장→연산교차로,2023.6.26 01:00,31,123,11,165,0
신리→연산교차로,2023.6.26 01:00,63,45,7,115,0
안락→연산교차로,2023.6.26 01:00,125,0,31,156,0
연산터널→연산교차로,2023.6.26 01:00,67,77,48,192,0
교대→연산교차로,2023.6.26 02:00,37,0,55,92,0
부산시청→연산교차로,2023.6.26 02:00,112,58,55,225,0
사직운동장→연산교차로,2023.6.26 02:00,47,98,2,147,0
신리→연산교차로,2023.6.26 02:00,64,29,4,97,0
안락→연산교차로,2023.6.26 02:00,114,0,24,138,0
연산터널→연산교차로,2023.6.26 02:00,68,77,13,158,0
교대→연산교차로,2023.6.26 03:00,40,0,49,89,0
부산시청→연산교차로,2023.6.26 03:00,109,65,37,211,0
사직운동장→연산교차로,2023.6.26 03:00,21,68,7,96,0
신리→연산교차로,2023.6.26 03:00,35,26,8,69,0
안락→연산교차로,2023.6.26 03:00,83,0,23,106,0
연산터널→연산교차로,2023.6.26 03:00,51,64,14,129,0
교대→연산교차로,2023.6.26 04:00,46,0,53,99,0
부산시청→연산교차로,2023.6.26 04:00,109,58,25,192,0
사직운동장→연산교차로,2023.6.26 04:00,27,77,8,112,0
신리→연산교차로,2023.6.26 04:00,74,30,2,106,0
안락→연산교차로,2023.6.26 04:00,142,0,18,160,0
연산터널→연산교차로,2023.6.26 04:00,61,66,4,131,0
교대→연산교차로,2023.6.26 05:00,77,0,109,186,0
부산시청→연산교차로,2023.6.26 05:00,202,142,51,395,0
사직운동장→연산교차로,2023.6.26 05:00,56,141,23,220,0
신리→연산교차로,2023.6.26 05:00,182,65,4,251,0
안락→연산교차로,2023.6.26 05:00,257,0,43,300,0
연산터널→연산교차로,2023.6.26 05:00,107,115,16,238,0
교대→연산교차로,2023.6.26 06:00,167,0,235,402,0
부산시청→연산교차로,2023.6.26 06:00,360,240,108,708,0
사직운동장→연산교차로,2023.6.26 06:00,97,285,45,427,0
신리→연산교차로,2023.6.26 06:00,301,140,15,456,0
안락→연산교차로,2023.6.26 06:00,479,0,76,555,0
연산터널→연산교차로,2023.6.26 06:00,216,225,40,481,0
교대→연산교차로,2023.6.26 07:00,263,0,399,662,0
부산시청→연산교차로,2023.6.26 07:00,522,367,185,1074,0
사직운동장→연산교차로,2023.6.26 07:00,193,484,53,730,0
신리→연산교차로,2023.6.26 07:00,496,257,22,775,0
안락→연산교차로,2023.6.26 07:00,607,0,72,679,0
연산터널→연산교차로,2023.6.26 07:00,298,352,44,694,0
교대→연산교차로,2023.6.26 08:00,314,0,442,756,0
부산시청→연산교차로,2023.6.26 08:00,606,440,309,1355,0
사직운동장→연산교차로,2023.6.26 08:00,243,635,62,940,0
신리→연산교차로,2023.6.26 08:00,542,329,24,895,0
안락→연산교차로,2023.6.26 08:00,617,0,119,736,0
연산터널→연산교차로,2023.6.26 08:00,321,364,32,717,0
교대→연산교차로,2023.6.26 09:00,301,0,474,775,0
부산시청→연산교차로,2023.6.26 09:00,486,376,267,1129,0
사직운동장→연산교차로,2023.6.26 09:00,258,580,92,930,0
신리→연산교차로,2023.6.26 09:00,460,361,50,871,0
안락→연산교차로,2023.6.26 09:00,598,0,105,703,0
연산터널→연산교차로,2023.6.26 09:00,301,354,46,701,0
교대→연산교차로,2023.6.26 10:00,307,0,490,797,0
부산시청→연산교차로,2023.6.26 10:00,514,371,247,1132,0
사직운동장→연산교차로,2023.6.26 10:00,328,553,66,947,0
신리→연산교차로,2023.6.26 10:00,461,250,57,768,0
안락→연산교차로,2023.6.26 10:00,563,0,128,691,0
연산터널→연산교차로,2023.6.26 10:00,269,328,60,657,0
교대→연산교차로,2023.6.26 11:00,312,0,473,785,0
부산시청→연산교차로,2023.6.26 11:00,580,369,236,1185,0
사직운동장→연산교차로,2023.6.26 11:00,266,552,72,890,0
신리→연산교차로,2023.6.26 11:00,427,297,58,782,0
안락→연산교차로,2023.6.26 11:00,546,0,127,673,0
연산터널→연산교차로,2023.6.26 11:00,286,277,54,617,0
교대→연산교차로,2023.6.26 12:00,307,0,418,725,0
부산시청→연산교차로,2023.6.26 12:00,584,357,250,1191,0
사직운동장→연산교차로,2023.6.26 12:00,283,520,73,876,0
신리→연산교차로,2023.6.26 12:00,423,238,44,705,0
안락→연산교차로,2023.6.26 12:00,483,0,135,618,0
연산터널→연산교차로,2023.6.26 12:00,252,290,39,581,0
교대→연산교차로,2023.6.26 13:00,355,0,446,801,0
부산시청→연산교차로,2023.6.26 13:00,550,437,282,1269,0
사직운동장→연산교차로,2023.6.26 13:00,318,640,82,1040,0
신리→연산교차로,2023.6.26 13:00,472,254,49,775,0
안락→연산교차로,2023.6.26 13:00,465,0,126,591,0
연산터널→연산교차로,2023.6.26 13:00,236,263,26,525,0
교대→연산교차로,2023.6.26 14:00,369,0,535,904,0
부산시청→연산교차로,2023.6.26 14:00,568,454,298,1320,0
사직운동장→연산교차로,2023.6.26 14:00,308,609,89,1006,0
신리→연산교차로,2023.6.26 14:00,463,286,52,801,0
안락→연산교차로,2023.6.26 14:00,457,0,121,578,0
연산터널→연산교차로,2023.6.26 14:00,235,282,52,569,0
교대→연산교차로,2023.6.26 15:00,366,0,520,886,0
부산시청→연산교차로,2023.6.26 15:00,602,478,297,1377,0
사직운동장→연산교차로,2023.6.26 15:00,288,648,91,1027,0
신리→연산교차로,2023.6.26 15:00,461,270,43,774,0
안락→연산교차로,2023.6.26 15:00,475,0,106,581,0
연산터널→연산교차로,2023.6.26 15:00,253,269,38,560,0
교대→연산교차로,2023.6.26 16:00,354,0,473,827,0
부산시청→연산교차로,2023.6.26 16:00,565,467,321,1353,0
사직운동장→연산교차로,2023.6.26 16:00,293,647,76,1016,0
신리→연산교차로,2023.6.26 16:00,511,270,57,838,0
안락→연산교차로,2023.6.26 16:00,452,0,110,562,0
연산터널→연산교차로,2023.6.26 16:00,233,285,50,568,0
교대→연산교차로,2023.6.26 17:00,360,0,495,855,0
부산시청→연산교차로,2023.6.26 17:00,581,540,320,1441,0
사직운동장→연산교차로,2023.6.26 17:00,360,692,43,1095,0
신리→연산교차로,2023.6.26 17:00,488,275,67,830,0
안락→연산교차로,2023.6.26 17:00,459,0,91,550,0
연산터널→연산교차로,2023.6.26 17:00,228,269,41,538,0
교대→연산교차로,2023.6.26 18:00,369,0,514,883,0
부산시청→연산교차로,2023.6.26 18:00,614,582,310,1506,0
사직운동장→연산교차로,2023.6.26 18:00,369,664,35,1068,0
신리→연산교차로,2023.6.26 18:00,531,240,54,825,0
안락→연산교차로,2023.6.26 18:00,462,0,110,572,0
연산터널→연산교차로,2023.6.26 18:00,219,265,52,536,0
교대→연산교차로,2023.6.26 19:00,320,0,376,696,0
부산시청→연산교차로,2023.6.26 19:00,542,414,292,1248,0
사직운동장→연산교차로,2023.6.26 19:00,169,553,63,785,0
신리→연산교차로,2023.6.26 19:00,355,209,36,600,0
안락→연산교차로,2023.6.26 19:00,393,0,95,488,0
연산터널→연산교차로,2023.6.26 19:00,205,241,44,490,0
교대→연산교차로,2023.6.26 20:00,276,0,293,569,0
부산시청→연산교차로,2023.6.26 20:00,466,345,243,1054,0
사직운동장→연산교차로,2023.6.26 20:00,163,467,52,682,0
신리→연산교차로,2023.6.26 20:00,293,183,30,506,0
안락→연산교차로,2023.6.26 20:00,392,0,88,480,0
연산터널→연산교차로,2023.6.26 20:00,193,244,51,488,0
교대→연산교차로,2023.6.26 21:00,266,0,258,524,0
부산시청→연산교차로,2023.6.26 21:00,444,271,181,896,0
사직운동장→연산교차로,2023.6.26 21:00,172,386,61,619,0
신리→연산교차로,2023.6.26 21:00,297,145,34,476,0
안락→연산교차로,2023.6.26 21:00,373,0,93,466,0
연산터널→연산교차로,2023.6.26 21:00,218,237,66,521,0
교대→연산교차로,2023.6.26 22:00,214,0,228,442,0
부산시청→연산교차로,2023.6.26 22:00,364,269,136,769,0
사직운동장→연산교차로,2023.6.26 22:00,142,332,24,498,0
신리→연산교차로,2023.6.26 22:00,227,133,27,387,0
안락→연산교차로,2023.6.26 22:00,325,0,88,413,0
연산터널→연산교차로,2023.6.26 22:00,204,227,68,499,0
교대→연산교차로,2023.6.26 23:00,160,0,172,332,0
부산시청→연산교차로,2023.6.26 23:00,294,177,115,586,0
사직운동장→연산교차로,2023.6.26 23:00,113,266,38,417,0
신리→연산교차로,2023.6.26 23:00,162,97,22,281,0
안락→연산교차로,2023.6.26 23:00,246,0,71,317,0
연산터널→연산교차로,2023.6.26 23:00,140,175,71,386,0
교대→연산교차로,2023.6.27 00:00,122,0,161,283,0
부산시청→연산교차로,2023.6.27 00:00,230,140,93,463,0
사직운동장→연산교차로,2023.6.27 00:00,81,224,28,333,0
신리→연산교차로,2023.6.27 00:00,144,95,24,263,0
안락→연산교차로,2023.6.27 00:00,185,0,49,234,0
연산터널→연산교차로,2023.6.27 00:00,111,162,49,322,0
교대→연산교차로,2023.6.27 01:00,96,0,132,228,0
부산시청→연산교차로,2023.6.27 01:00,175,119,78,372,0
사직운동장→연산교차로,2023.6.27 01:00,44,131,14,189,0
신리→연산교차로,2023.6.27 01:00,111,59,13,183,0
안락→연산교차로,2023.6.27 01:00,126,0,45,171,0
연산터널→연산교차로,2023.6.27 01:00,82,137,41,260,0
교대→연산교차로,2023.6.27 02:00,64,0,88,152,0
부산시청→연산교차로,2023.6.27 02:00,167,66,48,281,0
사직운동장→연산교차로,2023.6.27 02:00,49,127,6,182,0
신리→연산교차로,2023.6.27 02:00,89,26,10,125,0
안락→연산교차로,2023.6.27 02:00,121,0,30,151,0
연산터널→연산교차로,2023.6.27 02:00,90,99,24,213,0
교대→연산교차로,2023.6.27 03:00,52,0,93,145,0
부산시청→연산교차로,2023.6.27 03:00,129,50,37,216,0
사직운동장→연산교차로,2023.6.27 03:00,41,119,21,181,0
신리→연산교차로,2023.6.27 03:00,67,34,7,108,0
안락→연산교차로,2023.6.27 03:00,109,0,24,133,0
연산터널→연산교차로,2023.6.27 03:00,76,95,32,203,0
교대→연산교차로,2023.6.27 04:00,56,0,84,140,0
부산시청→연산교차로,2023.6.27 04:00,114,58,44,216,0
사직운동장→연산교차로,2023.6.27 04:00,38,91,24,153,0
신리→연산교차로,2023.6.27 04:00,83,47,8,138,0
안락→연산교차로,2023.6.27 04:00,136,0,29,165,0
연산터널→연산교차로,2023.6.27 04:00,67,80,23,170,0
교대→연산교차로,2023.6.27 05:00,98,0,120,218,0
부산시청→연산교차로,2023.6.27 05:00,222,162,74,458,0
사직운동장→연산교차로,2023.6.27 05:00,59,156,30,245,0
신리→연산교차로,2023.6.27 05:00,201,87,21,309,0
안락→연산교차로,2023.6.27 05:00,327,0,51,378,0
연산터널→연산교차로,2023.6.27 05:00,131,149,33,313,0
교대→연산교차로,2023.6.27 06:00,187,0,215,402,0
부산시청→연산교차로,2023.6.27 06:00,321,234,115,670,0
사직운동장→연산교차로,2023.6.27 06:00,103,270,43,416,0
신리→연산교차로,2023.6.27 06:00,337,155,23,515,0
안락→연산교차로,2023.6.27 06:00,500,0,71,571,0
연산터널→연산교차로,2023.6.27 06:00,220,244,43,507,0
교대→연산교차로,2023.6.27 07:00,254,0,384,638,0
부산시청→연산교차로,2023.6.27 07:00,523,362,181,1066,0
사직운동장→연산교차로,2023.6.27 07:00,222,492,54,768,0
신리→연산교차로,2023.6.27 07:00,503,247,37,787,0
안락→연산교차로,2023.6.27 07:00,621,0,82,703,0
연산터널→연산교차로,2023.6.27 07:00,278,365,52,695,0
교대→연산교차로,2023.6.27 08:00,309,0,475,784,0
부산시청→연산교차로,2023.6.27 08:00,577,411,319,1307,0
사직운동장→연산교차로,2023.6.27 08:00,273,661,70,1004,0
신리→연산교차로,2023.6.27 08:00,535,335,27,897,0
안락→연산교차로,2023.6.27 08:00,600,0,139,739,0
연산터널→연산교차로,2023.6.27 08:00,333,375,35,743,0
교대→연산교차로,2023.6.27 09:00,301,0,518,819,0
부산시청→연산교차로,2023.6.27 09:00,514,385,304,1203,0
사직운동장→연산교차로,2023.6.27 09:00,254,542,130,926,0
신리→연산교차로,2023.6.27 09:00,445,355,48,848,0
안락→연산교차로,2023.6.27 09:00,631,0,109,740,0
연산터널→연산교차로,2023.6.27 09:00,286,374,41,701,0
교대→연산교차로,2023.6.27 10:00,301,0,519,820,0
부산시청→연산교차로,2023.6.27 10:00,535,356,256,1147,0
사직운동장→연산교차로,2023.6.27 10:00,288,602,94,984,0
신리→연산교차로,2023.6.27 10:00,484,320,61,865,0
안락→연산교차로,2023.6.27 10:00,565,0,103,668,0
연산터널→연산교차로,2023.6.27 10:00,298,351,41,690,0
교대→연산교차로,2023.6.27 11:00,294,0,498,792,0
부산시청→연산교차로,2023.6.27 11:00,550,370,266,1186,0
사직운동장→연산교차로,2023.6.27 11:00,320,576,87,983,0
신리→연산교차로,2023.6.27 11:00,457,258,69,784,0
안락→연산교차로,2023.6.27 11:00,574,0,158,732,0
연산터널→연산교차로,2023.6.27 11:00,258,303,46,607,0
교대→연산교차로,2023.6.27 12:00,276,0,400,676,0
부산시청→연산교차로,2023.6.27 12:00,551,379,253,1183,0
사직운동장→연산교차로,2023.6.27 12:00,270,567,70,907,0
신리→연산교차로,2023.6.27 12:00,419,219,44,682,0
안락→연산교차로,2023.6.27 12:00,511,0,146,657,0
연산터널→연산교차로,2023.6.27 12:00,304,259,42,605,0
교대→연산교차로,2023.6.27 13:00,333,0,471,804,0
부산시청→연산교차로,2023.6.27 13:00,521,410,269,1200,0
사직운동장→연산교차로,2023.6.27 13:00,322,583,90,995,0
신리→연산교차로,2023.6.27 13:00,460,280,55,795,0
안락→연산교차로,2023.6.27 13:00,475,0,105,580,0
연산터널→연산교차로,2023.6.27 13:00,247,290,33,570,0
교대→연산교차로,2023.6.27 14:00,367,0,493,860,0
부산시청→연산교차로,2023.6.27 14:00,552,435,280,1267,0
사직운동장→연산교차로,2023.6.27 14:00,338,643,86,1067,0
신리→연산교차로,2023.6.27 14:00,455,265,63,783,0
안락→연산교차로,2023.6.27 14:00,445,0,125,570,0
연산터널→연산교차로,2023.6.27 14:00,256,250,41,547,0
교대→연산교차로,2023.6.27 15:00,377,0,525,902,0
부산시청→연산교차로,2023.6.27 15:00,598,451,296,1345,0
사직운동장→연산교차로,2023.6.27 15:00,321,622,96,1039,0
신리→연산교차로,2023.6.27 15:00,444,299,59,802,0
안락→연산교차로,2023.6.27 15:00,427,0,114,541,0
연산터널→연산교차로,2023.6.27 15:00,229,283,50,562,0
교대→연산교차로,2023.6.27 16:00,377,0,553,930,0
부산시청→연산교차로,2023.6.27 16:00,541,470,317,1328,0
사직운동장→연산교차로,2023.6.27 16:00,351,666,73,1090,0
신리→연산교차로,2023.6.27 16:00,523,295,51,869,0
안락→연산교차로,2023.6.27 16:00,449,0,105,554,0
연산터널→연산교차로,2023.6.27 16:00,265,256,37,558,0
교대→연산교차로,2023.6.27 17:00,372,0,511,883,0
부산시청→연산교차로,2023.6.27 17:00,578,499,308,1385,0
사직운동장→연산교차로,2023.6.27 17:00,321,683,47,1051,0
신리→연산교차로,2023.6.27 17:00,518,300,53,871,0
안락→연산교차로,2023.6.27 17:00,478,0,127,605,0
연산터널→연산교차로,2023.6.27 17:00,236,282,46,564,0
교대→연산교차로,2023.6.27 18:00,354,0,575,929,0
부산시청→연산교차로,2023.6.27 18:00,584,522,317,1423,0
사직운동장→연산교차로,2023.6.27 18:00,335,681,57,1073,0
신리→연산교차로,2023.6.27 18:00,502,279,50,831,0
안락→연산교차로,2023.6.27 18:00,478,0,89,567,0
연산터널→연산교차로,2023.6.27 18:00,230,289,47,566,0
교대→연산교차로,2023.6.27 19:00,333,0,391,724,0
부산시청→연산교차로,2023.6.27 19:00,570,398,309,1277,0
사직운동장→연산교차로,2023.6.27 19:00,214,552,70,836,0
신리→연산교차로,2023.6.27 19:00,359,193,49,601,0
안락→연산교차로,2023.6.27 19:00,417,0,89,506,0
연산터널→연산교차로,2023.6.27 19:00,210,235,78,523,0
교대→연산교차로,2023.6.27 20:00,307,0,320,627,0
부산시청→연산교차로,2023.6.27 20:00,481,348,244,1073,0
사직운동장→연산교차로,2023.6.27 20:00,176,510,76,762,0
신리→연산교차로,2023.6.27 20:00,325,180,37,542,0
안락→연산교차로,2023.6.27 20:00,408,0,91,499,0
연산터널→연산교차로,2023.6.27 20:00,214,273,49,536,0
교대→연산교차로,2023.6.27 21:00,276,0,265,541,0
부산시청→연산교차로,2023.6.27 21:00,467,322,237,1026,0
사직운동장→연산교차로,2023.6.27 21:00,234,431,62,727,0
신리→연산교차로,2023.6.27 21:00,308,197,20,525,0
안락→연산교차로,2023.6.27 21:00,414,0,107,521,0
연산터널→연산교차로,2023.6.27 21:00,228,274,59,561,0
교대→연산교차로,2023.6.27 22:00,233,0,208,441,0
부산시청→연산교차로,2023.6.27 22:00,422,269,152,843,0
사직운동장→연산교차로,2023.6.27 22:00,218,411,25,654,0
신리→연산교차로,2023.6.27 22:00,275,151,16,442,0
안락→연산교차로,2023.6.27 22:00,340,0,78,418,0
연산터널→연산교차로,2023.6.27 22:00,197,213,45,455,0
교대→연산교차로,2023.6.27 23:00,172,0,160,332,0
부산시청→연산교차로,2023.6.27 23:00,294,218,107,619,0
사직운동장→연산교차로,2023.6.27 23:00,131,262,22,415,0
신리→연산교차로,2023.6.27 23:00,194,127,13,334,0
안락→연산교차로,2023.6.27 23:00,252,0,73,325,0
연산터널→연산교차로,2023.6.27 23:00,152,170,39,361,0
교대→연산교차로,2023.6.28 00:00,119,0,163,282,0
부산시청→연산교차로,2023.6.28 00:00,242,153,108,503,0
사직운동장→연산교차로,2023.6.28 00:00,99,220,5,324,0
신리→연산교차로,2023.6.28 00:00,154,85,10,249,0
안락→연산교차로,2023.6.28 00:00,200,0,53,253,0
연산터널→연산교차로,2023.6.28 00:00,126,141,7,274,0
교대→연산교차로,2023.6.28 01:00,99,0,116,215,0
부산시청→연산교차로,2023.6.28 01:00,185,114,76,375,0
사직운동장→연산교차로,2023.6.28 01:00,62,194,6,262,0
신리→연산교차로,2023.6.28 01:00,151,63,17,231,0
안락→연산교차로,2023.6.28 01:00,141,0,51,192,0
연산터널→연산교차로,2023.6.28 01:00,90,130,11,231,0
교대→연산교차로,2023.6.28 02:00,61,0,99,160,0
부산시청→연산교차로,2023.6.28 02:00,158,94,53,305,0
사직운동장→연산교차로,2023.6.28 02:00,54,143,3,200,0
신리→연산교차로,2023.6.28 02:00,66,51,16,133,0
안락→연산교차로,2023.6.28 02:00,118,0,33,151,0
연산터널→연산교차로,2023.6.28 02:00,88,115,23,226,0
교대→연산교차로,2023.6.28 03:00,59,0,109,168,0
부산시청→연산교차로,2023.6.28 03:00,133,60,45,238,0
사직운동장→연산교차로,2023.6.28 03:00,46,114,10,170,0
신리→연산교차로,2023.6.28 03:00,76,31,13,120,0
안락→연산교차로,2023.6.28 03:00,110,0,31,141,0
연산터널→연산교차로,2023.6.28 03:00,71,75,28,174,0
교대→연산교차로,2023.6.28 04:00,48,0,66,114,0
부산시청→연산교차로,2023.6.28 04:00,135,89,31,255,0
사직운동장→연산교차로,2023.6.28 04:00,50,151,16,217,0
신리→연산교차로,2023.6.28 04:00,83,44,8,135,0
안락→연산교차로,2023.6.28 04:00,174,0,22,196,0
연산터널→연산교차로,2023.6.28 04:00,76,96,9,181,0
교대→연산교차로,2023.6.28 05:00,99,0,116,215,0
부산시청→연산교차로,2023.6.28 05:00,226,151,70,447,0
사직운동장→연산교차로,2023.6.28 05:00,57,168,30,255,0
신리→연산교차로,2023.6.28 05:00,182,87,7,276,0
안락→연산교차로,2023.6.28 05:00,314,0,50,364,0
연산터널→연산교차로,2023.6.28 05:00,135,130,42,307,0
교대→연산교차로,2023.6.28 06:00,178,0,239,417,0
부산시청→연산교차로,2023.6.28 06:00,356,233,150,739,0
사직운동장→연산교차로,2023.6.28 06:00,121,257,45,423,0
신리→연산교차로,2023.6.28 06:00,319,156,34,509,0
안락→연산교차로,2023.6.28 06:00,487,0,76,563,0
연산터널→연산교차로,2023.6.28 06:00,238,229,43,510,0
교대→연산교차로,2023.6.28 07:00,274,0,412,686,0
부산시청→연산교차로,2023.6.28 07:00,519,371,220,1110,0
사직운동장→연산교차로,2023.6.28 07:00,202,472,42,716,0
신리→연산교차로,2023.6.28 07:00,492,248,29,769,0
안락→연산교차로,2023.6.28 07:00,614,0,94,708,0
연산터널→연산교차로,2023.6.28 07:00,298,373,45,716,0
교대→연산교차로,2023.6.28 08:00,308,0,465,773,0
부산시청→연산교차로,2023.6.28 08:00,606,450,314,1370,0
사직운동장→연산교차로,2023.6.28 08:00,258,666,71,995,0
신리→연산교차로,2023.6.28 08:00,523,326,30,879,0
안락→연산교차로,2023.6.28 08:00,617,0,122,739,0
연산터널→연산교차로,2023.6.28 08:00,329,366,37,732,0
교대→연산교차로,2023.6.28 09:00,285,0,497,782,0
부산시청→연산교차로,2023.6.28 09:00,494,373,299,1166,0
사직운동장→연산교차로,2023.6.28 09:00,252,595,86,933,0
신리→연산교차로,2023.6.28 09:00,459,319,52,830,0
안락→연산교차로,2023.6.28 09:00,572,0,100,672,0
연산터널→연산교차로,2023.6.28 09:00,298,360,37,695,0
교대→연산교차로,2023.6.28 10:00,304,0,457,761,0
부산시청→연산교차로,2023.6.28 10:00,558,344,239,1141,0
사직운동장→연산교차로,2023.6.28 10:00,278,551,72,901,0
신리→연산교차로,2023.6.28 10:00,477,266,50,793,0
안락→연산교차로,2023.6.28 10:00,574,0,122,696,0
연산터널→연산교차로,2023.6.28 10:00,268,352,42,662,0
교대→연산교차로,2023.6.28 11:00,305,0,453,758,0
부산시청→연산교차로,2023.6.28 11:00,569,371,237,1177,0
사직운동장→연산교차로,2023.6.28 11:00,323,570,67,960,0
신리→연산교차로,2023.6.28 11:00,445,255,57,757,0
안락→연산교차로,2023.6.28 11:00,510,0,177,687,0
연산터널→연산교차로,2023.6.28 11:00,283,306,38,627,0
교대→연산교차로,2023.6.28 12:00,296,0,369,665,0
부산시청→연산교차로,2023.6.28 12:00,521,366,239,1126,0
사직운동장→연산교차로,2023.6.28 12:00,298,565,68,931,0
신리→연산교차로,2023.6.28 12:00,455,254,38,747,0
안락→연산교차로,2023.6.28 12:00,501,0,148,649,0
연산터널→연산교차로,2023.6.28 12:00,282,299,51,632,0
교대→연산교차로,2023.6.28 13:00,334,0,419,753,0
부산시청→연산교차로,2023.6.28 13:00,548,445,253,1246,0
사직운동장→연산교차로,2023.6.28 13:00,332,576,104,1012,0
신리→연산교차로,2023.6.28 13:00,426,276,50,752,0
안락→연산교차로,2023.6.28 13:00,448,0,118,566,0
연산터널→연산교차로,2023.6.28 13:00,250,267,36,553,0
교대→연산교차로,2023.6.28 14:00,344,0,503,847,0
부산시청→연산교차로,2023.6.28 14:00,535,406,283,1224,0
사직운동장→연산교차로,2023.6.28 14:00,322,610,98,1030,0
신리→연산교차로,2023.6.28 14:00,470,299,68,837,0
안락→연산교차로,2023.6.28 14:00,464,0,121,585,0
연산터널→연산교차로,2023.6.28 14:00,241,285,49,575,0
교대→연산교차로,2023.6.28 15:00,352,0,485,837,0
부산시청→연산교차로,2023.6.28 15:00,564,492,281,1337,0
사직운동장→연산교차로,2023.6.28 15:00,339,672,89,1100,0
신리→연산교차로,2023.6.28 15:00,501,264,52,817,0
안락→연산교차로,2023.6.28 15:00,451,0,93,544,0
연산터널→연산교차로,2023.6.28 15:00,234,288,46,568,0
교대→연산교차로,2023.6.28 16:00,361,0,496,857,0
부산시청→연산교차로,2023.6.28 16:00,600,528,315,1443,0
사직운동장→연산교차로,2023.6.28 16:00,332,654,43,1029,0
신리→연산교차로,2023.6.28 16:00,509,292,54,855,0
안락→연산교차로,2023.6.28 16:00,469,0,109,578,0
연산터널→연산교차로,2023.6.28 16:00,248,280,37,565,0
교대→연산교차로,2023.6.28 17:00,367,0,522,889,0
부산시청→연산교차로,2023.6.28 17:00,622,578,302,1502,0
사직운동장→연산교차로,2023.6.28 17:00,349,720,41,1110,0
신리→연산교차로,2023.6.28 17:00,537,296,55,888,0
안락→연산교차로,2023.6.28 17:00,449,0,126,575,0
연산터널→연산교차로,2023.6.28 17:00,251,277,43,571,0
교대→연산교차로,2023.6.28 18:00,380,0,609,989,0
부산시청→연산교차로,2023.6.28 18:00,597,596,346,1539,0
사직운동장→연산교차로,2023.6.28 18:00,323,697,31,1051,0
신리→연산교차로,2023.6.28 18:00,491,259,42,792,0
안락→연산교차로,2023.6.28 18:00,476,0,78,554,0
연산터널→연산교차로,2023.6.28 18:00,229,275,51,555,0
교대→연산교차로,2023.6.28 19:00,350,0,393,743,0
부산시청→연산교차로,2023.6.28 19:00,566,429,252,1247,0
사직운동장→연산교차로,2023.6.28 19:00,193,529,77,799,0
신리→연산교차로,2023.6.28 19:00,326,214,35,575,0
안락→연산교차로,2023.6.28 19:00,438,0,96,534,0
연산터널→연산교차로,2023.6.28 19:00,204,265,58,527,0
교대→연산교차로,2023.6.28 20:00,317,0,341,658,0
부산시청→연산교차로,2023.6.28 20:00,459,386,229,1074,0
사직운동장→연산교차로,2023.6.28 20:00,181,482,101,764,0
신리→연산교차로,2023.6.28 20:00,316,175,34,525,0
안락→연산교차로,2023.6.28 20:00,396,0,106,502,0
연산터널→연산교차로,2023.6.28 20:00,206,254,59,519,0
교대→연산교차로,2023.6.28 21:00,271,0,277,548,0
부산시청→연산교차로,2023.6.28 21:00,485,318,245,1048,0
사직운동장→연산교차로,2023.6.28 21:00,198,433,73,704,0
신리→연산교차로,2023.6.28 21:00,304,179,31,514,0
안락→연산교차로,2023.6.28 21:00,410,0,94,504,0
연산터널→연산교차로,2023.6.28 21:00,215,267,54,536,0
교대→연산교차로,2023.6.28 22:00,231,0,233,464,0
부산시청→연산교차로,2023.6.28 22:00,400,266,160,826,0
사직운동장→연산교차로,2023.6.28 22:00,232,419,58,709,0
신리→연산교차로,2023.6.28 22:00,276,158,18,452,0
안락→연산교차로,2023.6.28 22:00,375,0,85,460,0
연산터널→연산교차로,2023.6.28 22:00,194,195,48,437,0
교대→연산교차로,2023.6.28 23:00,211,0,202,413,0
부산시청→연산교차로,2023.6.28 23:00,328,180,143,651,0
사직운동장→연산교차로,2023.6.28 23:00,145,314,52,511,0
신리→연산교차로,2023.6.28 23:00,220,132,21,373,0
안락→연산교차로,2023.6.28 23:00,255,0,68,323,0
연산터널→연산교차로,2023.6.28 23:00,165,153,39,357,0
교대→연산교차로,2023.6.29 00:00,147,0,169,316,0
부산시청→연산교차로,2023.6.29 00:00,270,134,93,497,0
사직운동장→연산교차로,2023.6.29 00:00,99,238,46,383,0
신리→연산교차로,2023.6.29 00:00,168,82,12,262,0
안락→연산교차로,2023.6.29 00:00,197,0,52,249,0
연산터널→연산교차로,2023.6.29 00:00,125,157,43,325,0
교대→연산교차로,2023.6.29 01:00,122,0,149,271,0
부산시청→연산교차로,2023.6.29 01:00,190,120,77,387,0
사직운동장→연산교차로,2023.6.29 01:00,83,185,46,314,0
신리→연산교차로,2023.6.29 01:00,128,65,19,212,0
안락→연산교차로,2023.6.29 01:00,153,0,48,201,0
연산터널→연산교차로,2023.6.29 01:00,126,122,57,305,0
교대→연산교차로,2023.6.29 02:00,73,0,115,188,0
부산시청→연산교차로,2023.6.29 02:00,174,87,59,320,0
사직운동장→연산교차로,2023.6.29 02:00,56,143,22,221,0
신리→연산교차로,2023.6.29 02:00,116,68,17,201,0
안락→연산교차로,2023.6.29 02:00,150,0,27,177,0
연산터널→연산교차로,2023.6.29 02:00,104,123,36,263,0
교대→연산교차로,2023.6.29 03:00,71,0,112,183,0
부산시청→연산교차로,2023.6.29 03:00,159,74,45,278,0
사직운동장→연산교차로,2023.6.29 03:00,44,121,17,182,0
신리→연산교차로,2023.6.29 03:00,78,50,9,137,0
안락→연산교차로,2023.6.29 03:00,120,0,23,143,0
연산터널→연산교차로,2023.6.29 03:00,89,105,29,223,0
교대→연산교차로,2023.6.29 04:00,47,0,88,135,0
부산시청→연산교차로,2023.6.29 04:00,151,78,44,273,0
사직운동장→연산교차로,2023.6.29 04:00,38,119,20,177,0
신리→연산교차로,2023.6.29 04:00,91,48,9,148,0
안락→연산교차로,2023.6.29 04:00,160,0,23,183,0
연산터널→연산교차로,2023.6.29 04:00,94,106,17,217,0
교대→연산교차로,2023.6.29 05:00,105,0,137,242,0
부산시청→연산교차로,2023.6.29 05:00,236,147,73,456,0
사직운동장→연산교차로,2023.6.29 05:00,60,192,46,298,0
신리→연산교차로,2023.6.29 05:00,195,87,17,299,0
안락→연산교차로,2023.6.29 05:00,322,0,58,380,0
연산터널→연산교차로,2023.6.29 05:00,136,133,21,290,0
교대→연산교차로,2023.6.29 06:00,187,0,264,451,0
부산시청→연산교차로,2023.6.29 06:00,359,236,111,706,0
사직운동장→연산교차로,2023.6.29 06:00,128,304,35,467,0
신리→연산교차로,2023.6.29 06:00,328,158,23,509,0
안락→연산교차로,2023.6.29 06:00,539,0,74,613,0
연산터널→연산교차로,2023.6.29 06:00,245,244,39,528,0
교대→연산교차로,2023.6.29 07:00,257,0,373,630,0
부산시청→연산교차로,2023.6.29 07:00,543,375,240,1158,0
사직운동장→연산교차로,2023.6.29 07:00,237,497,71,805,0
신리→연산교차로,2023.6.29 07:00,480,264,28,772,0
안락→연산교차로,2023.6.29 07:00,638,0,81,719,0
연산터널→연산교차로,2023.6.29 07:00,311,373,46,730,0
교대→연산교차로,2023.6.29 08:00,318,0,491,809,0
부산시청→연산교차로,2023.6.29 08:00,568,430,310,1308,0
사직운동장→연산교차로,2023.6.29 08:00,276,633,83,992,0
신리→연산교차로,2023.6.29 08:00,542,340,38,920,0
안락→연산교차로,2023.6.29 08:00,627,0,98,725,0
연산터널→연산교차로,2023.6.29 08:00,299,376,35,710,0
교대→연산교차로,2023.6.29 09:00,292,0,518,810,0
부산시청→연산교차로,2023.6.29 09:00,539,367,283,1189,0
사직운동장→연산교차로,2023.6.29 09:00,259,580,82,921,0
신리→연산교차로,2023.6.29 09:00,457,330,68,855,0
안락→연산교차로,2023.6.29 09:00,598,0,110,708,0
연산터널→연산교차로,2023.6.29 09:00,314,378,47,739,0
교대→연산교차로,2023.6.29 10:00,297,0,454,751,0
부산시청→연산교차로,2023.6.29 10:00,573,364,267,1204,0
사직운동장→연산교차로,2023.6.29 10:00,384,587,83,1054,0
신리→연산교차로,2023.6.29 10:00,451,274,89,814,0
안락→연산교차로,2023.6.29 10:00,540,0,122,662,0
연산터널→연산교차로,2023.6.29 10:00,292,332,50,674,0
교대→연산교차로,2023.6.29 11:00,310,0,458,768,0
부산시청→연산교차로,2023.6.29 11:00,548,373,252,1173,0
사직운동장→연산교차로,2023.6.29 11:00,329,581,61,971,0
신리→연산교차로,2023.6.29 11:00,445,244,72,761,0
안락→연산교차로,2023.6.29 11:00,499,0,150,649,0
연산터널→연산교차로,2023.6.29 11:00,257,289,54,600,0
교대→연산교차로,2023.6.29 12:00,300,0,423,723,0
부산시청→연산교차로,2023.6.29 12:00,551,343,253,1147,0
사직운동장→연산교차로,2023.6.29 12:00,255,566,69,890,0
신리→연산교차로,2023.6.29 12:00,409,245,73,727,0
안락→연산교차로,2023.6.29 12:00,504,0,155,659,0
연산터널→연산교차로,2023.6.29 12:00,270,275,46,591,0
교대→연산교차로,2023.6.29 13:00,336,0,446,782,0
부산시청→연산교차로,2023.6.29 13:00,538,431,253,1222,0
사직운동장→연산교차로,2023.6.29 13:00,271,567,75,913,0
신리→연산교차로,2023.6.29 13:00,464,268,83,815,0
안락→연산교차로,2023.6.29 13:00,452,0,113,565,0
연산터널→연산교차로,2023.6.29 13:00,228,260,46,534,0
교대→연산교차로,2023.6.29 14:00,329,0,498,827,0
부산시청→연산교차로,2023.6.29 14:00,520,430,298,1248,0
사직운동장→연산교차로,2023.6.29 14:00,292,612,80,984,0
신리→연산교차로,2023.6.29 14:00,439,255,89,783,0
안락→연산교차로,2023.6.29 14:00,456,0,112,568,0
연산터널→연산교차로,2023.6.29 14:00,235,275,49,559,0
교대→연산교차로,2023.6.29 15:00,338,0,506,844,0
부산시청→연산교차로,2023.6.29 15:00,571,502,280,1353,0
사직운동장→연산교차로,2023.6.29 15:00,321,623,84,1028,0
신리→연산교차로,2023.6.29 15:00,479,255,62,796,0
안락→연산교차로,2023.6.29 15:00,447,0,111,558,0
연산터널→연산교차로,2023.6.29 15:00,219,293,39,551,0
교대→연산교차로,2023.6.29 16:00,337,0,494,831,0
부산시청→연산교차로,2023.6.29 16:00,559,494,290,1343,0
사직운동장→연산교차로,2023.6.29 16:00,312,631,62,1005,0
신리→연산교차로,2023.6.29 16:00,461,262,57,780,0
안락→연산교차로,2023.6.29 16:00,431,0,92,523,0
연산터널→연산교차로,2023.6.29 16:00,196,280,46,522,0
교대→연산교차로,2023.6.29 17:00,344,0,527,871,0
부산시청→연산교차로,2023.6.29 17:00,567,553,303,1423,0
사직운동장→연산교차로,2023.6.29 17:00,271,643,39,953,0
신리→연산교차로,2023.6.29 17:00,513,280,46,839,0
안락→연산교차로,2023.6.29 17:00,438,0,108,546,0
연산터널→연산교차로,2023.6.29 17:00,233,271,33,537,0
교대→연산교차로,2023.6.29 18:00,343,0,545,888,0
부산시청→연산교차로,2023.6.29 18:00,564,553,322,1439,0
사직운동장→연산교차로,2023.6.29 18:00,257,667,36,960,0
신리→연산교차로,2023.6.29 18:00,545,242,34,821,0
안락→연산교차로,2023.6.29 18:00,446,0,86,532,0
연산터널→연산교차로,2023.6.29 18:00,214,287,47,548,0
교대→연산교차로,2023.6.29 19:00,321,0,399,720,0
부산시청→연산교차로,2023.6.29 19:00,531,422,302,1255,0
사직운동장→연산교차로,2023.6.29 19:00,222,548,50,820,0
신리→연산교차로,2023.6.29 19:00,321,201,36,558,0
안락→연산교차로,2023.6.29 19:00,403,0,87,490,0
연산터널→연산교차로,2023.6.29 19:00,204,273,49,526,0
교대→연산교차로,2023.6.29 20:00,309,0,272,581,0
부산시청→연산교차로,2023.6.29 20:00,473,366,226,1065,0
사직운동장→연산교차로,2023.6.29 20:00,195,445,54,694,0
신리→연산교차로,2023.6.29 20:00,276,156,33,465,0
안락→연산교차로,2023.6.29 20:00,389,0,100,489,0
연산터널→연산교차로,2023.6.29 20:00,188,259,33,480,0
교대→연산교차로,2023.6.29 21:00,271,0,280,551,0
부산시청→연산교차로,2023.6.29 21:00,478,327,212,1017,0
사직운동장→연산교차로,2023.6.29 21:00,190,400,74,664,0
신리→연산교차로,2023.6.29 21:00,290,172,12,474,0
안락→연산교차로,2023.6.29 21:00,376,0,91,467,0
연산터널→연산교차로,2023.6.29 21:00,215,249,58,522,0
교대→연산교차로,2023.6.29 22:00,213,0,184,397,0
부산시청→연산교차로,2023.6.29 22:00,405,243,181,829,0
사직운동장→연산교차로,2023.6.29 22:00,172,327,49,548,0
신리→연산교차로,2023.6.29 22:00,238,144,17,399,0
안락→연산교차로,2023.6.29 22:00,350,0,84,434,0
연산터널→연산교차로,2023.6.29 22:00,197,228,46,471,0
교대→연산교차로,2023.6.29 23:00,185,0,178,363,0
부산시청→연산교차로,2023.6.29 23:00,318,191,137,646,0
사직운동장→연산교차로,2023.6.29 23:00,92,284,54,430,0
신리→연산교차로,2023.6.29 23:00,198,120,14,332,0
안락→연산교차로,2023.6.29 23:00,276,0,62,338,0
연산터널→연산교차로,2023.6.29 23:00,141,201,52,394,0
교대→연산교차로,2023.6.30 00:00,135,0,183,318,0
부산시청→연산교차로,2023.6.30 00:00,252,150,93,495,0
사직운동장→연산교차로,2023.6.30 00:00,93,204,52,349,0
신리→연산교차로,2023.6.30 00:00,146,116,18,280,0
안락→연산교차로,2023.6.30 00:00,181,0,52,233,0
연산터널→연산교차로,2023.6.30 00:00,127,164,51,342,0
교대→연산교차로,2023.6.30 01:00,104,0,147,251,0
부산시청→연산교차로,2023.6.30 01:00,223,123,89,435,0
사직운동장→연산교차로,2023.6.30 01:00,62,178,21,261,0
신리→연산교차로,2023.6.30 01:00,111,49,13,173,0
안락→연산교차로,2023.6.30 01:00,158,0,42,200,0
연산터널→연산교차로,2023.6.30 01:00,104,130,35,269,0
교대→연산교차로,2023.6.30 02:00,67,0,104,171,0
부산시청→연산교차로,2023.6.30 02:00,138,76,56,270,0
사직운동장→연산교차로,2023.6.30 02:00,59,141,24,224,0
신리→연산교차로,2023.6.30 02:00,70,54,8,132,0
안락→연산교차로,2023.6.30 02:00,144,0,24,168,0
연산터널→연산교차로,2023.6.30 02:00,83,119,17,219,0
교대→연산교차로,2023.6.30 03:00,65,0,78,143,0
부산시청→연산교차로,2023.6.30 03:00,145,69,36,250,0
사직운동장→연산교차로,2023.6.30 03:00,34,115,25,174,0
신리→연산교차로,2023.6.30 03:00,73,33,6,112,0
안락→연산교차로,2023.6.30 03:00,96,0,24,120,0
연산터널→연산교차로,2023.6.30 03:00,72,108,20,200,0
교대→연산교차로,2023.6.30 04:00,51,0,60,111,0
부산시청→연산교차로,2023.6.30 04:00,143,83,52,278,0
사직운동장→연산교차로,2023.6.30 04:00,47,106,20,173,0
신리→연산교차로,2023.6.30 04:00,80,35,6,121,0
안락→연산교차로,2023.6.30 04:00,148,0,29,177,0
연산터널→연산교차로,2023.6.30 04:00,75,102,11,188,0
교대→연산교차로,2023.6.30 05:00,93,0,133,226,0
부산시청→연산교차로,2023.6.30 05:00,196,123,59,378,0
사직운동장→연산교차로,2023.6.30 05:00,60,165,37,262,0
신리→연산교차로,2023.6.30 05:00,176,91,10,277,0
안락→연산교차로,2023.6.30 05:00,255,0,47,302,0
연산터널→연산교차로,2023.6.30 05:00,131,105,24,260,0
교대→연산교차로,2023.6.30 06:00,164,0,204,368,0
부산시청→연산교차로,2023.6.30 06:00,312,217,105,634,0
사직운동장→연산교차로,2023.6.30 06:00,98,243,40,381,0
신리→연산교차로,2023.6.30 06:00,320,148,23,491,0
안락→연산교차로,2023.6.30 06:00,493,0,73,566,0
연산터널→연산교차로,2023.6.30 06:00,218,222,53,493,0
교대→연산교차로,2023.6.30 07:00,261,0,369,630,0
부산시청→연산교차로,2023.6.30 07:00,505,347,199,1051,0
사직운동장→연산교차로,2023.6.30 07:00,208,488,45,741,0
신리→연산교차로,2023.6.30 07:00,481,248,24,753,0
안락→연산교차로,2023.6.30 07:00,598,0,72,670,0
연산터널→연산교차로,2023.6.30 07:00,269,366,48,683,0
교대→연산교차로,2023.6.30 08:00,296,0,506,802,0
부산시청→연산교차로,2023.6.30 08:00,548,411,310,1269,0
사직운동장→연산교차로,2023.6.30 08:00,307,632,53,992,0
신리→연산교차로,2023.6.30 08:00,500,331,20,851,0
안락→연산교차로,2023.6.30 08:00,604,0,102,706,0
연산터널→연산교차로,2023.6.30 08:00,312,390,36,738,0
교대→연산교차로,2023.6.30 09:00,272,0,511,783,0
부산시청→연산교차로,2023.6.30 09:00,500,359,286,1145,0
사직운동장→연산교차로,2023.6.30 09:00,309,546,107,962,0
신리→연산교차로,2023.6.30 09:00,453,317,41,811,0
안락→연산교차로,2023.6.30 09:00,571,0,107,678,0
연산터널→연산교차로,2023.6.30 09:00,286,372,32,690,0
교대→연산교차로,2023.6.30 10:00,298,0,446,744,0
부산시청→연산교차로,2023.6.30 10:00,498,376,295,1169,0
사직운동장→연산교차로,2023.6.30 10:00,287,592,89,968,0
신리→연산교차로,2023.6.30 10:00,499,307,57,863,0
안락→연산교차로,2023.6.30 10:00,559,0,104,663,0
연산터널→연산교차로,2023.6.30 10:00,281,355,46,682,0
교대→연산교차로,2023.6.30 11:00,303,0,517,820,0
부산시청→연산교차로,2023.6.30 11:00,615,390,249,1254,0
사직운동장→연산교차로,2023.6.30 11:00,419,556,75,1050,0
신리→연산교차로,2023.6.30 11:00,485,269,73,827,0
안락→연산교차로,2023.6.30 11:00,551,0,136,687,0
연산터널→연산교차로,2023.6.30 11:00,256,322,70,648,0
교대→연산교차로,2023.6.30 12:00,307,0,410,717,0
부산시청→연산교차로,2023.6.30 12:00,560,346,251,1157,0
사직운동장→연산교차로,2023.6.30 12:00,272,555,92,919,0
신리→연산교차로,2023.6.30 12:00,415,273,42,730,0
안락→연산교차로,2023.6.30 12:00,543,0,144,687,0
연산터널→연산교차로,2023.6.30 12:00,259,305,47,611,0
교대→연산교차로,2023.6.30 13:00,337,0,469,806,0
부산시청→연산교차로,2023.6.30 13:00,606,449,306,1361,0
사직운동장→연산교차로,2023.6.30 13:00,300,584,80,964,0
신리→연산교차로,2023.6.30 13:00,419,282,43,744,0
안락→연산교차로,2023.6.30 13:00,488,0,101,589,0
연산터널→연산교차로,2023.6.30 13:00,231,304,41,576,0
교대→연산교차로,2023.6.30 14:00,339,0,534,873,0
부산시청→연산교차로,2023.6.30 14:00,558,473,343,1374,0
사직운동장→연산교차로,2023.6.30 14:00,306,652,92,1050,0
신리→연산교차로,2023.6.30 14:00,461,302,50,813,0
안락→연산교차로,2023.6.30 14:00,481,0,113,594,0
연산터널→연산교차로,2023.6.30 14:00,251,282,34,567,0
교대→연산교차로,2023.6.30 15:00,357,0,512,869,0
부산시청→연산교차로,2023.6.30 15:00,609,528,289,1426,0
사직운동장→연산교차로,2023.6.30 15:00,381,673,83,1137,0
신리→연산교차로,2023.6.30 15:00,509,255,47,811,0
안락→연산교차로,2023.6.30 15:00,475,0,90,565,0
연산터널→연산교차로,2023.6.30 15:00,250,276,48,574,0
교대→연산교차로,2023.6.30 16:00,359,0,528,887,0
부산시청→연산교차로,2023.6.30 16:00,602,533,356,1491,0
사직운동장→연산교차로,2023.6.30 16:00,296,660,56,1012,0
신리→연산교차로,2023.6.30 16:00,545,293,49,887,0
안락→연산교차로,2023.6.30 16:00,448,0,100,548,0
연산터널→연산교차로,2023.6.30 16:00,248,279,55,582,0
교대→연산교차로,2023.6.30 17:00,382,0,560,942,0
부산시청→연산교차로,2023.6.30 17:00,621,535,339,1495,0
사직운동장→연산교차로,2023.6.30 17:00,309,587,35,931,0
신리→연산교차로,2023.6.30 17:00,516,292,48,856,0
안락→연산교차로,2023.6.30 17:00,481,0,94,575,0
연산터널→연산교차로,2023.6.30 17:00,239,257,45,541,0
교대→연산교차로,2023.6.30 18:00,378,0,579,957,0
부산시청→연산교차로,2023.6.30 18:00,599,578,351,1528,0
사직운동장→연산교차로,2023.6.30 18:00,315,686,59,1060,0
신리→연산교차로,2023.6.30 18:00,551,261,60,872,0
안락→연산교차로,2023.6.30 18:00,493,0,85,578,0
연산터널→연산교차로,2023.6.30 18:00,232,281,60,573,0
교대→연산교차로,2023.6.30 19:00,345,0,450,795,0
부산시청→연산교차로,2023.6.30 19:00,554,421,287,1262,0
사직운동장→연산교차로,2023.6.30 19:00,189,569,76,834,0
신리→연산교차로,2023.6.30 19:00,390,220,52,662,0
안락→연산교차로,2023.6.30 19:00,444,0,110,554,0
연산터널→연산교차로,2023.6.30 19:00,219,274,69,562,0
교대→연산교차로,2023.6.30 20:00,292,0,333,625,0
부산시청→연산교차로,2023.6.30 20:00,490,379,246,1115,0
사직운동장→연산교차로,2023.6.30 20:00,184,490,88,762,0
신리→연산교차로,2023.6.30 20:00,356,182,44,582,0
안락→연산교차로,2023.6.30 20:00,377,0,107,484,0
연산터널→연산교차로,2023.6.30 20:00,210,277,59,546,0
교대→연산교차로,2023.6.30 21:00,276,0,318,594,0
부산시청→연산교차로,2023.6.30 21:00,522,341,191,1054,0
사직운동장→연산교차로,2023.6.30 21:00,200,440,106,746,0
신리→연산교차로,2023.6.30 21:00,331,192,35,558,0
안락→연산교차로,2023.6.30 21:00,438,0,104,542,0
연산터널→연산교차로,2023.6.30 21:00,254,268,77,599,0
교대→연산교차로,2023.6.30 22:00,276,0,293,569,0
부산시청→연산교차로,2023.6.30 22:00,436,288,175,899,0
사직운동장→연산교차로,2023.6.30 22:00,158,402,95,655,0
신리→연산교차로,2023.6.30 22:00,285,157,33,475,0
안락→연산교차로,2023.6.30 22:00,368,0,104,472,0
연산터널→연산교차로,2023.6.30 22:00,225,269,77,571,0
교대→연산교차로,2023.6.30 23:00,233,0,261,494,0
부산시청→연산교차로,2023.6.30 23:00,379,245,138,762,0
사직운동장→연산교차로,2023.6.30 23:00,125,317,71,513,0
신리→연산교차로,2023.6.30 23:00,270,135,27,432,0
안락→연산교차로,2023.6.30 23:00,309,0,82,391,0
연산터널→연산교차로,2023.6.30 23:00,181,218,50,449,0
교대→연산교차로,2023.7.1 00:00,191,0,240,431,0
부산시청→연산교차로,2023.7.1 00:00,308,199,119,626,0
사직운동장→연산교차로,2023.7.1 00:00,137,284,62,483,0
신리→연산교차로,2023.7.1 00:00,215,150,18,383,0
안락→연산교차로,2023.7.1 00:00,305,0,72,377,0
연산터널→연산교차로,2023.7.1 00:00,149,203,37,389,0
교대→연산교차로,2023.7.1 01:00,135,0,212,347,0
부산시청→연산교차로,2023.7.1 01:00,269,169,99,537,0
사직운동장→연산교차로,2023.7.1 01:00,103,233,56,392,0
신리→연산교차로,2023.7.1 01:00,195,108,16,319,0
안락→연산교차로,2023.7.1 01:00,234,0,62,296,0
연산터널→연산교차로,2023.7.1 01:00,131,163,42,336,0
교대→연산교차로,2023.7.1 02:00,116,0,173,289,0
부산시청→연산교차로,2023.7.1 02:00,265,147,99,511,0
사직운동장→연산교차로,2023.7.1 02:00,83,184,41,308,0
신리→연산교차로,2023.7.1 02:00,128,85,15,228,0
안락→연산교차로,2023.7.1 02:00,199,0,49,248,0
연산터널→연산교차로,2023.7.1 02:00,143,166,44,353,0
교대→연산교차로,2023.7.1 03:00,88,0,178,266,0
부산시청→연산교차로,2023.7.1 03:00,211,114,68,393,0
사직운동장→연산교차로,2023.7.1 03:00,63,200,23,286,0
신리→연산교차로,2023.7.1 03:00,101,63,9,173,0
안락→연산교차로,2023.7.1 03:00,178,0,47,225,0
연산터널→연산교차로,2023.7.1 03:00,105,133,49,287,0
교대→연산교차로,2023.7.1 04:00,85,0,114,199,0
부산시청→연산교차로,2023.7.1 04:00,197,100,77,374,0
사직운동장→연산교차로,2023.7.1 04:00,57,142,22,221,0
신리→연산교차로,2023.7.1 04:00,104,47,11,162,0
안락→연산교차로,2023.7.1 04:00,154,0,42,196,0
연산터널→연산교차로,2023.7.1 04:00,91,138,26,255,0
교대→연산교차로,2023.7.1 05:00,111,0,135,246,0
부산시청→연산교차로,2023.7.1 05:00,222,173,81,476,0
사직운동장→연산교차로,2023.7.1 05:00,80,188,52,320,0
신리→연산교차로,2023.7.1 05:00,202,99,17,318,0
안락→연산교차로,2023.7.1 05:00,328,0,47,375,0
연산터널→연산교차로,2023.7.1 05:00,138,142,38,318,0
교대→연산교차로,2023.7.1 06:00,160,0,176,336,0
부산시청→연산교차로,2023.7.1 06:00,290,198,91,579,0
사직운동장→연산교차로,2023.7.1 06:00,116,236,36,388,0
신리→연산교차로,2023.7.1 06:00,280,115,18,413,0
안락→연산교차로,2023.7.1 06:00,389,0,86,475,0
연산터널→연산교차로,2023.7.1 06:00,159,193,39,391,0
교대→연산교차로,2023.7.1 07:00,185,0,205,390,0
부산시청→연산교차로,2023.7.1 07:00,344,246,141,731,0
사직운동장→연산교차로,2023.7.1 07:00,120,312,38,470,0
신리→연산교차로,2023.7.1 07:00,296,145,25,466,0
안락→연산교차로,2023.7.1 07:00,418,0,79,497,0
연산터널→연산교차로,2023.7.1 07:00,196,184,44,424,0
교대→연산교차로,2023.7.1 08:00,246,0,335,581,0
부산시청→연산교차로,2023.7.1 08:00,448,293,237,978,0
사직운동장→연산교차로,2023.7.1 08:00,232,524,61,817,0
신리→연산교차로,2023.7.1 08:00,376,240,42,658,0
안락→연산교차로,2023.7.1 08:00,499,0,110,609,0
연산터널→연산교차로,2023.7.1 08:00,259,299,52,610,0
교대→연산교차로,2023.7.1 09:00,287,0,357,644,0
부산시청→연산교차로,2023.7.1 09:00,526,348,265,1139,0
사직운동장→연산교차로,2023.7.1 09:00,274,581,79,934,0
신리→연산교차로,2023.7.1 09:00,504,295,62,861,0
안락→연산교차로,2023.7.1 09:00,579,0,133,712,0
연산터널→연산교차로,2023.7.1 09:00,308,296,51,655,0
교대→연산교차로,2023.7.1 10:00,302,0,421,723,0
부산시청→연산교차로,2023.7.1 10:00,549,376,275,1200,0
사직운동장→연산교차로,2023.7.1 10:00,281,630,58,969,0
신리→연산교차로,2023.7.1 10:00,510,299,67,876,0
안락→연산교차로,2023.7.1 10:00,583,0,165,748,0
연산터널→연산교차로,2023.7.1 10:00,290,368,55,713,0
교대→연산교차로,2023.7.1 11:00,318,0,521,839,0
부산시청→연산교차로,2023.7.1 11:00,575,382,294,1251,0
사직운동장→연산교차로,2023.7.1 11:00,275,626,65,966,0
신리→연산교차로,2023.7.1 11:00,533,267,76,876,0
안락→연산교차로,2023.7.1 11:00,609,0,128,737,0
연산터널→연산교차로,2023.7.1 11:00,303,353,68,724,0
교대→연산교차로,2023.7.1 12:00,326,0,460,786,0
부산시청→연산교차로,2023.7.1 12:00,587,404,335,1326,0
사직운동장→연산교차로,2023.7.1 12:00,343,642,38,1023,0
신리→연산교차로,2023.7.1 12:00,492,312,80,884,0
안락→연산교차로,2023.7.1 12:00,593,0,164,757,0
연산터널→연산교차로,2023.7.1 12:00,294,330,51,675,0
교대→연산교차로,2023.7.1 13:00,375,0,536,911,0
부산시청→연산교차로,2023.7.1 13:00,595,450,366,1411,0
사직운동장→연산교차로,2023.7.1 13:00,330,653,43,1026,0
신리→연산교차로,2023.7.1 13:00,518,283,52,853,0
안락→연산교차로,2023.7.1 13:00,498,0,102,600,0
연산터널→연산교차로,2023.7.1 13:00,250,283,44,577,0
교대→연산교차로,2023.7.1 14:00,361,0,537,898,0
부산시청→연산교차로,2023.7.1 14:00,603,492,344,1439,0
사직운동장→연산교차로,2023.7.1 14:00,353,684,58,1095,0
신리→연산교차로,2023.7.1 14:00,481,280,69,830,0
안락→연산교차로,2023.7.1 14:00,462,0,101,563,0
연산터널→연산교차로,2023.7.1 14:00,239,252,45,536,0
교대→연산교차로,2023.7.1 15:00,356,0,465,821,0
부산시청→연산교차로,2023.7.1 15:00,673,514,328,1515,0
사직운동장→연산교차로,2023.7.1 15:00,320,691,59,1070,0
신리→연산교차로,2023.7.1 15:00,465,274,65,804,0
안락→연산교차로,2023.7.1 15:00,472,0,100,572,0
연산터널→연산교차로,2023.7.1 15:00,245,267,33,545,0
교대→연산교차로,2023.7.1 16:00,361,0,446,807,0
부산시청→연산교차로,2023.7.1 16:00,678,511,319,1508,0
사직운동장→연산교차로,2023.7.1 16:00,302,699,43,1044,0
신리→연산교차로,2023.7.1 16:00,495,272,64,831,0
안락→연산교차로,2023.7.1 16:00,440,0,82,522,0
연산터널→연산교차로,2023.7.1 16:00,242,260,43,545,0
교대→연산교차로,2023.7.1 17:00,335,0,379,714,0
부산시청→연산교차로,2023.7.1 17:00,634,484,357,1475,0
사직운동장→연산교차로,2023.7.1 17:00,304,650,58,1012,0
신리→연산교차로,2023.7.1 17:00,446,261,52,759,0
안락→연산교차로,2023.7.1 17:00,473,0,106,579,0
연산터널→연산교차로,2023.7.1 17:00,245,263,54,562,0
교대→연산교차로,2023.7.1 18:00,323,0,390,713,0
부산시청→연산교차로,2023.7.1 18:00,624,461,272,1357,0
사직운동장→연산교차로,2023.7.1 18:00,274,596,67,937,0
신리→연산교차로,2023.7.1 18:00,392,247,52,691,0
안락→연산교차로,2023.7.1 18:00,477,0,124,601,0
연산터널→연산교차로,2023.7.1 18:00,218,275,57,550,0
교대→연산교차로,2023.7.1 19:00,313,0,324,637,0
부산시청→연산교차로,2023.7.1 19:00,503,357,230,1090,0
사직운동장→연산교차로,2023.7.1 19:00,204,470,49,723,0
신리→연산교차로,2023.7.1 19:00,346,199,35,580,0
안락→연산교차로,2023.7.1 19:00,449,0,102,551,0
연산터널→연산교차로,2023.7.1 19:00,225,265,58,548,0
교대→연산교차로,2023.7.1 20:00,274,0,303,577,0
부산시청→연산교차로,2023.7.1 20:00,436,346,221,1003,0
사직운동장→연산교차로,2023.7.1 20:00,188,443,95,726,0
신리→연산교차로,2023.7.1 20:00,335,186,29,550,0
안락→연산교차로,2023.7.1 20:00,436,0,107,543,0
연산터널→연산교차로,2023.7.1 20:00,199,281,54,534,0
교대→연산교차로,2023.7.1 21:00,293,0,314,607,0
부산시청→연산교차로,2023.7.1 21:00,506,355,198,1059,0
사직운동장→연산교차로,2023.7.1 21:00,202,415,95,712,0
신리→연산교차로,2023.7.1 21:00,353,213,24,590,0
안락→연산교차로,2023.7.1 21:00,444,0,95,539,0
연산터널→연산교차로,2023.7.1 21:00,231,268,75,574,0
교대→연산교차로,2023.7.1 22:00,267,0,259,526,0
부산시청→연산교차로,2023.7.1 22:00,425,272,165,862,0
사직운동장→연산교차로,2023.7.1 22:00,152,389,100,641,0
신리→연산교차로,2023.7.1 22:00,306,183,32,521,0
안락→연산교차로,2023.7.1 22:00,389,0,115,504,0
연산터널→연산교차로,2023.7.1 22:00,183,244,77,504,0
교대→연산교차로,2023.7.1 23:00,212,0,261,473,0
부산시청→연산교차로,2023.7.1 23:00,352,232,135,719,0
사직운동장→연산교차로,2023.7.1 23:00,130,311,74,515,0
신리→연산교차로,2023.7.1 23:00,274,124,23,421,0
안락→연산교차로,2023.7.1 23:00,312,0,77,389,0
연산터널→연산교차로,2023.7.1 23:00,186,234,61,481,0
교대→연산교차로,2023.7.2 00:00,188,0,203,391,1
부산시청→연산교차로,2023.7.2 00:00,333,219,119,671,1
사직운동장→연산교차로,2023.7.2 00:00,84,251,62,397,1
신리→연산교차로,2023.7.2 00:00,255,137,13,405,1
안락→연산교차로,2023.7.2 00:00,272,0,49,321,1
연산터널→연산교차로,2023.7.2 00:00,148,198,66,412,1
교대→연산교차로,2023.7.2 01:00,144,0,221,365,1
부산시청→연산교차로,2023.7.2 01:00,278,185,101,564,1
사직운동장→연산교차로,2023.7.2 01:00,74,209,49,332,1
신리→연산교차로,2023.7.2 01:00,193,104,20,317,1
안락→연산교차로,2023.7.2 01:00,238,0,53,291,1
연산터널→연산교차로,2023.7.2 01:00,131,162,51,344,1
교대→연산교차로,2023.7.2 02:00,132,0,196,328,1
부산시청→연산교차로,2023.7.2 02:00,214,129,99,442,1
사직운동장→연산교차로,2023.7.2 02:00,61,176,27,264,1
신리→연산교차로,2023.7.2 02:00,160,75,13,248,1
안락→연산교차로,2023.7.2 02:00,179,0,47,226,1
연산터널→연산교차로,2023.7.2 02:00,117,158,50,325,1
교대→연산교차로,2023.7.2 03:00,100,0,183,283,1
부산시청→연산교차로,2023.7.2 03:00,206,110,64,380,1
사직운동장→연산교차로,2023.7.2 03:00,53,164,37,254,1
신리→연산교차로,2023.7.2 03:00,93,63,9,165,1
안락→연산교차로,2023.7.2 03:00,162,0,43,205,1
연산터널→연산교차로,2023.7.2 03:00,87,139,34,260,1
교대→연산교차로,2023.7.2 04:00,75,0,122,197,1
부산시청→연산교차로,2023.7.2 04:00,191,83,57,331,1
사직운동장→연산교차로,2023.7.2 04:00,45,112,30,187,1
신리→연산교차로,2023.7.2 04:00,89,54,3,146,1
안락→연산교차로,2023.7.2 04:00,125,0,22,147,1
연산터널→연산교차로,2023.7.2 04:00,87,111,22,220,1
교대→연산교차로,2023.7.2 05:00,80,0,103,183,1
부산시청→연산교차로,2023.7.2 05:00,163,119,60,342,1
사직운동장→연산교차로,2023.7.2 05:00,51,126,32,209,1
신리→연산교차로,2023.7.2 05:00,153,72,9,234,1
안락→연산교차로,2023.7.2 05:00,194,0,54,248,1
연산터널→연산교차로,2023.7.2 05:00,104,92,31,227,1
교대→연산교차로,2023.7.2 06:00,106,0,122,228,1
부산시청→연산교차로,2023.7.2 06:00,223,161,77,461,1
사직운동장→연산교차로,2023.7.2 06:00,68,160,39,267,1
신리→연산교차로,2023.7.2 06:00,151,71,11,233,1
안락→연산교차로,2023.7.2 06:00,237,0,46,283,1
연산터널→연산교차로,2023.7.2 06:00,139,123,23,285,1
교대→연산교차로,2023.7.2 07:00,130,0,132,262,1
부산시청→연산교차로,2023.7.2 07:00,237,170,89,496,1
사직운동장→연산교차로,2023.7.2 07:00,73,260,46,379,1
신리→연산교차로,2023.7.2 07:00,199,71,25,295,1
안락→연산교차로,2023.7.2 07:00,243,0,47,290,1
연산터널→연산교차로,2023.7.2 07:00,128,146,35,309,1
교대→연산교차로,2023.7.2 08:00,184,0,166,350,1
부산시청→연산교차로,2023.7.2 08:00,268,213,154,635,1
사직운동장→연산교차로,2023.7.2 08:00,124,337,38,499,1
신리→연산교차로,2023.7.2 08:00,249,137,38,424,1
안락→연산교차로,2023.7.2 08:00,310,0,69,379,1
연산터널→연산교차로,2023.7.2 08:00,177,179,25,381,1
교대→연산교차로,2023.7.2 09:00,229,0,226,455,1
부산시청→연산교차로,2023.7.2 09:00,402,312,155,869,1
사직운동장→연산교차로,2023.7.2 09:00,151,366,38,555,1
신리→연산교차로,2023.7.2 09:00,372,189,15,576,1
안락→연산교차로,2023.7.2 09:00,429,0,83,512,1
연산터널→연산교차로,2023.7.2 09:00,252,249,41,542,1
교대→연산교차로,2023.7.2 10:00,318,0,366,684,1
부산시청→연산교차로,2023.7.2 10:00,476,349,202,1027,1
사직운동장→연산교차로,2023.7.2 10:00,226,543,52,821,1
신리→연산교차로,2023.7.2 10:00,409,194,37,640,1
안락→연산교차로,2023.7.2 10:00,512,0,115,627,1
연산터널→연산교차로,2023.7.2 10:00,267,273,43,583,1
교대→연산교차로,2023.7.2 11:00,279,0,357,636,1
부산시청→연산교차로,2023.7.2 11:00,529,348,218,1095,1
사직운동장→연산교차로,2023.7.2 11:00,225,520,32,777,1
신리→연산교차로,2023.7.2 11:00,401,211,40,652,1
안락→연산교차로,2023.7.2 11:00,544,0,116,660,1
연산터널→연산교차로,2023.7.2 11:00,274,244,46,564,1
교대→연산교차로,2023.7.2 12:00,298,0,362,660,1
부산시청→연산교차로,2023.7.2 12:00,563,374,242,1179,1
사직운동장→연산교차로,2023.7.2 12:00,267,596,41,904,1
신리→연산교차로,2023.7.2 12:00,458,213,42,713,1
안락→연산교차로,2023.7.2 12:00,577,0,118,695,1
연산터널→연산교차로,2023.7.2 12:00,268,285,47,600,1
교대→연산교차로,2023.7.2 13:00,315,0,334,649,1
부산시청→연산교차로,2023.7.2 13:00,589,385,256,1230,1
사직운동장→연산교차로,2023.7.2 13:00,248,569,27,844,1
신리→연산교차로,2023.7.2 13:00,430,228,53,711,1
안락→연산교차로,2023.7.2 13:00,512,0,133,645,1
연산터널→연산교차로,2023.7.2 13:00,267,309,59,635,1
교대→연산교차로,2023.7.2 14:00,297,0,315,612,1
부산시청→연산교차로,2023.7.2 14:00,548,386,239,1173,1
사직운동장→연산교차로,2023.7.2 14:00,260,543,28,831,1
신리→연산교차로,2023.7.2 14:00,475,227,35,737,1
안락→연산교차로,2023.7.2 14:00,519,0,121,640,1
연산터널→연산교차로,2023.7.2 14:00,245,277,38,560,1
교대→연산교차로,2023.7.2 15:00,307,0,322,629,1
부산시청→연산교차로,2023.7.2 15:00,553,402,250,1205,1
사직운동장→연산교차로,2023.7.2 15:00,230,551,43,824,1
신리→연산교차로,2023.7.2 15:00,435,196,30,661,1
안락→연산교차로,2023.7.2 15:00,546,0,130,676,1
연산터널→연산교차로,2023.7.2 15:00,254,261,47,562,1
교대→연산교차로,2023.7.2 16:00,304,0,300,604,1
부산시청→연산교차로,2023.7.2 16:00,588,371,221,1180,1
사직운동장→연산교차로,2023.7.2 16:00,239,543,41,823,1
신리→연산교차로,2023.7.2 16:00,456,201,46,703,1
안락→연산교차로,2023.7.2 16:00,543,0,134,677,1
연산터널→연산교차로,2023.7.2 16:00,263,297,47,607,1
교대→연산교차로,2023.7.2 17:00,313,0,322,635,1
부산시청→연산교차로,2023.7.2 17:00,552,390,218,1160,1
사직운동장→연산교차로,2023.7.2 17:00,213,530,41,784,1
신리→연산교차로,2023.7.2 17:00,400,215,38,653,1
안락→연산교차로,2023.7.2 17:00,514,0,132,646,1
연산터널→연산교차로,2023.7.2 17:00,238,245,42,525,1
교대→연산교차로,2023.7.2 18:00,296,0,267,563,1
부산시청→연산교차로,2023.7.2 18:00,516,326,205,1047,1
사직운동장→연산교차로,2023.7.2 18:00,202,482,39,723,1
신리→연산교차로,2023.7.2 18:00,381,190,46,617,1
안락→연산교차로,2023.7.2 18:00,434,0,116,550,1
연산터널→연산교차로,2023.7.2 18:00,239,246,43,528,1
교대→연산교차로,2023.7.2 19:00,273,0,253,526,1
부산시청→연산교차로,2023.7.2 19:00,414,272,189,875,1
사직운동장→연산교차로,2023.7.2 19:00,145,418,58,621,1
신리→연산교차로,2023.7.2 19:00,318,164,26,508,1
안락→연산교차로,2023.7.2 19:00,429,0,109,538,1
연산터널→연산교차로,2023.7.2 19:00,231,253,57,541,1
교대→연산교차로,2023.7.2 20:00,277,0,252,529,1
부산시청→연산교차로,2023.7.2 20:00,380,262,179,821,1
사직운동장→연산교차로,2023.7.2 20:00,182,360,63,605,1
신리→연산교차로,2023.7.2 20:00,309,178,22,509,1
안락→연산교차로,2023.7.2 20:00,397,0,88,485,1
연산터널→연산교차로,2023.7.2 20:00,220,216,47,483,1
교대→연산교차로,2023.7.2 21:00,265,0,230,495,1
부산시청→연산교차로,2023.7.2 21:00,367,264,159,790,1
사직운동장→연산교차로,2023.7.2 21:00,158,337,81,576,1
신리→연산교차로,2023.7.2 21:00,290,156,20,466,1
안락→연산교차로,2023.7.2 21:00,370,0,110,480,1
연산터널→연산교차로,2023.7.2 21:00,195,214,38,447,1
교대→연산교차로,2023.7.2 22:00,182,0,206,388,1
부산시청→연산교차로,2023.7.2 22:00,331,205,139,675,1
사직운동장→연산교차로,2023.7.2 22:00,137,293,72,502,1
신리→연산교차로,2023.7.2 22:00,259,119,11,389,1
안락→연산교차로,2023.7.2 22:00,296,0,55,351,1
연산터널→연산교차로,2023.7.2 22:00,160,163,53,376,1
교대→연산교차로,2023.7.2 23:00,124,0,157,281,1
부산시청→연산교차로,2023.7.2 23:00,264,160,85,509,1
사직운동장→연산교차로,2023.7.2 23:00,76,234,62,372,1
신리→연산교차로,2023.7.2 23:00,191,106,16,313,1
안락→연산교차로,2023.7.2 23:00,206,0,50,256,1
연산터널→연산교차로,2023.7.2 23:00,132,155,76,363,1
교대→연산교차로,2023.7.3 00:00,110,0,138,248,0
부산시청→연산교차로,2023.7.3 00:00,198,128,90,416,0
사직운동장→연산교차로,2023.7.3 00:00,56,181,50,287,0
신리→연산교차로,2023.7.3 00:00,145,79,18,242,0
안락→연산교차로,2023.7.3 00:00,166,0,36,202,0
연산터널→연산교차로,2023.7.3 00:00,97,126,56,279,0
교대→연산교차로,2023.7.3 01:00,70,0,117,187,0
부산시청→연산교차로,2023.7.3 01:00,174,98,64,336,0
사직운동장→연산교차로,2023.7.3 01:00,59,112,37,208,0
신리→연산교차로,2023.7.3 01:00,91,54,9,154,0
안락→연산교차로,2023.7.3 01:00,131,0,25,156,0
연산터널→연산교차로,2023.7.3 01:00,72,105,47,224,0
교대→연산교차로,2023.7.3 02:00,40,0,89,129,0
부산시청→연산교차로,2023.7.3 02:00,127,64,48,239,0
사직운동장→연산교차로,2023.7.3 02:00,38,101,21,160,0
신리→연산교차로,2023.7.3 02:00,64,39,9,112,0
안락→연산교차로,2023.7.3 02:00,110,0,20,130,0
연산터널→연산교차로,2023.7.3 02:00,58,93,24,175,0
교대→연산교차로,2023.7.3 03:00,47,0,80,127,0
부산시청→연산교차로,2023.7.3 03:00,116,58,42,216,0
사직운동장→연산교차로,2023.7.3 03:00,31,92,19,142,0
신리→연산교차로,2023.7.3 03:00,61,23,9,93,0
안락→연산교차로,2023.7.3 03:00,94,0,21,115,0
연산터널→연산교차로,2023.7.3 03:00,43,81,22,146,0
교대→연산교차로,2023.7.3 04:00,40,0,62,102,0
부산시청→연산교차로,2023.7.3 04:00,135,67,46,248,0
사직운동장→연산교차로,2023.7.3 04:00,37,81,22,140,0
신리→연산교차로,2023.7.3 04:00,102,38,4,144,0
안락→연산교차로,2023.7.3 04:00,178,0,28,206,0
연산터널→연산교차로,2023.7.3 04:00,71,87,15,173,0
교대→연산교차로,2023.7.3 05:00,110,0,127,237,0
부산시청→연산교차로,2023.7.3 05:00,262,155,76,493,0
사직운동장→연산교차로,2023.7.3 05:00,72,175,24,271,0
신리→연산교차로,2023.7.3 05:00,210,90,15,315,0
안락→연산교차로,2023.7.3 05:00,323,0,43,366,0
연산터널→연산교차로,2023.7.3 05:00,135,150,26,311,0
교대→연산교차로,2023.7.3 06:00,185,0,225,410,0
부산시청→연산교차로,2023.7.3 06:00,371,253,140,764,0
사직운동장→연산교차로,2023.7.3 06:00,117,266,46,429,0
신리→연산교차로,2023.7.3 06:00,352,173,25,550,0
안락→연산교차로,2023.7.3 06:00,544,0,75,619,0
연산터널→연산교차로,2023.7.3 06:00,216,238,37,491,0
교대→연산교차로,2023.7.3 07:00,289,0,441,730,0
부산시청→연산교차로,2023.7.3 07:00,548,375,296,1219,0
사직운동장→연산교차로,2023.7.3 07:00,209,525,67,801,0
신리→연산교차로,2023.7.3 07:00,475,292,32,799,0
안락→연산교차로,2023.7.3 07:00,621,0,94,715,0
연산터널→연산교차로,2023.7.3 07:00,292,394,35,721,0
교대→연산교차로,2023.7.3 08:00,300,0,497,797,0
부산시청→연산교차로,2023.7.3 08:00,590,433,333,1356,0
사직운동장→연산교차로,2023.7.3 08:00,267,638,66,971,0
신리→연산교차로,2023.7.3 08:00,505,352,27,884,0
안락→연산교차로,2023.7.3 08:00,630,0,107,737,0
연산터널→연산교차로,2023.7.3 08:00,313,382,29,724,0
교대→연산교차로,2023.7.3 09:00,301,0,513,814,0
부산시청→연산교차로,2023.7.3 09:00,504,364,263,1131,0
사직운동장→연산교차로,2023.7.3 09:00,233,569,81,883,0
신리→연산교차로,2023.7.3 09:00,487,328,51,866,0
안락→연산교차로,2023.7.3 09:00,618,0,101,719,0
연산터널→연산교차로,2023.7.3 09:00,291,365,33,689,0
교대→연산교차로,2023.7.3 10:00,297,0,508,805,0
부산시청→연산교차로,2023.7.3 10:00,560,349,252,1161,0
사직운동장→연산교차로,2023.7.3 10:00,287,571,66,924,0
신리→연산교차로,2023.7.3 10:00,444,266,57,767,0
안락→연산교차로,2023.7.3 10:00,554,0,131,685,0
연산터널→연산교차로,2023.7.3 10:00,306,321,47,674,0
교대→연산교차로,2023.7.3 11:00,297,0,460,757,0
부산시청→연산교차로,2023.7.3 11:00,573,365,282,1220,0
사직운동장→연산교차로,2023.7.3 11:00,309,575,72,956,0
신리→연산교차로,2023.7.3 11:00,452,265,49,766,0
안락→연산교차로,2023.7.3 11:00,566,0,136,702,0
연산터널→연산교차로,2023.7.3 11:00,280,324,54,658,0
교대→연산교차로,2023.7.3 12:00,296,0,361,657,0
부산시청→연산교차로,2023.7.3 12:00,571,351,254,1176,0
사직운동장→연산교차로,2023.7.3 12:00,323,563,77,963,0
신리→연산교차로,2023.7.3 12:00,404,263,41,708,0
안락→연산교차로,2023.7.3 12:00,491,0,135,626,0
연산터널→연산교차로,2023.7.3 12:00,273,285,43,601,0
교대→연산교차로,2023.7.3 13:00,344,0,425,769,0
부산시청→연산교차로,2023.7.3 13:00,586,415,239,1240,0
사직운동장→연산교차로,2023.7.3 13:00,301,580,93,974,0
신리→연산교차로,2023.7.3 13:00,434,264,67,765,0
안락→연산교차로,2023.7.3 13:00,437,0,112,549,0
연산터널→연산교차로,2023.7.3 13:00,231,287,48,566,0
교대→연산교차로,2023.7.3 14:00,348,0,520,868,0
부산시청→연산교차로,2023.7.3 14:00,551,457,296,1304,0
사직운동장→연산교차로,2023.7.3 14:00,367,625,92,1084,0
신리→연산교차로,2023.7.3 14:00,440,264,48,752,0
안락→연산교차로,2023.7.3 14:00,446,0,86,532,0
연산터널→연산교차로,2023.7.3 14:00,245,263,56,564,0
교대→연산교차로,2023.7.3 15:00,353,0,524,877,0
부산시청→연산교차로,2023.7.3 15:00,624,480,284,1388,0
사직운동장→연산교차로,2023.7.3 15:00,359,634,90,1083,0
신리→연산교차로,2023.7.3 15:00,472,261,50,783,0
안락→연산교차로,2023.7.3 15:00,447,0,112,559,0
연산터널→연산교차로,2023.7.3 15:00,252,257,54,563,0
교대→연산교차로,2023.7.3 16:00,360,0,508,868,0
부산시청→연산교차로,2023.7.3 16:00,611,516,319,1446,0
사직운동장→연산교차로,2023.7.3 16:00,355,665,63,1083,0
신리→연산교차로,2023.7.3 16:00,506,294,65,865,0
안락→연산교차로,2023.7.3 16:00,422,0,104,526,0
연산터널→연산교차로,2023.7.3 16:00,225,295,42,562,0
교대→연산교차로,2023.7.3 17:00,363,0,518,881,0
부산시청→연산교차로,2023.7.3 17:00,620,567,308,1495,0
사직운동장→연산교차로,2023.7.3 17:00,345,699,50,1094,0
신리→연산교차로,2023.7.3 17:00,517,285,57,859,0
안락→연산교차로,2023.7.3 17:00,464,0,109,573,0
연산터널→연산교차로,2023.7.3 17:00,233,276,41,550,0
교대→연산교차로,2023.7.3 18:00,381,0,548,929,0
부산시청→연산교차로,2023.7.3 18:00,610,556,325,1491,0
사직운동장→연산교차로,2023.7.3 18:00,302,708,51,1061,0
신리→연산교차로,2023.7.3 18:00,522,285,51,858,0
안락→연산교차로,2023.7.3 18:00,477,0,107,584,0
연산터널→연산교차로,2023.7.3 18:00,236,264,55,555,0
교대→연산교차로,2023.7.3 19:00,319,0,374,693,0
부산시청→연산교차로,2023.7.3 19:00,550,404,279,1233,0
사직운동장→연산교차로,2023.7.3 19:00,212,546,87,845,0
신리→연산교차로,2023.7.3 19:00,362,208,43,613,0
안락→연산교차로,2023.7.3 19:00,406,0,115,521,0
연산터널→연산교차로,2023.7.3 19:00,213,236,65,514,0
교대→연산교차로,2023.7.3 20:00,310,0,322,632,0
부산시청→연산교차로,2023.7.3 20:00,460,360,208,1028,0
사직운동장→연산교차로,2023.7.3 20:00,173,451,90,714,0
신리→연산교차로,2023.7.3 20:00,327,177,35,539,0
안락→연산교차로,2023.7.3 20:00,388,0,105,493,0
연산터널→연산교차로,2023.7.3 20:00,206,281,56,543,0
교대→연산교차로,2023.7.3 21:00,257,0,285,542,0
부산시청→연산교차로,2023.7.3 21:00,465,284,248,997,0
사직운동장→연산교차로,2023.7.3 21:00,177,440,91,708,0
신리→연산교차로,2023.7.3 21:00,262,162,41,465,0
안락→연산교차로,2023.7.3 21:00,409,0,82,491,0
연산터널→연산교차로,2023.7.3 21:00,205,249,71,525,0
교대→연산교차로,2023.7.3 22:00,232,0,224,456,0
부산시청→연산교차로,2023.7.3 22:00,352,240,151,743,0
사직운동장→연산교차로,2023.7.3 22:00,154,334,92,580,0
신리→연산교차로,2023.7.3 22:00,223,161,16,400,0
안락→연산교차로,2023.7.3 22:00,344,0,76,420,0
연산터널→연산교차로,2023.7.3 22:00,181,220,69,470,0
교대→연산교차로,2023.7.3 23:00,159,0,212,371,0
부산시청→연산교차로,2023.7.3 23:00,279,171,133,583,0
사직운동장→연산교차로,2023.7.3 23:00,113,281,85,479,0
신리→연산교차로,2023.7.3 23:00,193,99,24,316,0
안락→연산교차로,2023.7.3 23:00,245,0,64,309,0
연산터널→연산교차로,2023.7.3 23:00,157,184,72,413,0
교대→연산교차로,2023.7.4 00:00,110,0,171,281,0
부산시청→연산교차로,2023.7.4 00:00,262,148,110,520,0
사직운동장→연산교차로,2023.7.4 00:00,99,235,54,388,0
신리→연산교차로,2023.7.4 00:00,138,101,17,256,0
안락→연산교차로,2023.7.4 00:00,215,0,37,252,0
연산터널→연산교차로,2023.7.4 00:00,128,158,64,350,0
교대→연산교차로,2023.7.4 01:00,84,0,158,242,0
부산시청→연산교차로,2023.7.4 01:00,166,112,95,373,0
사직운동장→연산교차로,2023.7.4 01:00,57,174,44,275,0
신리→연산교차로,2023.7.4 01:00,93,67,21,181,0
안락→연산교차로,2023.7.4 01:00,140,0,34,174,0
연산터널→연산교차로,2023.7.4 01:00,112,140,65,317,0
교대→연산교차로,2023.7.4 02:00,78,0,117,195,0
부산시청→연산교차로,2023.7.4 02:00,155,84,68,307,0
사직운동장→연산교차로,2023.7.4 02:00,50,158,41,249,0
신리→연산교차로,2023.7.4 02:00,82,46,16,144,0
안락→연산교차로,2023.7.4 02:00,114,0,28,142,0
연산터널→연산교차로,2023.7.4 02:00,82,124,50,256,0
교대→연산교차로,2023.7.4 03:00,49,0,87,136,0
부산시청→연산교차로,2023.7.4 03:00,129,59,47,235,0
사직운동장→연산교차로,2023.7.4 03:00,31,130,15,176,0
신리→연산교차로,2023.7.4 03:00,70,38,11,119,0
안락→연산교차로,2023.7.4 03:00,99,0,31,130,0
연산터널→연산교차로,2023.7.4 03:00,74,99,55,228,0
교대→연산교차로,2023.7.4 04:00,56,0,84,140,0
부산시청→연산교차로,2023.7.4 04:00,158,73,64,295,0
사직운동장→연산교차로,2023.7.4 04:00,47,122,29,198,0
신리→연산교차로,2023.7.4 04:00,93,43,11,147,0
안락→연산교차로,2023.7.4 04:00,164,0,26,190,0
연산터널→연산교차로,2023.7.4 04:00,85,88,36,209,0
교대→연산교차로,2023.7.4 05:00,89,0,140,229,0
부산시청→연산교차로,2023.7.4 05:00,213,157,75,445,0
사직운동장→연산교차로,2023.7.4 05:00,78,187,41,306,0
신리→연산교차로,2023.7.4 05:00,213,107,13,333,0
안락→연산교차로,2023.7.4 05:00,345,0,47,392,0
연산터널→연산교차로,2023.7.4 05:00,147,134,37,318,0
교대→연산교차로,2023.7.4 06:00,202,0,235,437,0
부산시청→연산교차로,2023.7.4 06:00,355,243,126,724,0
사직운동장→연산교차로,2023.7.4 06:00,111,310,45,466,0
신리→연산교차로,2023.7.4 06:00,333,173,26,532,0
안락→연산교차로,2023.7.4 06:00,503,0,81,584,0
연산터널→연산교차로,2023.7.4 06:00,217,231,46,494,0
교대→연산교차로,2023.7.4 07:00,261,0,383,644,0
부산시청→연산교차로,2023.7.4 07:00,549,362,258,1169,0
사직운동장→연산교차로,2023.7.4 07:00,237,492,74,803,0
신리→연산교차로,2023.7.4 07:00,488,285,41,814,0
안락→연산교차로,2023.7.4 07:00,621,0,77,698,0
연산터널→연산교차로,2023.7.4 07:00,303,372,40,715,0
교대→연산교차로,2023.7.4 08:00,318,0,509,827,0
부산시청→연산교차로,2023.7.4 08:00,603,421,334,1358,0
사직운동장→연산교차로,2023.7.4 08:00,255,652,73,980,0
신리→연산교차로,2023.7.4 08:00,489,360,27,876,0
안락→연산교차로,2023.7.4 08:00,622,0,113,735,0
연산터널→연산교차로,2023.7.4 08:00,342,377,43,762,0
교대→연산교차로,2023.7.4 09:00,294,0,554,848,0
부산시청→연산교차로,2023.7.4 09:00,544,385,328,1257,0
사직운동장→연산교차로,2023.7.4 09:00,265,571,85,921,0
신리→연산교차로,2023.7.4 09:00,470,324,54,848,0
안락→연산교차로,2023.7.4 09:00,609,0,110,719,0
연산터널→연산교차로,2023.7.4 09:00,304,374,38,716,0
교대→연산교차로,2023.7.4 10:00,306,0,539,845,0
부산시청→연산교차로,2023.7.4 10:00,528,375,283,1186,0
사직운동장→연산교차로,2023.7.4 10:00,275,565,75,915,0
신리→연산교차로,2023.7.4 10:00,484,265,75,824,0
안락→연산교차로,2023.7.4 10:00,572,0,145,717,0
연산터널→연산교차로,2023.7.4 10:00,277,361,59,697,0
교대→연산교차로,2023.7.4 11:00,293,0,442,735,0
부산시청→연산교차로,2023.7.4 11:00,531,372,268,1171,0
사직운동장→연산교차로,2023.7.4 11:00,280,566,96,942,0
신리→연산교차로,2023.7.4 11:00,412,292,56,760,0
안락→연산교차로,2023.7.4 11:00,562,0,139,701,0
연산터널→연산교차로,2023.7.4 11:00,266,282,68,616,0
교대→연산교차로,2023.7.4 12:00,289,0,401,690,0
부산시청→연산교차로,2023.7.4 12:00,529,386,267,1182,0
사직운동장→연산교차로,2023.7.4 12:00,325,557,83,965,0
신리→연산교차로,2023.7.4 12:00,384,217,58,659,0
안락→연산교차로,2023.7.4 12:00,488,0,132,620,0
연산터널→연산교차로,2023.7.4 12:00,277,265,35,577,0
교대→연산교차로,2023.7.4 13:00,327,0,468,795,0
부산시청→연산교차로,2023.7.4 13:00,535,432,263,1230,0
사직운동장→연산교차로,2023.7.4 13:00,269,590,88,947,0
신리→연산교차로,2023.7.4 13:00,446,274,64,784,0
안락→연산교차로,2023.7.4 13:00,460,0,109,569,0
연산터널→연산교차로,2023.7.4 13:00,232,267,44,543,0
교대→연산교차로,2023.7.4 14:00,335,0,549,884,0
부산시청→연산교차로,2023.7.4 14:00,581,437,313,1331,0
사직운동장→연산교차로,2023.7.4 14:00,355,619,85,1059,0
신리→연산교차로,2023.7.4 14:00,428,284,62,774,0
안락→연산교차로,2023.7.4 14:00,449,0,132,581,0
연산터널→연산교차로,2023.7.4 14:00,226,262,59,547,0
교대→연산교차로,2023.7.4 15:00,346,0,523,869,0
부산시청→연산교차로,2023.7.4 15:00,566,462,298,1326,0
사직운동장→연산교차로,2023.7.4 15:00,345,611,71,1027,0
신리→연산교차로,2023.7.4 15:00,444,257,54,755,0
안락→연산교차로,2023.7.4 15:00,462,0,122,584,0
연산터널→연산교차로,2023.7.4 15:00,218,268,48,534,0
교대→연산교차로,2023.7.4 16:00,350,0,513,863,0
부산시청→연산교차로,2023.7.4 16:00,582,515,294,1391,0
사직운동장→연산교차로,2023.7.4 16:00,339,629,74,1042,0
신리→연산교차로,2023.7.4 16:00,483,267,50,800,0
안락→연산교차로,2023.7.4 16:00,449,0,120,569,0
연산터널→연산교차로,2023.7.4 16:00,226,248,38,512,0
교대→연산교차로,2023.7.4 17:00,359,0,511,870,0
부산시청→연산교차로,2023.7.4 17:00,597,523,328,1448,0
사직운동장→연산교차로,2023.7.4 17:00,316,677,46,1039,0
신리→연산교차로,2023.7.4 17:00,481,269,51,801,0
안락→연산교차로,2023.7.4 17:00,473,0,105,578,0
연산터널→연산교차로,2023.7.4 17:00,222,266,41,529,0
교대→연산교차로,2023.7.4 18:00,364,0,556,920,0
부산시청→연산교차로,2023.7.4 18:00,590,563,345,1498,0
사직운동장→연산교차로,2023.7.4 18:00,355,652,47,1054,0
신리→연산교차로,2023.7.4 18:00,481,242,56,779,0
안락→연산교차로,2023.7.4 18:00,442,0,103,545,0
연산터널→연산교차로,2023.7.4 18:00,221,275,66,562,0
교대→연산교차로,2023.7.4 19:00,330,0,402,732,0
부산시청→연산교차로,2023.7.4 19:00,522,417,284,1223,0
사직운동장→연산교차로,2023.7.4 19:00,229,556,57,842,0
신리→연산교차로,2023.7.4 19:00,398,219,34,651,0
안락→연산교차로,2023.7.4 19:00,450,0,74,524,0
연산터널→연산교차로,2023.7.4 19:00,213,264,55,532,0
교대→연산교차로,2023.7.4 20:00,319,0,291,610,0
부산시청→연산교차로,2023.7.4 20:00,505,380,270,1155,0
사직운동장→연산교차로,2023.7.4 20:00,191,523,68,782,0
신리→연산교차로,2023.7.4 20:00,320,176,33,529,0
안락→연산교차로,2023.7.4 20:00,417,0,96,513,0
연산터널→연산교차로,2023.7.4 20:00,206,250,43,499,0
교대→연산교차로,2023.7.4 21:00,264,0,298,562,0
부산시청→연산교차로,2023.7.4 21:00,452,343,250,1045,0
사직운동장→연산교차로,2023.7.4 21:00,200,447,71,718,0
신리→연산교차로,2023.7.4 21:00,291,187,31,509,0
안락→연산교차로,2023.7.4 21:00,409,0,113,522,0
연산터널→연산교차로,2023.7.4 21:00,234,270,63,567,0
교대→연산교차로,2023.7.4 22:00,202,0,188,390,0
부산시청→연산교차로,2023.7.4 22:00,383,263,152,798,0
사직운동장→연산교차로,2023.7.4 22:00,158,325,45,528,0
신리→연산교차로,2023.7.4 22:00,241,176,21,438,0
안락→연산교차로,2023.7.4 22:00,376,0,106,482,0
연산터널→연산교차로,2023.7.4 22:00,207,246,55,508,0
교대→연산교차로,2023.7.4 23:00,158,0,135,293,0
부산시청→연산교차로,2023.7.4 23:00,295,186,119,600,0
사직운동장→연산교차로,2023.7.4 23:00,112,263,41,416,0
신리→연산교차로,2023.7.4 23:00,184,103,16,303,0
안락→연산교차로,2023.7.4 23:00,238,0,57,295,0
연산터널→연산교차로,2023.7.4 23:00,163,176,59,398,0
교대→연산교차로,2023.7.5 00:00,117,0,137,254,0
부산시청→연산교차로,2023.7.5 00:00,237,147,86,470,0
사직운동장→연산교차로,2023.7.5 00:00,83,217,16,316,0
신리→연산교차로,2023.7.5 00:00,119,88,14,221,0
안락→연산교차로,2023.7.5 00:00,191,0,51,242,0
연산터널→연산교차로,2023.7.5 00:00,110,129,28,267,0
교대→연산교차로,2023.7.5 01:00,93,0,93,186,0
부산시청→연산교차로,2023.7.5 01:00,168,119,72,359,0
사직운동장→연산교차로,2023.7.5 01:00,57,158,3,218,0
신리→연산교차로,2023.7.5 01:00,98,51,16,165,0
안락→연산교차로,2023.7.5 01:00,141,0,46,187,0
연산터널→연산교차로,2023.7.5 01:00,85,123,26,234,0
교대→연산교차로,2023.7.5 02:00,52,0,82,134,0
부산시청→연산교차로,2023.7.5 02:00,145,84,51,280,0
사직운동장→연산교차로,2023.7.5 02:00,62,123,2,187,0
신리→연산교차로,2023.7.5 02:00,71,46,9,126,0
안락→연산교차로,2023.7.5 02:00,149,0,27,176,0
연산터널→연산교차로,2023.7.5 02:00,94,84,12,190,0
교대→연산교차로,2023.7.5 03:00,50,0,78,128,0
부산시청→연산교차로,2023.7.5 03:00,100,52,43,195,0
사직운동장→연산교차로,2023.7.5 03:00,47,127,3,177,0
신리→연산교차로,2023.7.5 03:00,39,25,2,66,0
안락→연산교차로,2023.7.5 03:00,111,0,22,133,0
연산터널→연산교차로,2023.7.5 03:00,62,69,7,138,0
교대→연산교차로,2023.7.5 04:00,33,0,51,84,0
부산시청→연산교차로,2023.7.5 04:00,141,70,53,264,0
사직운동장→연산교차로,2023.7.5 04:00,29,108,3,140,0
신리→연산교차로,2023.7.5 04:00,53,22,3,78,0
안락→연산교차로,2023.7.5 04:00,139,0,28,167,0
연산터널→연산교차로,2023.7.5 04:00,66,79,8,153,0
교대→연산교차로,2023.7.5 05:00,83,0,108,191,0
부산시청→연산교차로,2023.7.5 05:00,166,129,56,351,0
사직운동장→연산교차로,2023.7.5 05:00,59,157,17,233,0
신리→연산교차로,2023.7.5 05:00,132,78,6,216,0
안락→연산교차로,2023.7.5 05:00,264,0,47,311,0
연산터널→연산교차로,2023.7.5 05:00,122,128,17,267,0
교대→연산교차로,2023.7.5 06:00,177,0,196,373,0
부산시청→연산교차로,2023.7.5 06:00,309,246,124,679,0
사직운동장→연산교차로,2023.7.5 06:00,91,265,33,389,0
신리→연산교차로,2023.7.5 06:00,310,137,20,467,0
안락→연산교차로,2023.7.5 06:00,489,0,86,575,0
연산터널→연산교차로,2023.7.5 06:00,203,211,35,449,0
교대→연산교차로,2023.7.5 07:00,252,0,396,648,0
부산시청→연산교차로,2023.7.5 07:00,548,377,190,1115,0
사직운동장→연산교차로,2023.7.5 07:00,225,496,48,769,0
신리→연산교차로,2023.7.5 07:00,465,296,24,785,0
안락→연산교차로,2023.7.5 07:00,620,0,92,712,0
연산터널→연산교차로,2023.7.5 07:00,287,379,43,709,0
교대→연산교차로,2023.7.5 08:00,315,0,481,796,0
부산시청→연산교차로,2023.7.5 08:00,552,425,309,1286,0
사직운동장→연산교차로,2023.7.5 08:00,288,629,60,977,0
신리→연산교차로,2023.7.5 08:00,500,346,20,866,0
안락→연산교차로,2023.7.5 08:00,620,0,114,734,0
연산터널→연산교차로,2023.7.5 08:00,323,398,31,752,0
교대→연산교차로,2023.7.5 09:00,284,0,512,796,0
부산시청→연산교차로,2023.7.5 09:00,516,370,259,1145,0
사직운동장→연산교차로,2023.7.5 09:00,254,556,93,903,0
신리→연산교차로,2023.7.5 09:00,449,351,38,838,0
안락→연산교차로,2023.7.5 09:00,618,0,84,702,0
연산터널→연산교차로,2023.7.5 09:00,274,389,42,705,0
교대→연산교차로,2023.7.5 10:00,286,0,428,714,0
부산시청→연산교차로,2023.7.5 10:00,521,372,276,1169,0
사직운동장→연산교차로,2023.7.5 10:00,285,554,67,906,0
신리→연산교차로,2023.7.5 10:00,469,280,47,796,0
안락→연산교차로,2023.7.5 10:00,556,0,119,675,0
연산터널→연산교차로,2023.7.5 10:00,262,365,53,680,0
교대→연산교차로,2023.7.5 11:00,307,0,452,759,0
부산시청→연산교차로,2023.7.5 11:00,559,356,262,1177,0
사직운동장→연산교차로,2023.7.5 11:00,352,576,87,1015,0
신리→연산교차로,2023.7.5 11:00,424,274,51,749,0
안락→연산교차로,2023.7.5 11:00,557,0,145,702,0
연산터널→연산교차로,2023.7.5 11:00,269,289,58,616,0
교대→연산교차로,2023.7.5 12:00,293,0,359,652,0
부산시청→연산교차로,2023.7.5 12:00,528,350,258,1136,0
사직운동장→연산교차로,2023.7.5 12:00,269,553,71,893,0
신리→연산교차로,2023.7.5 12:00,401,241,53,695,0
안락→연산교차로,2023.7.5 12:00,471,0,137,608,0
연산터널→연산교차로,2023.7.5 12:00,270,301,40,611,0
교대→연산교차로,2023.7.5 13:00,334,0,370,704,0
부산시청→연산교차로,2023.7.5 13:00,554,435,264,1253,0
사직운동장→연산교차로,2023.7.5 13:00,306,586,90,982,0
신리→연산교차로,2023.7.5 13:00,446,275,54,775,0
안락→연산교차로,2023.7.5 13:00,433,0,133,566,0
연산터널→연산교차로,2023.7.5 13:00,264,257,47,568,0
교대→연산교차로,2023.7.5 14:00,325,0,431,756,0
부산시청→연산교차로,2023.7.5 14:00,601,482,316,1399,0
사직운동장→연산교차로,2023.7.5 14:00,332,633,79,1044,0
신리→연산교차로,2023.7.5 14:00,506,289,61,856,0
안락→연산교차로,2023.7.5 14:00,454,0,103,557,0
연산터널→연산교차로,2023.7.5 14:00,252,285,47,584,0
교대→연산교차로,2023.7.5 15:00,365,0,434,799,0
부산시청→연산교차로,2023.7.5 15:00,565,491,308,1364,0
사직운동장→연산교차로,2023.7.5 15:00,280,645,66,991,0
신리→연산교차로,2023.7.5 15:00,441,274,69,784,0
안락→연산교차로,2023.7.5 15:00,445,0,87,532,0
연산터널→연산교차로,2023.7.5 15:00,214,277,64,555,0
교대→연산교차로,2023.7.5 16:00,350,0,494,844,0
부산시청→연산교차로,2023.7.5 16:00,605,534,319,1458,0
사직운동장→연산교차로,2023.7.5 16:00,342,705,33,1080,0
신리→연산교차로,2023.7.5 16:00,467,309,47,823,0
안락→연산교차로,2023.7.5 16:00,440,0,79,519,0
연산터널→연산교차로,2023.7.5 16:00,231,277,31,539,0
교대→연산교차로,2023.7.5 17:00,364,0,510,874,0
부산시청→연산교차로,2023.7.5 17:00,623,548,323,1494,0
사직운동장→연산교차로,2023.7.5 17:00,292,712,33,1037,0
신리→연산교차로,2023.7.5 17:00,537,291,44,872,0
안락→연산교차로,2023.7.5 17:00,479,0,72,551,0
연산터널→연산교차로,2023.7.5 17:00,234,275,48,557,0
교대→연산교차로,2023.7.5 18:00,372,0,571,943,0
부산시청→연산교차로,2023.7.5 18:00,605,581,356,1542,0
사직운동장→연산교차로,2023.7.5 18:00,334,668,37,1039,0
신리→연산교차로,2023.7.5 18:00,541,292,62,895,0
안락→연산교차로,2023.7.5 18:00,470,0,92,562,0
연산터널→연산교차로,2023.7.5 18:00,242,263,45,550,0
교대→연산교차로,2023.7.5 19:00,342,0,370,712,0
부산시청→연산교차로,2023.7.5 19:00,530,426,269,1225,0
사직운동장→연산교차로,2023.7.5 19:00,225,576,51,852,0
신리→연산교차로,2023.7.5 19:00,354,200,45,599,0
안락→연산교차로,2023.7.5 19:00,449,0,85,534,0
연산터널→연산교차로,2023.7.5 19:00,219,275,49,543,0
교대→연산교차로,2023.7.5 20:00,305,0,335,640,0
부산시청→연산교차로,2023.7.5 20:00,508,345,222,1075,0
사직운동장→연산교차로,2023.7.5 20:00,178,453,95,726,0
신리→연산교차로,2023.7.5 20:00,363,181,39,583,0
안락→연산교차로,2023.7.5 20:00,392,0,92,484,0
연산터널→연산교차로,2023.7.5 20:00,204,267,68,539,0
교대→연산교차로,2023.7.5 21:00,280,0,323,603,0
부산시청→연산교차로,2023.7.5 21:00,532,333,241,1106,0
사직운동장→연산교차로,2023.7.5 21:00,191,437,96,724,0
신리→연산교차로,2023.7.5 21:00,353,180,28,561,0
안락→연산교차로,2023.7.5 21:00,440,0,102,542,0
연산터널→연산교차로,2023.7.5 21:00,208,267,77,552,0
교대→연산교차로,2023.7.5 22:00,229,0,238,467,0
부산시청→연산교차로,2023.7.5 22:00,387,263,177,827,0
사직운동장→연산교차로,2023.7.5 22:00,170,395,79,644,0
신리→연산교차로,2023.7.5 22:00,252,168,31,451,0
안락→연산교차로,2023.7.5 22:00,363,0,95,458,0
연산터널→연산교차로,2023.7.5 22:00,195,234,75,504,0
교대→연산교차로,2023.7.5 23:00,198,0,247,445,0
부산시청→연산교차로,2023.7.5 23:00,311,182,151,644,0
사직운동장→연산교차로,2023.7.5 23:00,133,304,97,534,0
신리→연산교차로,2023.7.5 23:00,217,118,31,366,0
안락→연산교차로,2023.7.5 23:00,264,0,65,329,0
연산터널→연산교차로,2023.7.5 23:00,162,216,73,451,0
교대→연산교차로,2023.7.6 00:00,159,0,184,343,0
부산시청→연산교차로,2023.7.6 00:00,244,173,111,528,0
사직운동장→연산교차로,2023.7.6 00:00,66,240,80,386,0
신리→연산교차로,2023.7.6 00:00,179,93,16,288,0
안락→연산교차로,2023.7.6 00:00,252,0,62,314,0
연산터널→연산교차로,2023.7.6 00:00,164,167,64,395,0
교대→연산교차로,2023.7.6 01:00,91,0,163,254,0
부산시청→연산교차로,2023.7.6 01:00,199,121,82,402,0
사직운동장→연산교차로,2023.7.6 01:00,70,199,55,324,0
신리→연산교차로,2023.7.6 01:00,115,63,16,194,0
안락→연산교차로,2023.7.6 01:00,170,0,59,229,0
연산터널→연산교차로,2023.7.6 01:00,109,133,52,294,0
교대→연산교차로,2023.7.6 02:00,93,0,111,204,0
부산시청→연산교차로,2023.7.6 02:00,153,95,62,310,0
사직운동장→연산교차로,2023.7.6 02:00,69,176,35,280,0
신리→연산교차로,2023.7.6 02:00,94,65,18,177,0
안락→연산교차로,2023.7.6 02:00,133,0,41,174,0
연산터널→연산교차로,2023.7.6 02:00,88,131,35,254,0
교대→연산교차로,2023.7.6 03:00,58,0,98,156,0
부산시청→연산교차로,2023.7.6 03:00,139,72,58,269,0
사직운동장→연산교차로,2023.7.6 03:00,32,133,34,199,0
신리→연산교차로,2023.7.6 03:00,86,40,6,132,0
안락→연산교차로,2023.7.6 03:00,114,0,44,158,0
연산터널→연산교차로,2023.7.6 03:00,72,91,49,212,0
교대→연산교차로,2023.7.6 04:00,65,0,97,162,0
부산시청→연산교차로,2023.7.6 04:00,169,86,46,301,0
사직운동장→연산교차로,2023.7.6 04:00,41,124,34,199,0
신리→연산교차로,2023.7.6 04:00,111,50,12,173,0
안락→연산교차로,2023.7.6 04:00,192,0,41,233,0
연산터널→연산교차로,2023.7.6 04:00,93,90,35,218,0
교대→연산교차로,2023.7.6 05:00,110,0,123,233,0
부산시청→연산교차로,2023.7.6 05:00,250,138,82,470,0
사직운동장→연산교차로,2023.7.6 05:00,75,190,40,305,0
신리→연산교차로,2023.7.6 05:00,203,101,10,314,0
안락→연산교차로,2023.7.6 05:00,367,0,52,419,0
연산터널→연산교차로,2023.7.6 05:00,136,157,27,320,0
교대→연산교차로,2023.7.6 06:00,186,0,217,403,0
부산시청→연산교차로,2023.7.6 06:00,392,254,136,782,0
사직운동장→연산교차로,2023.7.6 06:00,124,276,47,447,0
신리→연산교차로,2023.7.6 06:00,312,182,29,523,0
안락→연산교차로,2023.7.6 06:00,473,0,87,560,0
연산터널→연산교차로,2023.7.6 06:00,238,242,38,518,0
교대→연산교차로,2023.7.6 07:00,286,0,391,677,0
부산시청→연산교차로,2023.7.6 07:00,558,359,212,1129,0
사직운동장→연산교차로,2023.7.6 07:00,221,522,54,797,0
신리→연산교차로,2023.7.6 07:00,442,285,26,753,0
안락→연산교차로,2023.7.6 07:00,643,0,77,720,0
연산터널→연산교차로,2023.7.6 07:00,277,353,42,672,0
교대→연산교차로,2023.7.6 08:00,313,0,530,843,0
부산시청→연산교차로,2023.7.6 08:00,594,435,322,1351,0
사직운동장→연산교차로,2023.7.6 08:00,256,619,67,942,0
신리→연산교차로,2023.7.6 08:00,485,358,29,872,0
안락→연산교차로,2023.7.6 08:00,650,0,102,752,0
연산터널→연산교차로,2023.7.6 08:00,298,408,35,741,0
교대→연산교차로,2023.7.6 09:00,287,0,533,820,0
부산시청→연산교차로,2023.7.6 09:00,527,373,291,1191,0
사직운동장→연산교차로,2023.7.6 09:00,236,565,59,860,0
신리→연산교차로,2023.7.6 09:00,454,298,53,805,0
안락→연산교차로,2023.7.6 09:00,584,0,129,713,0
연산터널→연산교차로,2023.7.6 09:00,297,369,39,705,0
교대→연산교차로,2023.7.6 10:00,308,0,491,799,0
부산시청→연산교차로,2023.7.6 10:00,530,357,237,1124,0
사직운동장→연산교차로,2023.7.6 10:00,340,583,75,998,0
신리→연산교차로,2023.7.6 10:00,461,297,63,821,0
안락→연산교차로,2023.7.6 10:00,554,0,119,673,0
연산터널→연산교차로,2023.7.6 10:00,292,343,35,670,0
교대→연산교차로,2023.7.6 11:00,295,0,445,740,0
부산시청→연산교차로,2023.7.6 11:00,584,383,255,1222,0
사직운동장→연산교차로,2023.7.6 11:00,338,578,82,998,0
신리→연산교차로,2023.7.6 11:00,444,241,62,747,0
안락→연산교차로,2023.7.6 11:00,533,0,144,677,0
연산터널→연산교차로,2023.7.6 11:00,241,313,48,602,0
교대→연산교차로,2023.7.6 12:00,267,0,358,625,0
부산시청→연산교차로,2023.7.6 12:00,465,329,229,1023,0
사직운동장→연산교차로,2023.7.6 12:00,353,514,67,934,0
신리→연산교차로,2023.7.6 12:00,402,222,51,675,0
안락→연산교차로,2023.7.6 12:00,379,0,142,521,0
연산터널→연산교차로,2023.7.6 12:00,229,230,47,506,0
교대→연산교차로,2023.7.6 13:00,321,0,408,729,0
부산시청→연산교차로,2023.7.6 13:00,577,437,244,1258,0
사직운동장→연산교차로,2023.7.6 13:00,325,565,75,965,0
신리→연산교차로,2023.7.6 13:00,416,265,48,729,0
안락→연산교차로,2023.7.6 13:00,436,0,149,585,0
연산터널→연산교차로,2023.7.6 13:00,240,262,33,535,0
교대→연산교차로,2023.7.6 14:00,317,0,492,809,0
부산시청→연산교차로,2023.7.6 14:00,557,459,294,1310,0
사직운동장→연산교차로,2023.7.6 14:00,300,603,90,993,0
신리→연산교차로,2023.7.6 14:00,461,274,51,786,0
안락→연산교차로,2023.7.6 14:00,434,0,134,568,0
연산터널→연산교차로,2023.7.6 14:00,210,303,44,557,0
교대→연산교차로,2023.7.6 15:00,357,0,462,819,0
부산시청→연산교차로,2023.7.6 15:00,614,464,317,1395,0
사직운동장→연산교차로,2023.7.6 15:00,249,654,71,974,0
신리→연산교차로,2023.7.6 15:00,448,275,49,772,0
안락→연산교차로,2023.7.6 15:00,420,0,125,545,0
연산터널→연산교차로,2023.7.6 15:00,246,269,31,546,0
교대→연산교차로,2023.7.6 16:00,351,0,498,849,0
부산시청→연산교차로,2023.7.6 16:00,656,526,295,1477,0
사직운동장→연산교차로,2023.7.6 16:00,396,675,60,1131,0
신리→연산교차로,2023.7.6 16:00,499,282,66,847,0
안락→연산교차로,2023.7.6 16:00,432,0,121,553,0
연산터널→연산교차로,2023.7.6 16:00,240,272,30,542,0
교대→연산교차로,2023.7.6 17:00,347,0,512,859,0
부산시청→연산교차로,2023.7.6 17:00,616,543,331,1490,0
사직운동장→연산교차로,2023.7.6 17:00,377,715,49,1141,0
신리→연산교차로,2023.7.6 17:00,539,273,54,866,0
안락→연산교차로,2023.7.6 17:00,438,0,116,554,0
연산터널→연산교차로,2023.7.6 17:00,235,264,49,548,0
교대→연산교차로,2023.7.6 18:00,361,0,502,863,0
부산시청→연산교차로,2023.7.6 18:00,632,581,323,1536,0
사직운동장→연산교차로,2023.7.6 18:00,303,687,51,1041,0
신리→연산교차로,2023.7.6 18:00,516,273,35,824,0
안락→연산교차로,2023.7.6 18:00,455,0,104,559,0
연산터널→연산교차로,2023.7.6 18:00,226,275,51,552,0
교대→연산교차로,2023.7.6 19:00,328,0,428,756,0
부산시청→연산교차로,2023.7.6 19:00,522,429,273,1224,0
사직운동장→연산교차로,2023.7.6 19:00,255,566,81,902,0
신리→연산교차로,2023.7.6 19:00,367,229,54,650,0
안락→연산교차로,2023.7.6 19:00,408,0,112,520,0
연산터널→연산교차로,2023.7.6 19:00,222,263,58,543,0
교대→연산교차로,2023.7.6 20:00,311,0,307,618,0
부산시청→연산교차로,2023.7.6 20:00,489,363,256,1108,0
사직운동장→연산교차로,2023.7.6 20:00,200,489,61,750,0
신리→연산교차로,2023.7.6 20:00,331,180,37,548,0
안락→연산교차로,2023.7.6 20:00,394,0,133,527,0
연산터널→연산교차로,2023.7.6 20:00,205,270,45,520,0
교대→연산교차로,2023.7.6 21:00,286,0,297,583,0
부산시청→연산교차로,2023.7.6 21:00,488,335,243,1066,0
사직운동장→연산교차로,2023.7.6 21:00,212,456,75,743,0
신리→연산교차로,2023.7.6 21:00,293,207,35,535,0
안락→연산교차로,2023.7.6 21:00,382,0,153,535,0
연산터널→연산교차로,2023.7.6 21:00,242,267,76,585,0
교대→연산교차로,2023.7.6 22:00,261,0,252,513,0
부산시청→연산교차로,2023.7.6 22:00,427,264,203,894,0
사직운동장→연산교차로,2023.7.6 22:00,162,393,58,613,0
신리→연산교차로,2023.7.6 22:00,294,164,25,483,0
안락→연산교차로,2023.7.6 22:00,335,0,113,448,0
연산터널→연산교차로,2023.7.6 22:00,182,226,68,476,0
교대→연산교차로,2023.7.6 23:00,196,0,205,401,0
부산시청→연산교차로,2023.7.6 23:00,351,200,155,706,0
사직운동장→연산교차로,2023.7.6 23:00,143,327,36,506,0
신리→연산교차로,2023.7.6 23:00,194,128,25,347,0
안락→연산교차로,2023.7.6 23:00,287,0,76,363,0
연산터널→연산교차로,2023.7.6 23:00,188,211,78,477,0
교대→연산교차로,2023.7.7 00:00,147,0,203,350,0
부산시청→연산교차로,2023.7.7 00:00,288,182,103,573,0
사직운동장→연산교차로,2023.7.7 00:00,129,246,24,399,0
신리→연산교차로,2023.7.7 00:00,156,114,26,296,0
안락→연산교차로,2023.7.7 00:00,224,0,67,291,0
연산터널→연산교차로,2023.7.7 00:00,152,175,67,394,0
교대→연산교차로,2023.7.7 01:00,93,0,179,272,0
부산시청→연산교차로,2023.7.7 01:00,208,138,94,440,0
사직운동장→연산교차로,2023.7.7 01:00,80,206,11,297,0
신리→연산교차로,2023.7.7 01:00,119,71,20,210,0
안락→연산교차로,2023.7.7 01:00,161,0,40,201,0
연산터널→연산교차로,2023.7.7 01:00,117,136,58,311,0
교대→연산교차로,2023.7.7 02:00,96,0,115,211,0
부산시청→연산교차로,2023.7.7 02:00,160,88,74,322,0
사직운동장→연산교차로,2023.7.7 02:00,59,163,4,226,0
신리→연산교차로,2023.7.7 02:00,92,61,11,164,0
안락→연산교차로,2023.7.7 02:00,147,0,37,184,0
연산터널→연산교차로,2023.7.7 02:00,91,107,57,255,0
교대→연산교차로,2023.7.7 03:00,55,0,104,159,0
부산시청→연산교차로,2023.7.7 03:00,139,80,58,277,0
사직운동장→연산교차로,2023.7.7 03:00,40,125,1,166,0
신리→연산교차로,2023.7.7 03:00,67,46,10,123,0
안락→연산교차로,2023.7.7 03:00,116,0,33,149,0
연산터널→연산교차로,2023.7.7 03:00,93,86,51,230,0
교대→연산교차로,2023.7.7 04:00,53,0,89,142,0
부산시청→연산교차로,2023.7.7 04:00,166,88,47,301,0
사직운동장→연산교차로,2023.7.7 04:00,51,124,3,178,0
신리→연산교차로,2023.7.7 04:00,92,48,14,154,0
안락→연산교차로,2023.7.7 04:00,161,0,33,194,0
연산터널→연산교차로,2023.7.7 04:00,82,105,33,220,0
교대→연산교차로,2023.7.7 05:00,104,0,124,228,0
부산시청→연산교차로,2023.7.7 05:00,256,149,91,496,0
사직운동장→연산교차로,2023.7.7 05:00,73,175,38,286,0
신리→연산교차로,2023.7.7 05:00,225,100,16,341,0
안락→연산교차로,2023.7.7 05:00,356,0,65,421,0
연산터널→연산교차로,2023.7.7 05:00,136,153,34,323,0
교대→연산교차로,2023.7.7 06:00,184,0,204,388,0
부산시청→연산교차로,2023.7.7 06:00,363,259,127,749,0
사직운동장→연산교차로,2023.7.7 06:00,114,279,44,437,0
신리→연산교차로,2023.7.7 06:00,325,177,25,527,0
안락→연산교차로,2023.7.7 06:00,486,0,111,597,0
연산터널→연산교차로,2023.7.7 06:00,205,219,40,464,0
교대→연산교차로,2023.7.7 07:00,260,0,411,671,0
부산시청→연산교차로,2023.7.7 07:00,522,384,214,1120,0
사직운동장→연산교차로,2023.7.7 07:00,222,494,51,767,0
신리→연산교차로,2023.7.7 07:00,440,268,33,741,0
안락→연산교차로,2023.7.7 07:00,637,0,87,724,0
연산터널→연산교차로,2023.7.7 07:00,295,376,56,727,0
교대→연산교차로,2023.7.7 08:00,306,0,516,822,0
부산시청→연산교차로,2023.7.7 08:00,597,410,319,1326,0
사직운동장→연산교차로,2023.7.7 08:00,274,639,78,991,0
신리→연산교차로,2023.7.7 08:00,482,359,36,877,0
안락→연산교차로,2023.7.7 08:00,590,0,129,719,0
연산터널→연산교차로,2023.7.7 08:00,323,368,36,727,0
교대→연산교차로,2023.7.7 09:00,286,0,554,840,0
부산시청→연산교차로,2023.7.7 09:00,502,392,317,1211,0
사직운동장→연산교차로,2023.7.7 09:00,315,584,72,971,0
신리→연산교차로,2023.7.7 09:00,439,333,54,826,0
안락→연산교차로,2023.7.7 09:00,571,0,109,680,0
연산터널→연산교차로,2023.7.7 09:00,290,378,36,704,0
교대→연산교차로,2023.7.7 10:00,293,0,521,814,0
부산시청→연산교차로,2023.7.7 10:00,597,346,240,1183,0
사직운동장→연산교차로,2023.7.7 10:00,386,547,81,1014,0
신리→연산교차로,2023.7.7 10:00,417,293,76,786,0
안락→연산교차로,2023.7.7 10:00,539,0,146,685,0
연산터널→연산교차로,2023.7.7 10:00,301,316,42,659,0
교대→연산교차로,2023.7.7 11:00,295,0,477,772,0
부산시청→연산교차로,2023.7.7 11:00,540,381,257,1178,0
사직운동장→연산교차로,2023.7.7 11:00,308,563,80,951,0
신리→연산교차로,2023.7.7 11:00,472,292,71,835,0
안락→연산교차로,2023.7.7 11:00,508,0,157,665,0
연산터널→연산교차로,2023.7.7 11:00,282,300,64,646,0
교대→연산교차로,2023.7.7 12:00,305,0,441,746,0
부산시청→연산교차로,2023.7.7 12:00,577,360,244,1181,0
사직운동장→연산교차로,2023.7.7 12:00,290,561,71,922,0
신리→연산교차로,2023.7.7 12:00,420,262,53,735,0
안락→연산교차로,2023.7.7 12:00,471,0,158,629,0
연산터널→연산교차로,2023.7.7 12:00,292,296,45,633,0
교대→연산교차로,2023.7.7 13:00,323,0,443,766,0
부산시청→연산교차로,2023.7.7 13:00,561,441,307,1309,0
사직운동장→연산교차로,2023.7.7 13:00,291,585,86,962,0
신리→연산교차로,2023.7.7 13:00,447,260,51,758,0
안락→연산교차로,2023.7.7 13:00,440,0,135,575,0
연산터널→연산교차로,2023.7.7 13:00,237,285,43,565,0
교대→연산교차로,2023.7.7 14:00,326,0,537,863,0
부산시청→연산교차로,2023.7.7 14:00,560,457,262,1279,0
사직운동장→연산교차로,2023.7.7 14:00,306,595,74,975,0
신리→연산교차로,2023.7.7 14:00,445,290,51,786,0
안락→연산교차로,2023.7.7 14:00,418,0,136,554,0
연산터널→연산교차로,2023.7.7 14:00,242,248,53,543,0
교대→연산교차로,2023.7.7 15:00,338,0,490,828,0
부산시청→연산교차로,2023.7.7 15:00,536,486,292,1314,0
사직운동장→연산교차로,2023.7.7 15:00,353,598,62,1013,0
신리→연산교차로,2023.7.7 15:00,460,260,59,779,0
안락→연산교차로,2023.7.7 15:00,432,0,124,556,0
연산터널→연산교차로,2023.7.7 15:00,232,285,55,572,0
교대→연산교차로,2023.7.7 16:00,326,0,511,837,0
부산시청→연산교차로,2023.7.7 16:00,558,522,306,1386,0
사직운동장→연산교차로,2023.7.7 16:00,307,621,33,961,0
신리→연산교차로,2023.7.7 16:00,457,283,52,792,0
안락→연산교차로,2023.7.7 16:00,406,0,116,522,0
연산터널→연산교차로,2023.7.7 16:00,238,255,43,536,0
교대→연산교차로,2023.7.7 17:00,327,0,520,847,0
부산시청→연산교차로,2023.7.7 17:00,562,500,278,1340,0
사직운동장→연산교차로,2023.7.7 17:00,283,636,32,951,0
신리→연산교차로,2023.7.7 17:00,460,301,55,816,0
안락→연산교차로,2023.7.7 17:00,348,0,90,438,0
연산터널→연산교차로,2023.7.7 17:00,207,278,60,545,0
교대→연산교차로,2023.7.7 18:00,380,0,556,936,0
부산시청→연산교차로,2023.7.7 18:00,473,527,271,1271,0
사직운동장→연산교차로,2023.7.7 18:00,250,606,28,884,0
신리→연산교차로,2023.7.7 18:00,529,248,61,838,0
안락→연산교차로,2023.7.7 18:00,426,0,109,535,0
연산터널→연산교차로,2023.7.7 18:00,201,273,38,512,0
교대→연산교차로,2023.7.7 19:00,345,0,433,778,0
부산시청→연산교차로,2023.7.7 19:00,572,490,307,1369,0
사직운동장→연산교차로,2023.7.7 19:00,219,616,42,877,0
신리→연산교차로,2023.7.7 19:00,414,221,24,659,0
안락→연산교차로,2023.7.7 19:00,399,0,103,502,0
연산터널→연산교차로,2023.7.7 19:00,205,263,47,515,0
교대→연산교차로,2023.7.7 20:00,328,0,350,678,0
부산시청→연산교차로,2023.7.7 20:00,467,354,248,1069,0
사직운동장→연산교차로,2023.7.7 20:00,218,531,64,813,0
신리→연산교차로,2023.7.7 20:00,322,196,28,546,0
안락→연산교차로,2023.7.7 20:00,412,0,95,507,0
연산터널→연산교차로,2023.7.7 20:00,223,253,46,522,0
교대→연산교차로,2023.7.7 21:00,306,0,281,587,0
부산시청→연산교차로,2023.7.7 21:00,482,303,214,999,0
사직운동장→연산교차로,2023.7.7 21:00,170,422,52,644,0
신리→연산교차로,2023.7.7 21:00,287,186,27,500,0
안락→연산교차로,2023.7.7 21:00,397,0,106,503,0
연산터널→연산교차로,2023.7.7 21:00,253,275,50,578,0
교대→연산교차로,2023.7.7 22:00,263,0,285,548,0
부산시청→연산교차로,2023.7.7 22:00,412,271,174,857,0
사직운동장→연산교차로,2023.7.7 22:00,139,389,96,624,0
신리→연산교차로,2023.7.7 22:00,256,174,28,458,0
안락→연산교차로,2023.7.7 22:00,335,0,105,440,0
연산터널→연산교차로,2023.7.7 22:00,202,240,63,505,0
교대→연산교차로,2023.7.7 23:00,165,0,163,328,0
부산시청→연산교차로,2023.7.7 23:00,329,197,145,671,0
사직운동장→연산교차로,2023.7.7 23:00,137,294,48,479,0
신리→연산교차로,2023.7.7 23:00,219,147,20,386,0
안락→연산교차로,2023.7.7 23:00,276,0,79,355,0
연산터널→연산교차로,2023.7.7 23:00,167,209,55,431,0
교대→연산교차로,2023.7.8 00:00,177,0,150,327,0
부산시청→연산교차로,2023.7.8 00:00,281,181,105,567,0
사직운동장→연산교차로,2023.7.8 00:00,131,255,26,412,0
신리→연산교차로,2023.7.8 00:00,183,112,16,311,0
안락→연산교차로,2023.7.8 00:00,248,0,76,324,0
연산터널→연산교차로,2023.7.8 00:00,152,175,32,359,0
교대→연산교차로,2023.7.8 01:00,137,0,154,291,0
부산시청→연산교차로,2023.7.8 01:00,232,142,83,457,0
사직운동장→연산교차로,2023.7.8 01:00,101,197,18,316,0
신리→연산교차로,2023.7.8 01:00,145,69,10,224,0
안락→연산교차로,2023.7.8 01:00,176,0,54,230,0
연산터널→연산교차로,2023.7.8 01:00,128,172,24,324,0
교대→연산교차로,2023.7.8 02:00,100,0,116,216,0
부산시청→연산교차로,2023.7.8 02:00,194,130,74,398,0
사직운동장→연산교차로,2023.7.8 02:00,86,169,9,264,0
신리→연산교차로,2023.7.8 02:00,116,80,12,208,0
안락→연산교차로,2023.7.8 02:00,162,0,51,213,0
연산터널→연산교차로,2023.7.8 02:00,98,145,15,258,0
교대→연산교차로,2023.7.8 03:00,74,0,135,209,0
부산시청→연산교차로,2023.7.8 03:00,180,109,62,351,0
사직운동장→연산교차로,2023.7.8 03:00,49,154,16,219,0
신리→연산교차로,2023.7.8 03:00,87,55,10,152,0
안락→연산교차로,2023.7.8 03:00,118,0,30,148,0
연산터널→연산교차로,2023.7.8 03:00,77,126,20,223,0
교대→연산교차로,2023.7.8 04:00,56,0,91,147,0
부산시청→연산교차로,2023.7.8 04:00,177,79,62,318,0
사직운동장→연산교차로,2023.7.8 04:00,61,143,24,228,0
신리→연산교차로,2023.7.8 04:00,103,41,6,150,0
안락→연산교차로,2023.7.8 04:00,169,0,42,211,0
연산터널→연산교차로,2023.7.8 04:00,87,103,20,210,0
교대→연산교차로,2023.7.8 05:00,101,0,125,226,0
부산시청→연산교차로,2023.7.8 05:00,234,118,72,424,0
사직운동장→연산교차로,2023.7.8 05:00,61,159,41,261,0
신리→연산교차로,2023.7.8 05:00,189,91,12,292,0
안락→연산교차로,2023.7.8 05:00,295,0,67,362,0
연산터널→연산교차로,2023.7.8 05:00,98,141,27,266,0
교대→연산교차로,2023.7.8 06:00,146,0,173,319,0
부산시청→연산교차로,2023.7.8 06:00,294,213,96,603,0
사직운동장→연산교차로,2023.7.8 06:00,95,218,40,353,0
신리→연산교차로,2023.7.8 06:00,244,135,13,392,0
안락→연산교차로,2023.7.8 06:00,350,0,77,427,0
연산터널→연산교차로,2023.7.8 06:00,162,165,35,362,0
교대→연산교차로,2023.7.8 07:00,169,0,210,379,0
부산시청→연산교차로,2023.7.8 07:00,379,220,133,732,0
사직운동장→연산교차로,2023.7.8 07:00,121,312,49,482,0
신리→연산교차로,2023.7.8 07:00,264,142,29,435,0
안락→연산교차로,2023.7.8 07:00,433,0,106,539,0
연산터널→연산교차로,2023.7.8 07:00,165,195,42,402,0
교대→연산교차로,2023.7.8 08:00,238,0,321,559,0
부산시청→연산교차로,2023.7.8 08:00,431,292,221,944,0
사직운동장→연산교차로,2023.7.8 08:00,213,556,58,827,0
신리→연산교차로,2023.7.8 08:00,392,236,51,679,0
안락→연산교차로,2023.7.8 08:00,487,0,122,609,0
연산터널→연산교차로,2023.7.8 08:00,276,289,45,610,0
교대→연산교차로,2023.7.8 09:00,279,0,409,688,0
부산시청→연산교차로,2023.7.8 09:00,520,348,267,1135,0
사직운동장→연산교차로,2023.7.8 09:00,254,558,65,877,0
신리→연산교차로,2023.7.8 09:00,436,295,72,803,0
안락→연산교차로,2023.7.8 09:00,531,0,158,689,0
연산터널→연산교차로,2023.7.8 09:00,304,308,80,692,0
교대→연산교차로,2023.7.8 10:00,280,0,488,768,0
부산시청→연산교차로,2023.7.8 10:00,534,378,246,1158,0
사직운동장→연산교차로,2023.7.8 10:00,264,577,49,890,0
신리→연산교차로,2023.7.8 10:00,457,317,71,845,0
안락→연산교차로,2023.7.8 10:00,529,0,167,696,0
연산터널→연산교차로,2023.7.8 10:00,288,317,69,674,0
교대→연산교차로,2023.7.8 11:00,297,0,505,802,0
부산시청→연산교차로,2023.7.8 11:00,579,385,322,1286,0
사직운동장→연산교차로,2023.7.8 11:00,291,620,52,963,0
신리→연산교차로,2023.7.8 11:00,478,294,71,843,0
안락→연산교차로,2023.7.8 11:00,560,0,149,709,0
연산터널→연산교차로,2023.7.8 11:00,299,333,70,702,0
교대→연산교차로,2023.7.8 12:00,323,0,516,839,0
부산시청→연산교차로,2023.7.8 12:00,586,381,253,1220,0
사직운동장→연산교차로,2023.7.8 12:00,329,593,44,966,0
신리→연산교차로,2023.7.8 12:00,502,282,61,845,0
안락→연산교차로,2023.7.8 12:00,529,0,161,690,0
연산터널→연산교차로,2023.7.8 12:00,302,347,39,688,0
교대→연산교차로,2023.7.8 13:00,351,0,530,881,0
부산시청→연산교차로,2023.7.8 13:00,624,482,313,1419,0
사직운동장→연산교차로,2023.7.8 13:00,254,667,43,964,0
신리→연산교차로,2023.7.8 13:00,464,290,90,844,0
안락→연산교차로,2023.7.8 13:00,451,0,148,599,0
연산터널→연산교차로,2023.7.8 13:00,237,283,47,567,0
교대→연산교차로,2023.7.8 14:00,336,0,472,808,0
부산시청→연산교차로,2023.7.8 14:00,582,503,307,1392,0
사직운동장→연산교차로,2023.7.8 14:00,287,627,51,965,0
신리→연산교차로,2023.7.8 14:00,475,266,60,801,0
안락→연산교차로,2023.7.8 14:00,445,0,103,548,0
연산터널→연산교차로,2023.7.8 14:00,220,281,43,544,0
교대→연산교차로,2023.7.8 15:00,332,0,452,784,0
부산시청→연산교차로,2023.7.8 15:00,578,459,310,1347,0
사직운동장→연산교차로,2023.7.8 15:00,309,616,35,960,0
신리→연산교차로,2023.7.8 15:00,466,282,56,804,0
안락→연산교차로,2023.7.8 15:00,438,0,105,543,0
연산터널→연산교차로,2023.7.8 15:00,216,280,34,530,0
교대→연산교차로,2023.7.8 16:00,357,0,440,797,0
부산시청→연산교차로,2023.7.8 16:00,637,498,312,1447,0
사직운동장→연산교차로,2023.7.8 16:00,304,631,56,991,0
신리→연산교차로,2023.7.8 16:00,445,314,48,807,0
안락→연산교차로,2023.7.8 16:00,439,0,121,560,0
연산터널→연산교차로,2023.7.8 16:00,251,262,49,562,0
교대→연산교차로,2023.7.8 17:00,316,0,403,719,0
부산시청→연산교차로,2023.7.8 17:00,607,478,304,1389,0
사직운동장→연산교차로,2023.7.8 17:00,261,657,46,964,0
신리→연산교차로,2023.7.8 17:00,407,305,48,760,0
안락→연산교차로,2023.7.8 17:00,454,0,102,556,0
연산터널→연산교차로,2023.7.8 17:00,234,263,44,541,0
교대→연산교차로,2023.7.8 18:00,335,0,415,750,0
부산시청→연산교차로,2023.7.8 18:00,578,404,262,1244,0
사직운동장→연산교차로,2023.7.8 18:00,269,590,76,935,0
신리→연산교차로,2023.7.8 18:00,401,262,36,699,0
안락→연산교차로,2023.7.8 18:00,449,0,122,571,0
연산터널→연산교차로,2023.7.8 18:00,221,274,74,569,0
교대→연산교차로,2023.7.8 19:00,290,0,339,629,0
부산시청→연산교차로,2023.7.8 19:00,479,366,235,1080,0
사직운동장→연산교차로,2023.7.8 19:00,169,502,75,746,0
신리→연산교차로,2023.7.8 19:00,334,204,41,579,0
안락→연산교차로,2023.7.8 19:00,388,0,115,503,0
연산터널→연산교차로,2023.7.8 19:00,221,255,56,532,0
교대→연산교차로,2023.7.8 20:00,254,0,271,525,0
부산시청→연산교차로,2023.7.8 20:00,483,330,192,1005,0
사직운동장→연산교차로,2023.7.8 20:00,222,487,60,769,0
신리→연산교차로,2023.7.8 20:00,318,184,42,544,0
안락→연산교차로,2023.7.8 20:00,390,0,107,497,0
연산터널→연산교차로,2023.7.8 20:00,206,269,41,516,0
교대→연산교차로,2023.7.8 21:00,268,0,256,524,0
부산시청→연산교차로,2023.7.8 21:00,470,325,198,993,0
사직운동장→연산교차로,2023.7.8 21:00,255,436,58,749,0
신리→연산교차로,2023.7.8 21:00,331,196,31,558,0
안락→연산교차로,2023.7.8 21:00,376,0,118,494,0
연산터널→연산교차로,2023.7.8 21:00,275,244,58,577,0
교대→연산교차로,2023.7.8 22:00,221,0,259,480,0
부산시청→연산교차로,2023.7.8 22:00,368,241,169,778,0
사직운동장→연산교차로,2023.7.8 22:00,198,368,60,626,0
신리→연산교차로,2023.7.8 22:00,305,155,27,487,0
안락→연산교차로,2023.7.8 22:00,319,0,118,437,0
연산터널→연산교차로,2023.7.8 22:00,205,239,67,511,0
교대→연산교차로,2023.7.8 23:00,178,0,189,367,0
부산시청→연산교차로,2023.7.8 23:00,358,199,146,703,0
사직운동장→연산교차로,2023.7.8 23:00,125,290,33,448,0
신리→연산교차로,2023.7.8 23:00,218,138,23,379,0
안락→연산교차로,2023.7.8 23:00,296,0,77,373,0
연산터널→연산교차로,2023.7.8 23:00,150,203,80,433,0
교대→연산교차로,2023.7.9 00:00,170,0,209,379,1
부산시청→연산교차로,2023.7.9 00:00,308,183,103,594,1
사직운동장→연산교차로,2023.7.9 00:00,101,241,41,383,1
신리→연산교차로,2023.7.9 00:00,239,135,17,391,1
안락→연산교차로,2023.7.9 00:00,249,0,76,325,1
연산터널→연산교차로,2023.7.9 00:00,140,172,48,360,1
교대→연산교차로,2023.7.9 01:00,126,0,198,324,1
부산시청→연산교차로,2023.7.9 01:00,274,154,105,533,1
사직운동장→연산교차로,2023.7.9 01:00,84,204,20,308,1
신리→연산교차로,2023.7.9 01:00,141,101,17,259,1
안락→연산교차로,2023.7.9 01:00,222,0,67,289,1
연산터널→연산교차로,2023.7.9 01:00,129,168,36,333,1
교대→연산교차로,2023.7.9 02:00,102,0,195,297,1
부산시청→연산교차로,2023.7.9 02:00,232,125,79,436,1
사직운동장→연산교차로,2023.7.9 02:00,81,178,36,295,1
신리→연산교차로,2023.7.9 02:00,125,84,11,220,1
안락→연산교차로,2023.7.9 02:00,183,0,69,252,1
연산터널→연산교차로,2023.7.9 02:00,102,144,36,282,1
교대→연산교차로,2023.7.9 03:00,98,0,173,271,1
부산시청→연산교차로,2023.7.9 03:00,201,106,74,381,1
사직운동장→연산교차로,2023.7.9 03:00,49,155,23,227,1
신리→연산교차로,2023.7.9 03:00,110,64,8,182,1
안락→연산교차로,2023.7.9 03:00,139,0,47,186,1
연산터널→연산교차로,2023.7.9 03:00,107,106,36,249,1
교대→연산교차로,2023.7.9 04:00,80,0,119,199,1
부산시청→연산교차로,2023.7.9 04:00,161,98,52,311,1
사직운동장→연산교차로,2023.7.9 04:00,48,119,13,180,1
신리→연산교차로,2023.7.9 04:00,73,49,9,131,1
안락→연산교차로,2023.7.9 04:00,133,0,42,175,1
연산터널→연산교차로,2023.7.9 04:00,74,108,14,196,1
교대→연산교차로,2023.7.9 05:00,69,0,115,184,1
부산시청→연산교차로,2023.7.9 05:00,159,119,44,322,1
사직운동장→연산교차로,2023.7.9 05:00,61,140,26,227,1
신리→연산교차로,2023.7.9 05:00,110,68,12,190,1
안락→연산교차로,2023.7.9 05:00,184,0,62,246,1
연산터널→연산교차로,2023.7.9 05:00,81,124,22,227,1
교대→연산교차로,2023.7.9 06:00,116,0,114,230,1
부산시청→연산교차로,2023.7.9 06:00,208,145,63,416,1
사직운동장→연산교차로,2023.7.9 06:00,62,184,37,283,1
신리→연산교차로,2023.7.9 06:00,157,80,11,248,1
안락→연산교차로,2023.7.9 06:00,256,0,53,309,1
연산터널→연산교차로,2023.7.9 06:00,121,114,31,266,1
교대→연산교차로,2023.7.9 07:00,132,0,146,278,1
부산시청→연산교차로,2023.7.9 07:00,213,176,77,466,1
사직운동장→연산교차로,2023.7.9 07:00,79,227,41,347,1
신리→연산교차로,2023.7.9 07:00,186,81,17,284,1
안락→연산교차로,2023.7.9 07:00,256,0,52,308,1
연산터널→연산교차로,2023.7.9 07:00,133,109,33,275,1
교대→연산교차로,2023.7.9 08:00,177,0,153,330,1
부산시청→연산교차로,2023.7.9 08:00,277,229,113,619,1
사직운동장→연산교차로,2023.7.9 08:00,133,299,35,467,1
신리→연산교차로,2023.7.9 08:00,268,120,32,420,1
안락→연산교차로,2023.7.9 08:00,323,0,78,401,1
연산터널→연산교차로,2023.7.9 08:00,177,155,31,363,1
교대→연산교차로,2023.7.9 09:00,217,0,221,438,1
부산시청→연산교차로,2023.7.9 09:00,366,268,147,781,1
사직운동장→연산교차로,2023.7.9 09:00,140,404,43,587,1
신리→연산교차로,2023.7.9 09:00,382,192,25,599,1
안락→연산교차로,2023.7.9 09:00,377,0,118,495,1
연산터널→연산교차로,2023.7.9 09:00,275,200,45,520,1
교대→연산교차로,2023.7.9 10:00,295,0,283,578,1
부산시청→연산교차로,2023.7.9 10:00,453,321,180,954,1
사직운동장→연산교차로,2023.7.9 10:00,228,557,58,843,1
신리→연산교차로,2023.7.9 10:00,460,209,39,708,1
안락→연산교차로,2023.7.9 10:00,488,0,88,576,1
연산터널→연산교차로,2023.7.9 10:00,249,222,40,511,1
교대→연산교차로,2023.7.9 11:00,290,0,305,595,1
부산시청→연산교차로,2023.7.9 11:00,450,338,178,966,1
사직운동장→연산교차로,2023.7.9 11:00,208,516,54,778,1
신리→연산교차로,2023.7.9 11:00,424,212,34,670,1
안락→연산교차로,2023.7.9 11:00,456,0,97,553,1
연산터널→연산교차로,2023.7.9 11:00,252,238,63,553,1
교대→연산교차로,2023.7.9 12:00,304,0,338,642,1
부산시청→연산교차로,2023.7.9 12:00,459,343,208,1010,1
사직운동장→연산교차로,2023.7.9 12:00,232,531,53,816,1
신리→연산교차로,2023.7.9 12:00,431,260,43,734,1
안락→연산교차로,2023.7.9 12:00,526,0,136,662,1
연산터널→연산교차로,2023.7.9 12:00,278,266,50,594,1
교대→연산교차로,2023.7.9 13:00,292,0,331,623,1
부산시청→연산교차로,2023.7.9 13:00,539,375,215,1129,1
사직운동장→연산교차로,2023.7.9 13:00,266,587,58,911,1
신리→연산교차로,2023.7.9 13:00,464,258,37,759,1
안락→연산교차로,2023.7.9 13:00,538,0,150,688,1
연산터널→연산교차로,2023.7.9 13:00,262,277,52,591,1
교대→연산교차로,2023.7.9 14:00,269,0,356,625,1
부산시청→연산교차로,2023.7.9 14:00,550,362,208,1120,1
사직운동장→연산교차로,2023.7.9 14:00,228,595,61,884,1
신리→연산교차로,2023.7.9 14:00,431,239,41,711,1
안락→연산교차로,2023.7.9 14:00,487,0,156,643,1
연산터널→연산교차로,2023.7.9 14:00,272,276,57,605,1
교대→연산교차로,2023.7.9 15:00,290,0,297,587,1
부산시청→연산교차로,2023.7.9 15:00,568,384,221,1173,1
사직운동장→연산교차로,2023.7.9 15:00,241,569,66,876,1
신리→연산교차로,2023.7.9 15:00,419,278,46,743,1
안락→연산교차로,2023.7.9 15:00,513,0,193,706,1
연산터널→연산교차로,2023.7.9 15:00,272,286,36,594,1
교대→연산교차로,2023.7.9 16:00,296,0,335,631,1
부산시청→연산교차로,2023.7.9 16:00,510,361,211,1082,1
사직운동장→연산교차로,2023.7.9 16:00,227,558,54,839,1
신리→연산교차로,2023.7.9 16:00,377,245,35,657,1
안락→연산교차로,2023.7.9 16:00,569,0,159,728,1
연산터널→연산교차로,2023.7.9 16:00,246,266,52,564,1
교대→연산교차로,2023.7.9 17:00,295,0,284,579,1
부산시청→연산교차로,2023.7.9 17:00,483,314,201,998,1
사직운동장→연산교차로,2023.7.9 17:00,231,509,41,781,1
신리→연산교차로,2023.7.9 17:00,415,254,39,708,1
안락→연산교차로,2023.7.9 17:00,502,0,137,639,1
연산터널→연산교차로,2023.7.9 17:00,247,269,45,561,1
교대→연산교차로,2023.7.9 18:00,300,0,316,616,1
부산시청→연산교차로,2023.7.9 18:00,450,286,169,905,1
사직운동장→연산교차로,2023.7.9 18:00,211,462,57,730,1
신리→연산교차로,2023.7.9 18:00,378,177,35,590,1
안락→연산교차로,2023.7.9 18:00,411,0,139,550,1
연산터널→연산교차로,2023.7.9 18:00,230,227,64,521,1
교대→연산교차로,2023.7.9 19:00,257,0,266,523,1
부산시청→연산교차로,2023.7.9 19:00,398,271,180,849,1
사직운동장→연산교차로,2023.7.9 19:00,163,406,53,622,1
신리→연산교차로,2023.7.9 19:00,286,170,31,487,1
안락→연산교차로,2023.7.9 19:00,359,0,110,469,1
연산터널→연산교차로,2023.7.9 19:00,244,215,51,510,1
교대→연산교차로,2023.7.9 20:00,294,0,237,531,1
부산시청→연산교차로,2023.7.9 20:00,419,247,160,826,1
사직운동장→연산교차로,2023.7.9 20:00,161,396,56,613,1
신리→연산교차로,2023.7.9 20:00,305,144,28,477,1
안락→연산교차로,2023.7.9 20:00,380,0,107,487,1
연산터널→연산교차로,2023.7.9 20:00,212,199,61,472,1
교대→연산교차로,2023.7.9 21:00,257,0,207,464,1
부산시청→연산교차로,2023.7.9 21:00,384,244,146,774,1
사직운동장→연산교차로,2023.7.9 21:00,193,416,46,655,1
신리→연산교차로,2023.7.9 21:00,303,157,20,480,1
안락→연산교차로,2023.7.9 21:00,311,0,87,398,1
연산터널→연산교차로,2023.7.9 21:00,166,188,34,388,1
교대→연산교차로,2023.7.9 22:00,193,0,177,370,1
부산시청→연산교차로,2023.7.9 22:00,320,187,124,631,1
사직운동장→연산교차로,2023.7.9 22:00,119,297,51,467,1
신리→연산교차로,2023.7.9 22:00,226,123,21,370,1
안락→연산교차로,2023.7.9 22:00,277,0,61,338,1
연산터널→연산교차로,2023.7.9 22:00,145,165,44,354,1
교대→연산교차로,2023.7.9 23:00,119,0,141,260,1
부산시청→연산교차로,2023.7.9 23:00,223,169,100,492,1
사직운동장→연산교차로,2023.7.9 23:00,60,198,67,325,1
신리→연산교차로,2023.7.9 23:00,173,112,16,301,1
안락→연산교차로,2023.7.9 23:00,196,0,50,246,1
연산터널→연산교차로,2023.7.9 23:00,118,144,68,330,1
교대→연산교차로,2023.7.10 00:00,105,0,129,234,0
부산시청→연산교차로,2023.7.10 00:00,177,128,84,389,0
사직운동장→연산교차로,2023.7.10 00:00,78,180,34,292,0
신리→연산교차로,2023.7.10 00:00,113,55,17,185,0
안락→연산교차로,2023.7.10 00:00,162,0,43,205,0
연산터널→연산교차로,2023.7.10 00:00,106,142,66,314,0
교대→연산교차로,2023.7.10 01:00,72,0,105,177,0
부산시청→연산교차로,2023.7.10 01:00,168,92,62,322,0
사직운동장→연산교차로,2023.7.10 01:00,42,137,26,205,0
신리→연산교차로,2023.7.10 01:00,86,51,23,160,0
안락→연산교차로,2023.7.10 01:00,131,0,34,165,0
연산터널→연산교차로,2023.7.10 01:00,75,99,59,233,0
교대→연산교차로,2023.7.10 02:00,56,0,80,136,0
부산시청→연산교차로,2023.7.10 02:00,124,56,42,222,0
사직운동장→연산교차로,2023.7.10 02:00,49,105,18,172,0
신리→연산교차로,2023.7.10 02:00,79,44,10,133,0
안락→연산교차로,2023.7.10 02:00,102,0,40,142,0
연산터널→연산교차로,2023.7.10 02:00,68,90,41,199,0
교대→연산교차로,2023.7.10 03:00,39,0,82,121,0
부산시청→연산교차로,2023.7.10 03:00,122,65,44,231,0
사직운동장→연산교차로,2023.7.10 03:00,37,93,6,136,0
신리→연산교차로,2023.7.10 03:00,56,35,7,98,0
안락→연산교차로,2023.7.10 03:00,92,0,21,113,0
연산터널→연산교차로,2023.7.10 03:00,58,70,27,155,0
교대→연산교차로,2023.7.10 04:00,54,0,63,117,0
부산시청→연산교차로,2023.7.10 04:00,122,67,35,224,0
사직운동장→연산교차로,2023.7.10 04:00,32,94,13,139,0
신리→연산교차로,2023.7.10 04:00,92,42,6,140,0
안락→연산교차로,2023.7.10 04:00,152,0,24,176,0
연산터널→연산교차로,2023.7.10 04:00,79,70,26,175,0
교대→연산교차로,2023.7.10 05:00,105,0,125,230,0
부산시청→연산교차로,2023.7.10 05:00,223,155,68,446,0
사직운동장→연산교차로,2023.7.10 05:00,57,157,25,239,0
신리→연산교차로,2023.7.10 05:00,221,98,10,329,0
안락→연산교차로,2023.7.10 05:00,365,0,74,439,0
연산터널→연산교차로,2023.7.10 05:00,127,137,32,296,0
교대→연산교차로,2023.7.10 06:00,189,0,221,410,0
부산시청→연산교차로,2023.7.10 06:00,394,239,110,743,0
사직운동장→연산교차로,2023.7.10 06:00,133,266,55,454,0
신리→연산교차로,2023.7.10 06:00,362,166,24,552,0
안락→연산교차로,2023.7.10 06:00,532,0,99,631,0
연산터널→연산교차로,2023.7.10 06:00,224,238,39,501,0
교대→연산교차로,2023.7.10 07:00,265,0,428,693,0
부산시청→연산교차로,2023.7.10 07:00,549,381,222,1152,0
사직운동장→연산교차로,2023.7.10 07:00,204,511,71,786,0
신리→연산교차로,2023.7.10 07:00,470,311,27,808,0
안락→연산교차로,2023.7.10 07:00,634,0,89,723,0
연산터널→연산교차로,2023.7.10 07:00,313,382,38,733,0
교대→연산교차로,2023.7.10 08:00,318,0,495,813,0
부산시청→연산교차로,2023.7.10 08:00,600,462,323,1385,0
사직운동장→연산교차로,2023.7.10 08:00,270,632,84,986,0
신리→연산교차로,2023.7.10 08:00,510,355,34,899,0
안락→연산교차로,2023.7.10 08:00,594,0,126,720,0
연산터널→연산교차로,2023.7.10 08:00,347,355,32,734,0
교대→연산교차로,2023.7.10 09:00,280,0,547,827,0
부산시청→연산교차로,2023.7.10 09:00,542,384,291,1217,0
사직운동장→연산교차로,2023.7.10 09:00,285,566,102,953,0
신리→연산교차로,2023.7.10 09:00,440,340,52,832,0
안락→연산교차로,2023.7.10 09:00,584,0,117,701,0
연산터널→연산교차로,2023.7.10 09:00,324,351,42,717,0
교대→연산교차로,2023.7.10 10:00,292,0,473,765,0
부산시청→연산교차로,2023.7.10 10:00,512,354,275,1141,0
사직운동장→연산교차로,2023.7.10 10:00,272,541,85,898,0
신리→연산교차로,2023.7.10 10:00,437,283,46,766,0
안락→연산교차로,2023.7.10 10:00,557,0,137,694,0
연산터널→연산교차로,2023.7.10 10:00,286,339,53,678,0
교대→연산교차로,2023.7.10 11:00,294,0,480,774,0
부산시청→연산교차로,2023.7.10 11:00,587,397,243,1227,0
사직운동장→연산교차로,2023.7.10 11:00,336,617,73,1026,0
신리→연산교차로,2023.7.10 11:00,431,264,61,756,0
안락→연산교차로,2023.7.10 11:00,530,0,160,690,0
연산터널→연산교차로,2023.7.10 11:00,301,329,58,688,0
교대→연산교차로,2023.7.10 12:00,276,0,383,659,0
부산시청→연산교차로,2023.7.10 12:00,553,366,258,1177,0
사직운동장→연산교차로,2023.7.10 12:00,269,533,72,874,0
신리→연산교차로,2023.7.10 12:00,427,253,54,734,0
안락→연산교차로,2023.7.10 12:00,448,0,155,603,0
연산터널→연산교차로,2023.7.10 12:00,242,284,50,576,0
교대→연산교차로,2023.7.10 13:00,328,0,461,789,0
부산시청→연산교차로,2023.7.10 13:00,562,460,322,1344,0
사직운동장→연산교차로,2023.7.10 13:00,364,596,69,1029,0
신리→연산교차로,2023.7.10 13:00,436,275,65,776,0
안락→연산교차로,2023.7.10 13:00,403,0,123,526,0
연산터널→연산교차로,2023.7.10 13:00,258,280,34,572,0
교대→연산교차로,2023.7.10 14:00,356,0,494,850,0
부산시청→연산교차로,2023.7.10 14:00,516,440,344,1300,0
사직운동장→연산교차로,2023.7.10 14:00,368,581,90,1039,0
신리→연산교차로,2023.7.10 14:00,439,265,63,767,0
안락→연산교차로,2023.7.10 14:00,428,0,150,578,0
연산터널→연산교차로,2023.7.10 14:00,254,268,47,569,0
교대→연산교차로,2023.7.10 15:00,365,0,470,835,0
부산시청→연산교차로,2023.7.10 15:00,549,456,339,1344,0
사직운동장→연산교차로,2023.7.10 15:00,327,590,80,997,0
신리→연산교차로,2023.7.10 15:00,469,275,60,804,0
안락→연산교차로,2023.7.10 15:00,457,0,128,585,0
연산터널→연산교차로,2023.7.10 15:00,240,273,47,560,0
교대→연산교차로,2023.7.10 16:00,363,0,516,879,0
부산시청→연산교차로,2023.7.10 16:00,583,525,396,1504,0
사직운동장→연산교차로,2023.7.10 16:00,374,666,64,1104,0
신리→연산교차로,2023.7.10 16:00,510,279,65,854,0
안락→연산교차로,2023.7.10 16:00,440,0,111,551,0
연산터널→연산교차로,2023.7.10 16:00,228,290,42,560,0
교대→연산교차로,2023.7.10 17:00,353,0,572,925,0
부산시청→연산교차로,2023.7.10 17:00,602,545,321,1468,0
사직운동장→연산교차로,2023.7.10 17:00,371,702,43,1116,0
신리→연산교차로,2023.7.10 17:00,548,279,52,879,0
안락→연산교차로,2023.7.10 17:00,430,0,128,558,0
연산터널→연산교차로,2023.7.10 17:00,226,277,42,545,0
교대→연산교차로,2023.7.10 18:00,385,0,536,921,0
부산시청→연산교차로,2023.7.10 18:00,637,571,346,1554,0
사직운동장→연산교차로,2023.7.10 18:00,423,702,38,1163,0
신리→연산교차로,2023.7.10 18:00,521,291,52,864,0
안락→연산교차로,2023.7.10 18:00,441,0,123,564,0
연산터널→연산교차로,2023.7.10 18:00,220,282,47,549,0
교대→연산교차로,2023.7.10 19:00,331,0,369,700,0
부산시청→연산교차로,2023.7.10 19:00,521,440,254,1215,0
사직운동장→연산교차로,2023.7.10 19:00,187,590,59,836,0
신리→연산교차로,2023.7.10 19:00,359,225,41,625,0
안락→연산교차로,2023.7.10 19:00,409,0,116,525,0
연산터널→연산교차로,2023.7.10 19:00,202,253,55,510,0
교대→연산교차로,2023.7.10 20:00,313,0,314,627,0
부산시청→연산교차로,2023.7.10 20:00,477,369,224,1070,0
사직운동장→연산교차로,2023.7.10 20:00,182,495,94,771,0
신리→연산교차로,2023.7.10 20:00,317,206,34,557,0
안락→연산교차로,2023.7.10 20:00,397,0,105,502,0
연산터널→연산교차로,2023.7.10 20:00,217,243,46,506,0
교대→연산교차로,2023.7.10 21:00,256,0,294,550,0
부산시청→연산교차로,2023.7.10 21:00,489,279,220,988,0
사직운동장→연산교차로,2023.7.10 21:00,186,427,80,693,0
신리→연산교차로,2023.7.10 21:00,273,181,33,487,0
안락→연산교차로,2023.7.10 21:00,400,0,126,526,0
연산터널→연산교차로,2023.7.10 21:00,225,265,64,554,0
교대→연산교차로,2023.7.10 22:00,216,0,223,439,0
부산시청→연산교차로,2023.7.10 22:00,375,227,153,755,0
사직운동장→연산교차로,2023.7.10 22:00,152,370,78,600,0
신리→연산교차로,2023.7.10 22:00,248,156,40,444,0
안락→연산교차로,2023.7.10 22:00,341,0,80,421,0
연산터널→연산교차로,2023.7.10 22:00,190,213,52,455,0
교대→연산교차로,2023.7.10 23:00,182,0,208,390,0
부산시청→연산교차로,2023.7.10 23:00,327,202,129,658,0
사직운동장→연산교차로,2023.7.10 23:00,119,273,62,454,0
신리→연산교차로,2023.7.10 23:00,196,108,24,328,0
안락→연산교차로,2023.7.10 23:00,238,0,64,302,0
연산터널→연산교차로,2023.7.10 23:00,151,189,70,410,0
교대→연산교차로,2023.7.11 00:00,121,0,164,285,0
부산시청→연산교차로,2023.7.11 00:00,218,154,114,486,0
사직운동장→연산교차로,2023.7.11 00:00,82,250,60,392,0
신리→연산교차로,2023.7.11 00:00,145,77,15,237,0
안락→연산교차로,2023.7.11 00:00,205,0,46,251,0
연산터널→연산교차로,2023.7.11 00:00,137,147,67,351,0
교대→연산교차로,2023.7.11 01:00,101,0,154,255,0
부산시청→연산교차로,2023.7.11 01:00,176,111,68,355,0
사직운동장→연산교차로,2023.7.11 01:00,77,191,31,299,0
신리→연산교차로,2023.7.11 01:00,107,61,17,185,0
안락→연산교차로,2023.7.11 01:00,144,0,44,188,0
연산터널→연산교차로,2023.7.11 01:00,99,116,44,259,0
교대→연산교차로,2023.7.11 02:00,59,0,121,180,0
부산시청→연산교차로,2023.7.11 02:00,175,88,61,324,0
사직운동장→연산교차로,2023.7.11 02:00,51,138,26,215,0
신리→연산교차로,2023.7.11 02:00,71,51,10,132,0
안락→연산교차로,2023.7.11 02:00,126,0,40,166,0
연산터널→연산교차로,2023.7.11 02:00,85,123,30,238,0
교대→연산교차로,2023.7.11 03:00,56,0,89,145,0
부산시청→연산교차로,2023.7.11 03:00,136,70,45,251,0
사직운동장→연산교차로,2023.7.11 03:00,31,121,23,175,0
신리→연산교차로,2023.7.11 03:00,74,52,7,133,0
안락→연산교차로,2023.7.11 03:00,99,0,35,134,0
연산터널→연산교차로,2023.7.11 03:00,72,98,30,200,0
교대→연산교차로,2023.7.11 04:00,57,0,85,142,0
부산시청→연산교차로,2023.7.11 04:00,143,72,38,253,0
사직운동장→연산교차로,2023.7.11 04:00,40,122,20,182,0
신리→연산교차로,2023.7.11 04:00,96,41,10,147,0
안락→연산교차로,2023.7.11 04:00,169,0,35,204,0
연산터널→연산교차로,2023.7.11 04:00,69,94,28,191,0
교대→연산교차로,2023.7.11 05:00,102,0,127,229,0
부산시청→연산교차로,2023.7.11 05:00,208,144,90,442,0
사직운동장→연산교차로,2023.7.11 05:00,55,180,39,274,0
신리→연산교차로,2023.7.11 05:00,211,96,16,323,0
안락→연산교차로,2023.7.11 05:00,323,0,71,394,0
연산터널→연산교차로,2023.7.11 05:00,143,136,36,315,0
교대→연산교차로,2023.7.11 06:00,181,0,218,399,0
부산시청→연산교차로,2023.7.11 06:00,348,250,135,733,0
사직운동장→연산교차로,2023.7.11 06:00,125,287,45,457,0
신리→연산교차로,2023.7.11 06:00,341,201,19,561,0
안락→연산교차로,2023.7.11 06:00,506,0,90,596,0
연산터널→연산교차로,2023.7.11 06:00,224,252,41,517,0
교대→연산교차로,2023.7.11 07:00,245,0,404,649,0
부산시청→연산교차로,2023.7.11 07:00,547,402,248,1197,0
사직운동장→연산교차로,2023.7.11 07:00,200,496,77,773,0
신리→연산교차로,2023.7.11 07:00,432,262,34,728,0
안락→연산교차로,2023.7.11 07:00,607,0,99,706,0
연산터널→연산교차로,2023.7.11 07:00,298,369,36,703,0
교대→연산교차로,2023.7.11 08:00,318,0,531,849,0
부산시청→연산교차로,2023.7.11 08:00,570,419,338,1327,0
사직운동장→연산교차로,2023.7.11 08:00,294,654,76,1024,0
신리→연산교차로,2023.7.11 08:00,505,350,28,883,0
안락→연산교차로,2023.7.11 08:00,626,0,115,741,0
연산터널→연산교차로,2023.7.11 08:00,315,388,28,731,0
교대→연산교차로,2023.7.11 09:00,296,0,537,833,0
부산시청→연산교차로,2023.7.11 09:00,553,374,280,1207,0
사직운동장→연산교차로,2023.7.11 09:00,258,560,83,901,0
신리→연산교차로,2023.7.11 09:00,429,317,30,776,0
안락→연산교차로,2023.7.11 09:00,585,0,118,703,0
연산터널→연산교차로,2023.7.11 09:00,295,373,37,705,0
교대→연산교차로,2023.7.11 10:00,302,0,487,789,0
부산시청→연산교차로,2023.7.11 10:00,559,371,294,1224,0
사직운동장→연산교차로,2023.7.11 10:00,322,567,81,970,0
신리→연산교차로,2023.7.11 10:00,437,277,72,786,0
안락→연산교차로,2023.7.11 10:00,510,0,153,663,0
연산터널→연산교차로,2023.7.11 10:00,293,348,57,698,0
교대→연산교차로,2023.7.11 11:00,287,0,444,731,0
부산시청→연산교차로,2023.7.11 11:00,533,366,268,1167,0
사직운동장→연산교차로,2023.7.11 11:00,291,558,62,911,0
신리→연산교차로,2023.7.11 11:00,445,296,56,797,0
안락→연산교차로,2023.7.11 11:00,471,0,171,642,0
연산터널→연산교차로,2023.7.11 11:00,275,318,69,662,0
교대→연산교차로,2023.7.11 12:00,317,0,451,768,0
부산시청→연산교차로,2023.7.11 12:00,526,364,248,1138,0
사직운동장→연산교차로,2023.7.11 12:00,272,550,78,900,0
신리→연산교차로,2023.7.11 12:00,407,232,49,688,0
안락→연산교차로,2023.7.11 12:00,458,0,197,655,0
연산터널→연산교차로,2023.7.11 12:00,269,266,43,578,0
교대→연산교차로,2023.7.11 13:00,327,0,436,763,0
부산시청→연산교차로,2023.7.11 13:00,532,434,265,1231,0
사직운동장→연산교차로,2023.7.11 13:00,261,596,89,946,0
신리→연산교차로,2023.7.11 13:00,432,251,67,750,0
안락→연산교차로,2023.7.11 13:00,444,0,147,591,0
연산터널→연산교차로,2023.7.11 13:00,265,266,40,571,0
교대→연산교차로,2023.7.11 14:00,317,0,479,796,0
부산시청→연산교차로,2023.7.11 14:00,515,447,279,1241,0
사직운동장→연산교차로,2023.7.11 14:00,310,617,76,1003,0
신리→연산교차로,2023.7.11 14:00,429,291,50,770,0
안락→연산교차로,2023.7.11 14:00,416,0,114,530,0
연산터널→연산교차로,2023.7.11 14:00,216,261,45,522,0
교대→연산교차로,2023.7.11 15:00,308,0,437,745,0
부산시청→연산교차로,2023.7.11 15:00,358,422,168,948,0
사직운동장→연산교차로,2023.7.11 15:00,210,526,49,785,0
신리→연산교차로,2023.7.11 15:00,367,190,55,612,0
안락→연산교차로,2023.7.11 15:00,377,0,95,472,0
연산터널→연산교차로,2023.7.11 15:00,206,235,43,484,0
교대→연산교차로,2023.7.11 16:00,334,0,463,797,0
부산시청→연산교차로,2023.7.11 16:00,476,480,288,1244,0
사직운동장→연산교차로,2023.7.11 16:00,274,615,34,923,0
신리→연산교차로,2023.7.11 16:00,366,170,79,615,0
안락→연산교차로,2023.7.11 16:00,432,0,125,557,0
연산터널→연산교차로,2023.7.11 16:00,252,259,35,546,0
교대→연산교차로,2023.7.11 17:00,365,0,501,866,0
부산시청→연산교차로,2023.7.11 17:00,593,517,324,1434,0
사직운동장→연산교차로,2023.7.11 17:00,292,687,49,1028,0
신리→연산교차로,2023.7.11 17:00,490,273,47,810,0
안락→연산교차로,2023.7.11 17:00,428,0,133,561,0
연산터널→연산교차로,2023.7.11 17:00,237,268,40,545,0
교대→연산교차로,2023.7.11 18:00,367,0,522,889,0
부산시청→연산교차로,2023.7.11 18:00,573,561,337,1471,0
사직운동장→연산교차로,2023.7.11 18:00,310,671,41,1022,0
신리→연산교차로,2023.7.11 18:00,548,265,34,847,0
안락→연산교차로,2023.7.11 18:00,413,0,108,521,0
연산터널→연산교차로,2023.7.11 18:00,224,255,52,531,0
교대→연산교차로,2023.7.11 19:00,327,0,393,720,0
부산시청→연산교차로,2023.7.11 19:00,489,443,279,1211,0
사직운동장→연산교차로,2023.7.11 19:00,209,559,35,803,0
신리→연산교차로,2023.7.11 19:00,299,221,40,560,0
안락→연산교차로,2023.7.11 19:00,386,0,115,501,0
연산터널→연산교차로,2023.7.11 19:00,211,246,32,489,0
교대→연산교차로,2023.7.11 20:00,299,0,280,579,0
부산시청→연산교차로,2023.7.11 20:00,467,335,245,1047,0
사직운동장→연산교차로,2023.7.11 20:00,181,444,46,671,0
신리→연산교차로,2023.7.11 20:00,300,163,27,490,0
안락→연산교차로,2023.7.11 20:00,403,0,88,491,0
연산터널→연산교차로,2023.7.11 20:00,185,245,33,463,0
교대→연산교차로,2023.7.11 21:00,264,0,241,505,0
부산시청→연산교차로,2023.7.11 21:00,443,279,210,932,0
사직운동장→연산교차로,2023.7.11 21:00,166,394,55,615,0
신리→연산교차로,2023.7.11 21:00,256,156,24,436,0
안락→연산교차로,2023.7.11 21:00,406,0,90,496,0
연산터널→연산교차로,2023.7.11 21:00,221,243,47,511,0
교대→연산교차로,2023.7.11 22:00,235,0,207,442,0
부산시청→연산교차로,2023.7.11 22:00,381,264,160,805,0
사직운동장→연산교차로,2023.7.11 22:00,130,341,60,531,0
신리→연산교차로,2023.7.11 22:00,238,129,17,384,0
안락→연산교차로,2023.7.11 22:00,280,0,92,372,0
연산터널→연산교차로,2023.7.11 22:00,193,226,53,472,0
교대→연산교차로,2023.7.11 23:00,159,0,211,370,0
부산시청→연산교차로,2023.7.11 23:00,284,167,111,562,0
사직운동장→연산교차로,2023.7.11 23:00,110,259,66,435,0
신리→연산교차로,2023.7.11 23:00,167,96,20,283,0
안락→연산교차로,2023.7.11 23:00,248,0,66,314,0
연산터널→연산교차로,2023.7.11 23:00,135,165,59,359,0
교대→연산교차로,2023.7.12 00:00,99,0,152,251,0
부산시청→연산교차로,2023.7.12 00:00,206,132,76,414,0
사직운동장→연산교차로,2023.7.12 00:00,96,202,39,337,0
신리→연산교차로,2023.7.12 00:00,130,83,25,238,0
안락→연산교차로,2023.7.12 00:00,159,0,59,218,0
연산터널→연산교차로,2023.7.12 00:00,129,132,59,320,0
교대→연산교차로,2023.7.12 01:00,90,0,152,242,0
부산시청→연산교차로,2023.7.12 01:00,170,114,68,352,0
사직운동장→연산교차로,2023.7.12 01:00,71,133,22,226,0
신리→연산교차로,2023.7.12 01:00,95,54,10,159,0
안락→연산교차로,2023.7.12 01:00,122,0,44,166,0
연산터널→연산교차로,2023.7.12 01:00,90,119,57,266,0
교대→연산교차로,2023.7.12 02:00,64,0,99,163,0
부산시청→연산교차로,2023.7.12 02:00,143,83,57,283,0
사직운동장→연산교차로,2023.7.12 02:00,48,136,25,209,0
신리→연산교차로,2023.7.12 02:00,79,41,7,127,0
안락→연산교차로,2023.7.12 02:00,128,0,36,164,0
연산터널→연산교차로,2023.7.12 02:00,91,104,33,228,0
교대→연산교차로,2023.7.12 03:00,62,0,85,147,0
부산시청→연산교차로,2023.7.12 03:00,140,67,41,248,0
사직운동장→연산교차로,2023.7.12 03:00,46,122,7,175,0
신리→연산교차로,2023.7.12 03:00,54,46,7,107,0
안락→연산교차로,2023.7.12 03:00,110,0,32,142,0
연산터널→연산교차로,2023.7.12 03:00,62,85,24,171,0
교대→연산교차로,2023.7.12 04:00,46,0,65,111,0
부산시청→연산교차로,2023.7.12 04:00,122,64,36,222,0
사직운동장→연산교차로,2023.7.12 04:00,37,94,6,137,0
신리→연산교차로,2023.7.12 04:00,75,46,3,124,0
안락→연산교차로,2023.7.12 04:00,160,0,28,188,0
연산터널→연산교차로,2023.7.12 04:00,67,78,15,160,0
교대→연산교차로,2023.7.12 05:00,76,0,93,169,0
부산시청→연산교차로,2023.7.12 05:00,165,116,52,333,0
사직운동장→연산교차로,2023.7.12 05:00,52,146,11,209,0
신리→연산교차로,2023.7.12 05:00,136,83,5,224,0
안락→연산교차로,2023.7.12 05:00,249,0,44,293,0
연산터널→연산교차로,2023.7.12 05:00,122,124,17,263,0
교대→연산교차로,2023.7.12 06:00,168,0,220,388,0
부산시청→연산교차로,2023.7.12 06:00,327,225,94,646,0
사직운동장→연산교차로,2023.7.12 06:00,116,273,35,424,0
신리→연산교차로,2023.7.12 06:00,314,174,17,505,0
안락→연산교차로,2023.7.12 06:00,483,0,84,567,0
연산터널→연산교차로,2023.7.12 06:00,227,216,30,473,0
교대→연산교차로,2023.7.12 07:00,254,0,370,624,0
부산시청→연산교차로,2023.7.12 07:00,537,359,178,1074,0
사직운동장→연산교차로,2023.7.12 07:00,183,446,45,674,0
신리→연산교차로,2023.7.12 07:00,453,285,18,756,0
안락→연산교차로,2023.7.12 07:00,587,0,103,690,0
연산터널→연산교차로,2023.7.12 07:00,285,328,39,652,0
교대→연산교차로,2023.7.12 08:00,297,0,457,754,0
부산시청→연산교차로,2023.7.12 08:00,545,428,285,1258,0
사직운동장→연산교차로,2023.7.12 08:00,277,657,51,985,0
신리→연산교차로,2023.7.12 08:00,517,328,13,858,0
안락→연산교차로,2023.7.12 08:00,553,0,138,691,0
연산터널→연산교차로,2023.7.12 08:00,327,343,35,705,0
교대→연산교차로,2023.7.12 09:00,302,0,516,818,0
부산시청→연산교차로,2023.7.12 09:00,493,392,270,1155,0
사직운동장→연산교차로,2023.7.12 09:00,276,574,103,953,0
신리→연산교차로,2023.7.12 09:00,437,334,27,798,0
안락→연산교차로,2023.7.12 09:00,542,0,132,674,0
연산터널→연산교차로,2023.7.12 09:00,289,358,40,687,0
교대→연산교차로,2023.7.12 10:00,301,0,476,777,0
부산시청→연산교차로,2023.7.12 10:00,526,368,274,1168,0
사직운동장→연산교차로,2023.7.12 10:00,325,547,82,954,0
신리→연산교차로,2023.7.12 10:00,441,283,54,778,0
안락→연산교차로,2023.7.12 10:00,557,0,141,698,0
연산터널→연산교차로,2023.7.12 10:00,285,353,45,683,0
교대→연산교차로,2023.7.12 11:00,280,0,482,762,0
부산시청→연산교차로,2023.7.12 11:00,525,364,249,1138,0
사직운동장→연산교차로,2023.7.12 11:00,283,566,72,921,0
신리→연산교차로,2023.7.12 11:00,433,287,67,787,0
안락→연산교차로,2023.7.12 11:00,502,0,186,688,0
연산터널→연산교차로,2023.7.12 11:00,279,289,52,620,0
교대→연산교차로,2023.7.12 12:00,294,0,417,711,0
부산시청→연산교차로,2023.7.12 12:00,509,372,256,1137,0
사직운동장→연산교차로,2023.7.12 12:00,321,565,65,951,0
신리→연산교차로,2023.7.12 12:00,413,227,56,696,0
안락→연산교차로,2023.7.12 12:00,461,0,161,622,0
연산터널→연산교차로,2023.7.12 12:00,272,263,50,585,0
교대→연산교차로,2023.7.12 13:00,317,0,432,749,0
부산시청→연산교차로,2023.7.12 13:00,548,466,270,1284,0
사직운동장→연산교차로,2023.7.12 13:00,294,551,93,938,0
신리→연산교차로,2023.7.12 13:00,406,272,46,724,0
안락→연산교차로,2023.7.12 13:00,436,0,120,556,0
연산터널→연산교차로,2023.7.12 13:00,232,257,43,532,0
교대→연산교차로,2023.7.12 14:00,331,0,511,842,0
부산시청→연산교차로,2023.7.12 14:00,577,461,324,1362,0
사직운동장→연산교차로,2023.7.12 14:00,280,641,105,1026,0
신리→연산교차로,2023.7.12 14:00,477,273,60,810,0
안락→연산교차로,2023.7.12 14:00,426,0,131,557,0
연산터널→연산교차로,2023.7.12 14:00,254,250,46,550,0
교대→연산교차로,2023.7.12 15:00,354,0,483,837,0
부산시청→연산교차로,2023.7.12 15:00,583,499,283,1365,0
사직운동장→연산교차로,2023.7.12 15:00,307,642,81,1030,0
신리→연산교차로,2023.7.12 15:00,451,266,71,788,0
안락→연산교차로,2023.7.12 15:00,450,0,97,547,0
연산터널→연산교차로,2023.7.12 15:00,205,289,44,538,0
교대→연산교차로,2023.7.12 16:00,359,0,489,848,0
부산시청→연산교차로,2023.7.12 16:00,601,516,342,1459,0
사직운동장→연산교차로,2023.7.12 16:00,340,650,72,1062,0
신리→연산교차로,2023.7.12 16:00,535,283,54,872,0
안락→연산교차로,2023.7.12 16:00,439,0,121,560,0
연산터널→연산교차로,2023.7.12 16:00,233,285,55,573,0
교대→연산교차로,2023.7.12 17:00,389,0,565,954,0
부산시청→연산교차로,2023.7.12 17:00,598,555,358,1511,0
사직운동장→연산교차로,2023.7.12 17:00,299,693,54,1046,0
신리→연산교차로,2023.7.12 17:00,525,306,45,876,0
안락→연산교차로,2023.7.12 17:00,450,0,108,558,0
연산터널→연산교차로,2023.7.12 17:00,235,284,44,563,0
교대→연산교차로,2023.7.12 18:00,375,0,556,931,0
부산시청→연산교차로,2023.7.12 18:00,619,571,323,1513,0
사직운동장→연산교차로,2023.7.12 18:00,327,686,55,1068,0
신리→연산교차로,2023.7.12 18:00,554,260,35,849,0
안락→연산교차로,2023.7.12 18:00,462,0,116,578,0
연산터널→연산교차로,2023.7.12 18:00,226,281,39,546,0
교대→연산교차로,2023.7.12 19:00,345,0,390,735,0
부산시청→연산교차로,2023.7.12 19:00,521,359,251,1131,0
사직운동장→연산교차로,2023.7.12 19:00,213,539,60,812,0
신리→연산교차로,2023.7.12 19:00,351,248,50,649,0
안락→연산교차로,2023.7.12 19:00,412,0,128,540,0
연산터널→연산교차로,2023.7.12 19:00,218,263,57,538,0
교대→연산교차로,2023.7.12 20:00,331,0,335,666,0
부산시청→연산교차로,2023.7.12 20:00,513,361,220,1094,0
사직운동장→연산교차로,2023.7.12 20:00,181,467,82,730,0
신리→연산교차로,2023.7.12 20:00,313,182,26,521,0
안락→연산교차로,2023.7.12 20:00,381,0,117,498,0
연산터널→연산교차로,2023.7.12 20:00,208,284,56,548,0
교대→연산교차로,2023.7.12 21:00,283,0,259,542,0
부산시청→연산교차로,2023.7.12 21:00,510,301,248,1059,0
사직운동장→연산교차로,2023.7.12 21:00,180,442,89,711,0
신리→연산교차로,2023.7.12 21:00,287,169,28,484,0
안락→연산교차로,2023.7.12 21:00,388,0,105,493,0
연산터널→연산교차로,2023.7.12 21:00,235,289,57,581,0
교대→연산교차로,2023.7.12 22:00,257,0,238,495,0
부산시청→연산교차로,2023.7.12 22:00,393,265,155,813,0
사직운동장→연산교차로,2023.7.12 22:00,144,346,68,558,0
신리→연산교차로,2023.7.12 22:00,239,147,25,411,0
안락→연산교차로,2023.7.12 22:00,333,0,118,451,0
연산터널→연산교차로,2023.7.12 22:00,212,247,42,501,0
교대→연산교차로,2023.7.12 23:00,186,0,229,415,0
부산시청→연산교차로,2023.7.12 23:00,307,190,142,639,0
사직운동장→연산교차로,2023.7.12 23:00,145,303,69,517,0
신리→연산교차로,2023.7.12 23:00,225,145,27,397,0
안락→연산교차로,2023.7.12 23:00,274,0,80,354,0
연산터널→연산교차로,2023.7.12 23:00,161,188,58,407,0
교대→연산교차로,2023.7.13 00:00,147,0,176,323,0
부산시청→연산교차로,2023.7.13 00:00,252,154,111,517,0
사직운동장→연산교차로,2023.7.13 00:00,91,251,51,393,0
신리→연산교차로,2023.7.13 00:00,153,93,18,264,0
안락→연산교차로,2023.7.13 00:00,213,0,60,273,0
연산터널→연산교차로,2023.7.13 00:00,157,206,66,429,0
교대→연산교차로,2023.7.13 01:00,112,0,170,282,0
부산시청→연산교차로,2023.7.13 01:00,189,125,94,408,0
사직운동장→연산교차로,2023.7.13 01:00,73,202,41,316,0
신리→연산교차로,2023.7.13 01:00,107,72,27,206,0
안락→연산교차로,2023.7.13 01:00,170,0,56,226,0
연산터널→연산교차로,2023.7.13 01:00,109,173,51,333,0
교대→연산교차로,2023.7.13 02:00,89,0,149,238,0
부산시청→연산교차로,2023.7.13 02:00,176,103,64,343,0
사직운동장→연산교차로,2023.7.13 02:00,49,150,37,236,0
신리→연산교차로,2023.7.13 02:00,101,54,9,164,0
안락→연산교차로,2023.7.13 02:00,120,0,40,160,0
연산터널→연산교차로,2023.7.13 02:00,104,120,30,254,0
교대→연산교차로,2023.7.13 03:00,61,0,94,155,0
부산시청→연산교차로,2023.7.13 03:00,155,91,53,299,0
사직운동장→연산교차로,2023.7.13 03:00,45,123,20,188,0
신리→연산교차로,2023.7.13 03:00,65,45,9,119,0
안락→연산교차로,2023.7.13 03:00,103,0,29,132,0
연산터널→연산교차로,2023.7.13 03:00,75,115,45,235,0
교대→연산교차로,2023.7.13 04:00,45,0,108,153,0
부산시청→연산교차로,2023.7.13 04:00,164,68,50,282,0
사직운동장→연산교차로,2023.7.13 04:00,51,105,17,173,0
신리→연산교차로,2023.7.13 04:00,90,53,12,155,0
안락→연산교차로,2023.7.13 04:00,161,0,39,200,0
연산터널→연산교차로,2023.7.13 04:00,99,103,37,239,0
교대→연산교차로,2023.7.13 05:00,91,0,127,218,0
부산시청→연산교차로,2023.7.13 05:00,229,128,73,430,0
사직운동장→연산교차로,2023.7.13 05:00,55,174,45,274,0
신리→연산교차로,2023.7.13 05:00,182,82,10,274,0
안락→연산교차로,2023.7.13 05:00,322,0,53,375,0
연산터널→연산교차로,2023.7.13 05:00,135,137,35,307,0
교대→연산교차로,2023.7.13 06:00,170,0,221,391,0
부산시청→연산교차로,2023.7.13 06:00,328,224,111,663,0
사직운동장→연산교차로,2023.7.13 06:00,125,296,45,466,0
신리→연산교차로,2023.7.13 06:00,339,188,22,549,0
안락→연산교차로,2023.7.13 06:00,486,0,81,567,0
연산터널→연산교차로,2023.7.13 06:00,237,241,33,511,0
교대→연산교차로,2023.7.13 07:00,269,0,381,650,0
부산시청→연산교차로,2023.7.13 07:00,523,337,221,1081,0
사직운동장→연산교차로,2023.7.13 07:00,231,490,62,783,0
신리→연산교차로,2023.7.13 07:00,438,279,28,745,0
안락→연산교차로,2023.7.13 07:00,627,0,87,714,0
연산터널→연산교차로,2023.7.13 07:00,289,373,39,701,0
교대→연산교차로,2023.7.13 08:00,299,0,468,767,0
부산시청→연산교차로,2023.7.13 08:00,563,415,289,1267,0
사직운동장→연산교차로,2023.7.13 08:00,260,624,50,934,0
신리→연산교차로,2023.7.13 08:00,482,341,27,850,0
안락→연산교차로,2023.7.13 08:00,581,0,118,699,0
연산터널→연산교차로,2023.7.13 08:00,313,356,35,704,0
교대→연산교차로,2023.7.13 09:00,281,0,508,789,0
부산시청→연산교차로,2023.7.13 09:00,515,370,305,1190,0
사직운동장→연산교차로,2023.7.13 09:00,250,582,93,925,0
신리→연산교차로,2023.7.13 09:00,435,329,40,804,0
안락→연산교차로,2023.7.13 09:00,544,0,112,656,0
연산터널→연산교차로,2023.7.13 09:00,284,348,41,673,0
교대→연산교차로,2023.7.13 10:00,290,0,504,794,0
부산시청→연산교차로,2023.7.13 10:00,522,368,262,1152,0
사직운동장→연산교차로,2023.7.13 10:00,296,539,101,936,0
신리→연산교차로,2023.7.13 10:00,417,284,44,745,0
안락→연산교차로,2023.7.13 10:00,529,0,132,661,0
연산터널→연산교차로,2023.7.13 10:00,309,330,38,677,0
교대→연산교차로,2023.7.13 11:00,299,0,467,766,0
부산시청→연산교차로,2023.7.13 11:00,506,370,271,1147,0
사직운동장→연산교차로,2023.7.13 11:00,328,545,81,954,0
신리→연산교차로,2023.7.13 11:00,435,274,54,763,0
안락→연산교차로,2023.7.13 11:00,492,0,147,639,0
연산터널→연산교차로,2023.7.13 11:00,272,323,54,649,0
교대→연산교차로,2023.7.13 12:00,274,0,367,641,0
부산시청→연산교차로,2023.7.13 12:00,544,358,249,1151,0
사직운동장→연산교차로,2023.7.13 12:00,243,522,86,851,0
신리→연산교차로,2023.7.13 12:00,454,233,49,736,0
안락→연산교차로,2023.7.13 12:00,464,0,154,618,0
연산터널→연산교차로,2023.7.13 12:00,266,282,31,579,0
교대→연산교차로,2023.7.13 13:00,339,0,443,782,0
부산시청→연산교차로,2023.7.13 13:00,566,424,282,1272,0
사직운동장→연산교차로,2023.7.13 13:00,266,587,111,964,0
신리→연산교차로,2023.7.13 13:00,431,280,64,775,0
안락→연산교차로,2023.7.13 13:00,423,0,118,541,0
연산터널→연산교차로,2023.7.13 13:00,253,274,33,560,0
교대→연산교차로,2023.7.13 14:00,339,0,505,844,0
부산시청→연산교차로,2023.7.13 14:00,524,435,281,1240,0
사직운동장→연산교차로,2023.7.13 14:00,338,608,91,1037,0
신리→연산교차로,2023.7.13 14:00,446,294,44,784,0
안락→연산교차로,2023.7.13 14:00,424,0,128,552,0
연산터널→연산교차로,2023.7.13 14:00,223,284,50,557,0
교대→연산교차로,2023.7.13 15:00,362,0,520,882,0
부산시청→연산교차로,2023.7.13 15:00,544,475,318,1337,0
사직운동장→연산교차로,2023.7.13 15:00,334,639,99,1072,0
신리→연산교차로,2023.7.13 15:00,450,282,67,799,0
안락→연산교차로,2023.7.13 15:00,443,0,127,570,0
연산터널→연산교차로,2023.7.13 15:00,247,280,51,578,0
교대→연산교차로,2023.7.13 16:00,366,0,503,869,0
부산시청→연산교차로,2023.7.13 16:00,616,517,263,1396,0
사직운동장→연산교차로,2023.7.13 16:00,328,660,65,1053,0
신리→연산교차로,2023.7.13 16:00,466,292,52,810,0
안락→연산교차로,2023.7.13 16:00,439,0,126,565,0
연산터널→연산교차로,2023.7.13 16:00,259,275,28,562,0
교대→연산교차로,2023.7.13 17:00,387,0,566,953,0
부산시청→연산교차로,2023.7.13 17:00,616,552,322,1490,0
사직운동장→연산교차로,2023.7.13 17:00,316,714,60,1090,0
신리→연산교차로,2023.7.13 17:00,502,256,51,809,0
안락→연산교차로,2023.7.13 17:00,456,0,102,558,0
연산터널→연산교차로,2023.7.13 17:00,247,274,44,565,0
교대→연산교차로,2023.7.13 18:00,377,0,532,909,0
부산시청→연산교차로,2023.7.13 18:00,601,564,363,1528,0
사직운동장→연산교차로,2023.7.13 18:00,313,656,74,1043,0
신리→연산교차로,2023.7.13 18:00,513,282,41,836,0
안락→연산교차로,2023.7.13 18:00,452,0,97,549,0
연산터널→연산교차로,2023.7.13 18:00,241,279,57,577,0
교대→연산교차로,2023.7.13 19:00,310,0,388,698,0
부산시청→연산교차로,2023.7.13 19:00,491,406,260,1157,0
사직운동장→연산교차로,2023.7.13 19:00,195,559,72,826,0
신리→연산교차로,2023.7.13 19:00,373,221,52,646,0
안락→연산교차로,2023.7.13 19:00,412,0,113,525,0
연산터널→연산교차로,2023.7.13 19:00,224,253,42,519,0
교대→연산교차로,2023.7.13 20:00,308,0,334,642,0
부산시청→연산교차로,2023.7.13 20:00,479,320,215,1014,0
사직운동장→연산교차로,2023.7.13 20:00,180,477,76,733,0
신리→연산교차로,2023.7.13 20:00,338,176,29,543,0
안락→연산교차로,2023.7.13 20:00,421,0,102,523,0
연산터널→연산교차로,2023.7.13 20:00,212,241,55,508,0
교대→연산교차로,2023.7.13 21:00,284,0,291,575,0
부산시청→연산교차로,2023.7.13 21:00,497,325,250,1072,0
사직운동장→연산교차로,2023.7.13 21:00,182,444,71,697,0
신리→연산교차로,2023.7.13 21:00,273,187,34,494,0
안락→연산교차로,2023.7.13 21:00,402,0,117,519,0
연산터널→연산교차로,2023.7.13 21:00,216,268,51,535,0
교대→연산교차로,2023.7.13 22:00,221,0,243,464,0
부산시청→연산교차로,2023.7.13 22:00,389,273,163,825,0
사직운동장→연산교차로,2023.7.13 22:00,124,362,96,582,0
신리→연산교차로,2023.7.13 22:00,270,144,23,437,0
안락→연산교차로,2023.7.13 22:00,360,0,99,459,0
연산터널→연산교차로,2023.7.13 22:00,200,241,47,488,0
교대→연산교차로,2023.7.13 23:00,194,0,228,422,0
부산시청→연산교차로,2023.7.13 23:00,366,220,150,736,0
사직운동장→연산교차로,2023.7.13 23:00,128,300,67,495,0
신리→연산교차로,2023.7.13 23:00,204,120,26,350,0
안락→연산교차로,2023.7.13 23:00,301,0,85,386,0
연산터널→연산교차로,2023.7.13 23:00,148,181,50,379,0
교대→연산교차로,2023.7.14 00:00,159,0,208,367,0
부산시청→연산교차로,2023.7.14 00:00,261,153,106,520,0
사직운동장→연산교차로,2023.7.14 00:00,99,210,44,353,0
신리→연산교차로,2023.7.14 00:00,156,93,34,283,0
안락→연산교차로,2023.7.14 00:00,212,0,55,267,0
연산터널→연산교차로,2023.7.14 00:00,133,186,46,365,0
교대→연산교차로,2023.7.14 01:00,110,0,151,261,0
부산시청→연산교차로,2023.7.14 01:00,220,120,73,413,0
사직운동장→연산교차로,2023.7.14 01:00,77,168,31,276,0
신리→연산교차로,2023.7.14 01:00,102,69,10,181,0
안락→연산교차로,2023.7.14 01:00,178,0,31,209,0
연산터널→연산교차로,2023.7.14 01:00,103,128,38,269,0
교대→연산교차로,2023.7.14 02:00,71,0,103,174,0
부산시청→연산교차로,2023.7.14 02:00,157,86,58,301,0
사직운동장→연산교차로,2023.7.14 02:00,64,163,10,237,0
신리→연산교차로,2023.7.14 02:00,93,51,7,151,0
안락→연산교차로,2023.7.14 02:00,138,0,39,177,0
연산터널→연산교차로,2023.7.14 02:00,89,123,13,225,0
교대→연산교차로,2023.7.14 03:00,76,0,103,179,0
부산시청→연산교차로,2023.7.14 03:00,137,87,43,267,0
사직운동장→연산교차로,2023.7.14 03:00,41,134,10,185,0
신리→연산교차로,2023.7.14 03:00,58,39,10,107,0
안락→연산교차로,2023.7.14 03:00,116,0,30,146,0
연산터널→연산교차로,2023.7.14 03:00,77,91,21,189,0
교대→연산교차로,2023.7.14 04:00,58,0,76,134,0
부산시청→연산교차로,2023.7.14 04:00,152,77,30,259,0
사직운동장→연산교차로,2023.7.14 04:00,44,120,7,171,0
신리→연산교차로,2023.7.14 04:00,72,38,8,118,0
안락→연산교차로,2023.7.14 04:00,150,0,36,186,0
연산터널→연산교차로,2023.7.14 04:00,89,77,11,177,0
교대→연산교차로,2023.7.14 05:00,73,0,111,184,0
부산시청→연산교차로,2023.7.14 05:00,169,117,74,360,0
사직운동장→연산교차로,2023.7.14 05:00,72,175,14,261,0
신리→연산교차로,2023.7.14 05:00,145,79,5,229,0
안락→연산교차로,2023.7.14 05:00,251,0,60,311,0
연산터널→연산교차로,2023.7.14 05:00,120,128,16,264,0
교대→연산교차로,2023.7.14 06:00,154,0,212,366,0
부산시청→연산교차로,2023.7.14 06:00,344,231,104,679,0
사직운동장→연산교차로,2023.7.14 06:00,101,253,38,392,0
신리→연산교차로,2023.7.14 06:00,295,165,27,487,0
안락→연산교차로,2023.7.14 06:00,458,0,90,548,0
연산터널→연산교차로,2023.7.14 06:00,208,228,38,474,0
교대→연산교차로,2023.7.14 07:00,250,0,367,617,0
부산시청→연산교차로,2023.7.14 07:00,516,362,184,1062,0
사직운동장→연산교차로,2023.7.14 07:00,180,483,58,721,0
신리→연산교차로,2023.7.14 07:00,453,275,26,754,0
안락→연산교차로,2023.7.14 07:00,601,0,86,687,0
연산터널→연산교차로,2023.7.14 07:00,291,334,52,677,0
교대→연산교차로,2023.7.14 08:00,302,0,454,756,0
부산시청→연산교차로,2023.7.14 08:00,543,409,347,1299,0
사직운동장→연산교차로,2023.7.14 08:00,265,643,42,950,0
신리→연산교차로,2023.7.14 08:00,506,341,19,866,0
안락→연산교차로,2023.7.14 08:00,576,0,118,694,0
연산터널→연산교차로,2023.7.14 08:00,300,371,43,714,0
교대→연산교차로,2023.7.14 09:00,285,0,503,788,0
부산시청→연산교차로,2023.7.14 09:00,517,381,287,1185,0
사직운동장→연산교차로,2023.7.14 09:00,235,603,75,913,0
신리→연산교차로,2023.7.14 09:00,389,335,49,773,0
안락→연산교차로,2023.7.14 09:00,552,0,108,660,0
연산터널→연산교차로,2023.7.14 09:00,309,387,35,731,0
교대→연산교차로,2023.7.14 10:00,283,0,511,794,0
부산시청→연산교차로,2023.7.14 10:00,523,365,267,1155,0
사직운동장→연산교차로,2023.7.14 10:00,295,559,77,931,0
신리→연산교차로,2023.7.14 10:00,458,289,46,793,0
안락→연산교차로,2023.7.14 10:00,548,0,129,677,0
연산터널→연산교차로,2023.7.14 10:00,295,342,56,693,0
교대→연산교차로,2023.7.14 11:00,293,0,460,753,0
부산시청→연산교차로,2023.7.14 11:00,571,374,254,1199,0
사직운동장→연산교차로,2023.7.14 11:00,313,585,76,974,0
신리→연산교차로,2023.7.14 11:00,422,260,64,746,0
안락→연산교차로,2023.7.14 11:00,506,0,159,665,0
연산터널→연산교차로,2023.7.14 11:00,258,331,41,630,0
교대→연산교차로,2023.7.14 12:00,289,0,383,672,0
부산시청→연산교차로,2023.7.14 12:00,522,361,220,1103,0
사직운동장→연산교차로,2023.7.14 12:00,291,564,84,939,0
신리→연산교차로,2023.7.14 12:00,394,249,53,696,0
안락→연산교차로,2023.7.14 12:00,467,0,149,616,0
연산터널→연산교차로,2023.7.14 12:00,283,295,50,628,0
교대→연산교차로,2023.7.14 13:00,320,0,439,759,0
부산시청→연산교차로,2023.7.14 13:00,543,435,279,1257,0
사직운동장→연산교차로,2023.7.14 13:00,285,596,88,969,0
신리→연산교차로,2023.7.14 13:00,432,281,52,765,0
안락→연산교차로,2023.7.14 13:00,414,0,144,558,0
연산터널→연산교차로,2023.7.14 13:00,236,269,34,539,0
교대→연산교차로,2023.7.14 14:00,336,0,484,820,0
부산시청→연산교차로,2023.7.14 14:00,575,475,270,1320,0
사직운동장→연산교차로,2023.7.14 14:00,368,626,68,1062,0
신리→연산교차로,2023.7.14 14:00,453,293,68,814,0
안락→연산교차로,2023.7.14 14:00,405,0,128,533,0
연산터널→연산교차로,2023.7.14 14:00,239,255,39,533,0
교대→연산교차로,2023.7.14 15:00,338,0,541,879,0
부산시청→연산교차로,2023.7.14 15:00,561,499,293,1353,0
사직운동장→연산교차로,2023.7.14 15:00,336,620,88,1044,0
신리→연산교차로,2023.7.14 15:00,455,275,54,784,0
안락→연산교차로,2023.7.14 15:00,438,0,113,551,0
연산터널→연산교차로,2023.7.14 15:00,245,269,40,554,0
교대→연산교차로,2023.7.14 16:00,347,0,535,882,0
부산시청→연산교차로,2023.7.14 16:00,598,526,307,1431,0
사직운동장→연산교차로,2023.7.14 16:00,372,648,35,1055,0
신리→연산교차로,2023.7.14 16:00,482,284,61,827,0
안락→연산교차로,2023.7.14 16:00,414,0,119,533,0
연산터널→연산교차로,2023.7.14 16:00,240,268,37,545,0
교대→연산교차로,2023.7.14 17:00,359,0,535,894,0
부산시청→연산교차로,2023.7.14 17:00,652,543,285,1480,0
사직운동장→연산교차로,2023.7.14 17:00,382,681,47,1110,0
신리→연산교차로,2023.7.14 17:00,537,299,63,899,0
안락→연산교차로,2023.7.14 17:00,446,0,120,566,0
연산터널→연산교차로,2023.7.14 17:00,247,274,46,567,0
교대→연산교차로,2023.7.14 18:00,352,0,562,914,0
부산시청→연산교차로,2023.7.14 18:00,587,578,341,1506,0
사직운동장→연산교차로,2023.7.14 18:00,338,650,54,1042,0
신리→연산교차로,2023.7.14 18:00,510,307,43,860,0
안락→연산교차로,2023.7.14 18:00,439,0,126,565,0
연산터널→연산교차로,2023.7.14 18:00,220,297,45,562,0
교대→연산교차로,2023.7.14 19:00,319,0,415,734,0
부산시청→연산교차로,2023.7.14 19:00,530,419,282,1231,0
사직운동장→연산교차로,2023.7.14 19:00,214,579,57,850,0
신리→연산교차로,2023.7.14 19:00,370,240,29,639,0
안락→연산교차로,2023.7.14 19:00,410,0,111,521,0
연산터널→연산교차로,2023.7.14 19:00,206,248,52,506,0
교대→연산교차로,2023.7.14 20:00,306,0,378,684,0
부산시청→연산교차로,2023.7.14 20:00,488,410,215,1113,0
사직운동장→연산교차로,2023.7.14 20:00,208,504,47,759,0
신리→연산교차로,2023.7.14 20:00,353,180,32,565,0
안락→연산교차로,2023.7.14 20:00,413,0,102,515,0
연산터널→연산교차로,2023.7.14 20:00,235,270,32,537,0
교대→연산교차로,2023.7.14 21:00,289,0,333,622,0
부산시청→연산교차로,2023.7.14 21:00,511,322,198,1031,0
사직운동장→연산교차로,2023.7.14 21:00,177,458,46,681,0
신리→연산교차로,2023.7.14 21:00,301,194,24,519,0
안락→연산교차로,2023.7.14 21:00,402,0,108,510,0
연산터널→연산교차로,2023.7.14 21:00,216,254,35,505,0
교대→연산교차로,2023.7.14 22:00,279,0,260,539,0
부산시청→연산교차로,2023.7.14 22:00,432,303,171,906,0
사직운동장→연산교차로,2023.7.14 22:00,204,415,10,629,0
신리→연산교차로,2023.7.14 22:00,231,149,9,389,0
안락→연산교차로,2023.7.14 22:00,363,0,95,458,0
연산터널→연산교차로,2023.7.14 22:00,203,223,32,458,0
교대→연산교차로,2023.7.14 23:00,189,0,208,397,0
부산시청→연산교차로,2023.7.14 23:00,362,231,159,752,0
사직운동장→연산교차로,2023.7.14 23:00,138,306,38,482,0
신리→연산교차로,2023.7.14 23:00,232,157,24,413,0
안락→연산교차로,2023.7.14 23:00,295,0,101,396,0
연산터널→연산교차로,2023.7.14 23:00,151,233,55,439,0
교대→연산교차로,2023.7.15 00:00,165,0,235,400,0
부산시청→연산교차로,2023.7.15 00:00,275,177,128,580,0
사직운동장→연산교차로,2023.7.15 00:00,126,295,45,466,0
신리→연산교차로,2023.7.15 00:00,216,133,21,370,0
안락→연산교차로,2023.7.15 00:00,263,0,83,346,0
연산터널→연산교차로,2023.7.15 00:00,144,190,49,383,0
교대→연산교차로,2023.7.15 01:00,152,0,228,380,0
부산시청→연산교차로,2023.7.15 01:00,240,160,84,484,0
사직운동장→연산교차로,2023.7.15 01:00,75,206,36,317,0
신리→연산교차로,2023.7.15 01:00,148,88,9,245,0
안락→연산교차로,2023.7.15 01:00,206,0,77,283,0
연산터널→연산교차로,2023.7.15 01:00,137,143,41,321,0
교대→연산교차로,2023.7.15 02:00,132,0,173,305,0
부산시청→연산교차로,2023.7.15 02:00,212,124,71,407,0
사직운동장→연산교차로,2023.7.15 02:00,85,159,21,265,0
신리→연산교차로,2023.7.15 02:00,123,79,11,213,0
안락→연산교차로,2023.7.15 02:00,176,0,49,225,0
연산터널→연산교차로,2023.7.15 02:00,122,140,18,280,0
교대→연산교차로,2023.7.15 03:00,87,0,168,255,0
부산시청→연산교차로,2023.7.15 03:00,198,102,59,359,0
사직운동장→연산교차로,2023.7.15 03:00,56,161,40,257,0
신리→연산교차로,2023.7.15 03:00,97,62,13,172,0
안락→연산교차로,2023.7.15 03:00,145,0,46,191,0
연산터널→연산교차로,2023.7.15 03:00,105,127,30,262,0
교대→연산교차로,2023.7.15 04:00,63,0,124,187,0
부산시청→연산교차로,2023.7.15 04:00,175,87,72,334,0
사직운동장→연산교차로,2023.7.15 04:00,54,118,18,190,0
신리→연산교차로,2023.7.15 04:00,86,52,8,146,0
안락→연산교차로,2023.7.15 04:00,160,0,47,207,0
연산터널→연산교차로,2023.7.15 04:00,84,122,30,236,0
교대→연산교차로,2023.7.15 05:00,94,0,122,216,0
부산시청→연산교차로,2023.7.15 05:00,206,140,73,419,0
사직운동장→연산교차로,2023.7.15 05:00,62,151,37,250,0
신리→연산교차로,2023.7.15 05:00,166,94,15,275,0
안락→연산교차로,2023.7.15 05:00,255,0,54,309,0
연산터널→연산교차로,2023.7.15 05:00,100,144,29,273,0
교대→연산교차로,2023.7.15 06:00,156,0,187,343,0
부산시청→연산교차로,2023.7.15 06:00,276,205,80,561,0
사직운동장→연산교차로,2023.7.15 06:00,80,221,44,345,0
신리→연산교차로,2023.7.15 06:00,248,135,18,401,0
안락→연산교차로,2023.7.15 06:00,378,0,93,471,0
연산터널→연산교차로,2023.7.15 06:00,149,149,39,337,0
교대→연산교차로,2023.7.15 07:00,158,0,187,345,0
부산시청→연산교차로,2023.7.15 07:00,374,226,122,722,0
사직운동장→연산교차로,2023.7.15 07:00,146,281,52,479,0
신리→연산교차로,2023.7.15 07:00,264,165,25,454,0
안락→연산교차로,2023.7.15 07:00,436,0,80,516,0
연산터널→연산교차로,2023.7.15 07:00,168,177,40,385,0
교대→연산교차로,2023.7.15 08:00,260,0,332,592,0
부산시청→연산교차로,2023.7.15 08:00,443,274,198,915,0
사직운동장→연산교차로,2023.7.15 08:00,226,515,76,817,0
신리→연산교차로,2023.7.15 08:00,408,231,48,687,0
안락→연산교차로,2023.7.15 08:00,466,0,110,576,0
연산터널→연산교차로,2023.7.15 08:00,235,286,65,586,0
교대→연산교차로,2023.7.15 09:00,275,0,350,625,0
부산시청→연산교차로,2023.7.15 09:00,502,357,253,1112,0
사직운동장→연산교차로,2023.7.15 09:00,255,566,73,894,0
신리→연산교차로,2023.7.15 09:00,466,278,70,814,0
안락→연산교차로,2023.7.15 09:00,573,0,145,718,0
연산터널→연산교차로,2023.7.15 09:00,285,333,57,675,0
교대→연산교차로,2023.7.15 10:00,295,0,416,711,0
부산시청→연산교차로,2023.7.15 10:00,587,375,305,1267,0
사직운동장→연산교차로,2023.7.15 10:00,321,641,60,1022,0
신리→연산교차로,2023.7.15 10:00,523,296,71,890,0
안락→연산교차로,2023.7.15 10:00,544,0,209,753,0
연산터널→연산교차로,2023.7.15 10:00,286,338,76,700,0
교대→연산교차로,2023.7.15 11:00,313,0,468,781,0
부산시청→연산교차로,2023.7.15 11:00,597,379,332,1308,0
사직운동장→연산교차로,2023.7.15 11:00,290,630,57,977,0
신리→연산교차로,2023.7.15 11:00,510,307,88,905,0
안락→연산교차로,2023.7.15 11:00,555,0,194,749,0
연산터널→연산교차로,2023.7.15 11:00,313,337,51,701,0
교대→연산교차로,2023.7.15 12:00,319,0,488,807,0
부산시청→연산교차로,2023.7.15 12:00,596,388,276,1260,0
사직운동장→연산교차로,2023.7.15 12:00,339,631,51,1021,0
신리→연산교차로,2023.7.15 12:00,509,325,65,899,0
안락→연산교차로,2023.7.15 12:00,550,0,156,706,0
연산터널→연산교차로,2023.7.15 12:00,307,321,61,689,0
교대→연산교차로,2023.7.15 13:00,351,0,465,816,0
부산시청→연산교차로,2023.7.15 13:00,635,480,327,1442,0
사직운동장→연산교차로,2023.7.15 13:00,290,686,61,1037,0
신리→연산교차로,2023.7.15 13:00,461,325,70,856,0
안락→연산교차로,2023.7.15 13:00,449,0,168,617,0
연산터널→연산교차로,2023.7.15 13:00,263,285,41,589,0
교대→연산교차로,2023.7.15 14:00,359,0,498,857,0
부산시청→연산교차로,2023.7.15 14:00,609,502,339,1450,0
사직운동장→연산교차로,2023.7.15 14:00,314,666,63,1043,0
신리→연산교차로,2023.7.15 14:00,433,292,63,788,0
안락→연산교차로,2023.7.15 14:00,470,0,126,596,0
연산터널→연산교차로,2023.7.15 14:00,246,275,54,575,0
교대→연산교차로,2023.7.15 15:00,344,0,445,789,0
부산시청→연산교차로,2023.7.15 15:00,620,509,324,1453,0
사직운동장→연산교차로,2023.7.15 15:00,306,695,41,1042,0
신리→연산교차로,2023.7.15 15:00,469,318,68,855,0
안락→연산교차로,2023.7.15 15:00,434,0,111,545,0
연산터널→연산교차로,2023.7.15 15:00,243,260,39,542,0
교대→연산교차로,2023.7.15 16:00,337,0,445,782,0
부산시청→연산교차로,2023.7.15 16:00,677,487,271,1435,0
사직운동장→연산교차로,2023.7.15 16:00,258,648,57,963,0
신리→연산교차로,2023.7.15 16:00,441,321,66,828,0
안락→연산교차로,2023.7.15 16:00,460,0,99,559,0
연산터널→연산교차로,2023.7.15 16:00,244,278,47,569,0
교대→연산교차로,2023.7.15 17:00,374,0,461,835,0
부산시청→연산교차로,2023.7.15 17:00,640,481,310,1431,0
사직운동장→연산교차로,2023.7.15 17:00,320,678,55,1053,0
신리→연산교차로,2023.7.15 17:00,450,316,47,813,0
안락→연산교차로,2023.7.15 17:00,464,0,125,589,0
연산터널→연산교차로,2023.7.15 17:00,245,267,44,556,0
교대→연산교차로,2023.7.15 18:00,325,0,423,748,0
부산시청→연산교차로,2023.7.15 18:00,594,441,250,1285,0
사직운동장→연산교차로,2023.7.15 18:00,252,627,79,958,0
신리→연산교차로,2023.7.15 18:00,414,253,33,700,0
안락→연산교차로,2023.7.15 18:00,445,0,113,558,0
연산터널→연산교차로,2023.7.15 18:00,210,296,55,561,0
교대→연산교차로,2023.7.15 19:00,315,0,333,648,0
부산시청→연산교차로,2023.7.15 19:00,509,380,225,1114,0
사직운동장→연산교차로,2023.7.15 19:00,178,514,83,775,0
신리→연산교차로,2023.7.15 19:00,373,188,39,600,0
안락→연산교차로,2023.7.15 19:00,405,0,150,555,0
연산터널→연산교차로,2023.7.15 19:00,194,270,69,533,0
교대→연산교차로,2023.7.15 20:00,297,0,315,612,0
부산시청→연산교차로,2023.7.15 20:00,461,321,180,962,0
사직운동장→연산교차로,2023.7.15 20:00,212,497,75,784,0
신리→연산교차로,2023.7.15 20:00,331,211,24,566,0
안락→연산교차로,2023.7.15 20:00,410,0,128,538,0
연산터널→연산교차로,2023.7.15 20:00,226,261,40,527,0
교대→연산교차로,2023.7.15 21:00,292,0,292,584,0
부산시청→연산교차로,2023.7.15 21:00,507,351,202,1060,0
사직운동장→연산교차로,2023.7.15 21:00,251,481,50,782,0
신리→연산교차로,2023.7.15 21:00,287,240,25,552,0
안락→연산교차로,2023.7.15 21:00,380,0,109,489,0
연산터널→연산교차로,2023.7.15 21:00,249,239,49,537,0
교대→연산교차로,2023.7.15 22:00,253,0,273,526,0
부산시청→연산교차로,2023.7.15 22:00,404,271,168,843,0
사직운동장→연산교차로,2023.7.15 22:00,193,380,55,628,0
신리→연산교차로,2023.7.15 22:00,264,198,24,486,0
안락→연산교차로,2023.7.15 22:00,409,0,120,529,0
연산터널→연산교차로,2023.7.15 22:00,208,216,63,487,0
교대→연산교차로,2023.7.15 23:00,193,0,193,386,0
부산시청→연산교차로,2023.7.15 23:00,349,256,138,743,0
사직운동장→연산교차로,2023.7.15 23:00,108,315,30,453,0
신리→연산교차로,2023.7.15 23:00,259,133,22,414,0
안락→연산교차로,2023.7.15 23:00,299,0,76,375,0
연산터널→연산교차로,2023.7.15 23:00,186,181,28,395,0
교대→연산교차로,2023.7.16 00:00,166,0,237,403,1
부산시청→연산교차로,2023.7.16 00:00,301,209,111,621,1
사직운동장→연산교차로,2023.7.16 00:00,110,282,30,422,1
신리→연산교차로,2023.7.16 00:00,202,110,14,326,1
안락→연산교차로,2023.7.16 00:00,229,0,77,306,1
연산터널→연산교차로,2023.7.16 00:00,149,187,32,368,1
교대→연산교차로,2023.7.16 01:00,137,0,211,348,1
부산시청→연산교차로,2023.7.16 01:00,246,165,94,505,1
사직운동장→연산교차로,2023.7.16 01:00,81,199,32,312,1
신리→연산교차로,2023.7.16 01:00,174,82,12,268,1
안락→연산교차로,2023.7.16 01:00,207,0,55,262,1
연산터널→연산교차로,2023.7.16 01:00,139,173,37,349,1
교대→연산교차로,2023.7.16 02:00,98,0,154,252,1
부산시청→연산교차로,2023.7.16 02:00,202,147,80,429,1
사직운동장→연산교차로,2023.7.16 02:00,63,155,13,231,1
신리→연산교차로,2023.7.16 02:00,107,79,6,192,1
안락→연산교차로,2023.7.16 02:00,160,0,40,200,1
연산터널→연산교차로,2023.7.16 02:00,118,130,11,259,1
교대→연산교차로,2023.7.16 03:00,94,0,135,229,1
부산시청→연산교차로,2023.7.16 03:00,180,102,49,331,1
사직운동장→연산교차로,2023.7.16 03:00,74,129,6,209,1
신리→연산교차로,2023.7.16 03:00,98,63,3,164,1
안락→연산교차로,2023.7.16 03:00,110,0,43,153,1
연산터널→연산교차로,2023.7.16 03:00,78,122,7,207,1
교대→연산교차로,2023.7.16 04:00,80,0,96,176,1
부산시청→연산교차로,2023.7.16 04:00,136,85,39,260,1
사직운동장→연산교차로,2023.7.16 04:00,43,122,2,167,1
신리→연산교차로,2023.7.16 04:00,98,52,3,153,1
안락→연산교차로,2023.7.16 04:00,113,0,30,143,1
연산터널→연산교차로,2023.7.16 04:00,63,86,7,156,1
교대→연산교차로,2023.7.16 05:00,64,0,83,147,1
부산시청→연산교차로,2023.7.16 05:00,123,83,38,244,1
사직운동장→연산교차로,2023.7.16 05:00,35,97,15,147,1
신리→연산교차로,2023.7.16 05:00,86,56,5,147,1
안락→연산교차로,2023.7.16 05:00,114,0,38,152,1
연산터널→연산교차로,2023.7.16 05:00,76,87,15,178,1
교대→연산교차로,2023.7.16 06:00,88,0,102,190,1
부산시청→연산교차로,2023.7.16 06:00,180,120,45,345,1
사직운동장→연산교차로,2023.7.16 06:00,74,132,26,232,1
신리→연산교차로,2023.7.16 06:00,107,77,7,191,1
안락→연산교차로,2023.7.16 06:00,212,0,39,251,1
연산터널→연산교차로,2023.7.16 06:00,92,96,26,214,1
교대→연산교차로,2023.7.16 07:00,112,0,134,246,1
부산시청→연산교차로,2023.7.16 07:00,199,156,59,414,1
사직운동장→연산교차로,2023.7.16 07:00,73,183,22,278,1
신리→연산교차로,2023.7.16 07:00,178,75,11,264,1
안락→연산교차로,2023.7.16 07:00,230,0,47,277,1
연산터널→연산교차로,2023.7.16 07:00,122,114,21,257,1
교대→연산교차로,2023.7.16 08:00,180,0,139,319,1
부산시청→연산교차로,2023.7.16 08:00,299,213,100,612,1
사직운동장→연산교차로,2023.7.16 08:00,120,283,33,436,1
신리→연산교차로,2023.7.16 08:00,225,142,19,386,1
안락→연산교차로,2023.7.16 08:00,333,0,79,412,1
연산터널→연산교차로,2023.7.16 08:00,160,166,23,349,1
교대→연산교차로,2023.7.16 09:00,207,0,212,419,1
부산시청→연산교차로,2023.7.16 09:00,360,290,142,792,1
사직운동장→연산교차로,2023.7.16 09:00,138,384,34,556,1
신리→연산교차로,2023.7.16 09:00,323,189,25,537,1
안락→연산교차로,2023.7.16 09:00,399,0,87,486,1
연산터널→연산교차로,2023.7.16 09:00,235,218,47,500,1
교대→연산교차로,2023.7.16 10:00,280,0,225,505,1
부산시청→연산교차로,2023.7.16 10:00,392,298,187,877,1
사직운동장→연산교차로,2023.7.16 10:00,200,469,47,716,1
신리→연산교차로,2023.7.16 10:00,375,160,21,556,1
안락→연산교차로,2023.7.16 10:00,444,0,123,567,1
연산터널→연산교차로,2023.7.16 10:00,224,243,34,501,1
교대→연산교차로,2023.7.16 11:00,249,0,303,552,1
부산시청→연산교차로,2023.7.16 11:00,412,312,152,876,1
사직운동장→연산교차로,2023.7.16 11:00,211,460,52,723,1
신리→연산교차로,2023.7.16 11:00,372,227,32,631,1
안락→연산교차로,2023.7.16 11:00,428,0,126,554,1
연산터널→연산교차로,2023.7.16 11:00,236,244,43,523,1
교대→연산교차로,2023.7.16 12:00,285,0,298,583,1
부산시청→연산교차로,2023.7.16 12:00,462,341,183,986,1
사직운동장→연산교차로,2023.7.16 12:00,233,526,31,790,1
신리→연산교차로,2023.7.16 12:00,404,226,31,661,1
안락→연산교차로,2023.7.16 12:00,484,0,147,631,1
연산터널→연산교차로,2023.7.16 12:00,279,240,41,560,1
교대→연산교차로,2023.7.16 13:00,305,0,305,610,1
부산시청→연산교차로,2023.7.16 13:00,553,362,225,1140,1
사직운동장→연산교차로,2023.7.16 13:00,241,513,43,797,1
신리→연산교차로,2023.7.16 13:00,345,223,46,614,1
안락→연산교차로,2023.7.16 13:00,490,0,121,611,1
연산터널→연산교차로,2023.7.16 13:00,246,266,47,559,1
교대→연산교차로,2023.7.16 14:00,280,0,274,554,1
부산시청→연산교차로,2023.7.16 14:00,516,353,210,1079,1
사직운동장→연산교차로,2023.7.16 14:00,231,543,38,812,1
신리→연산교차로,2023.7.16 14:00,375,225,31,631,1
안락→연산교차로,2023.7.16 14:00,485,0,133,618,1
연산터널→연산교차로,2023.7.16 14:00,223,240,41,504,1
교대→연산교차로,2023.7.16 15:00,285,0,294,579,1
부산시청→연산교차로,2023.7.16 15:00,502,321,196,1019,1
사직운동장→연산교차로,2023.7.16 15:00,231,505,28,764,1
신리→연산교차로,2023.7.16 15:00,412,228,30,670,1
안락→연산교차로,2023.7.16 15:00,426,0,138,564,1
연산터널→연산교차로,2023.7.16 15:00,239,239,54,532,1
교대→연산교차로,2023.7.16 16:00,289,0,256,545,1
부산시청→연산교차로,2023.7.16 16:00,518,340,228,1086,1
사직운동장→연산교차로,2023.7.16 16:00,233,517,37,787,1
신리→연산교차로,2023.7.16 16:00,358,202,36,596,1
안락→연산교차로,2023.7.16 16:00,478,0,134,612,1
연산터널→연산교차로,2023.7.16 16:00,284,254,49,587,1
교대→연산교차로,2023.7.16 17:00,277,0,259,536,1
부산시청→연산교차로,2023.7.16 17:00,508,338,232,1078,1
사직운동장→연산교차로,2023.7.16 17:00,226,517,51,794,1
신리→연산교차로,2023.7.16 17:00,335,175,27,537,1
안락→연산교차로,2023.7.16 17:00,466,0,151,617,1
연산터널→연산교차로,2023.7.16 17:00,262,254,50,566,1
교대→연산교차로,2023.7.16 18:00,251,0,218,469,1
부산시청→연산교차로,2023.7.16 18:00,470,320,242,1032,1
사직운동장→연산교차로,2023.7.16 18:00,178,420,36,634,1
신리→연산교차로,2023.7.16 18:00,282,189,23,494,1
안락→연산교차로,2023.7.16 18:00,381,0,128,509,1
연산터널→연산교차로,2023.7.16 18:00,222,212,40,474,1
교대→연산교차로,2023.7.16 19:00,242,0,220,462,1
부산시청→연산교차로,2023.7.16 19:00,390,275,140,805,1
사직운동장→연산교차로,2023.7.16 19:00,156,366,30,552,1
신리→연산교차로,2023.7.16 19:00,247,150,19,416,1
안락→연산교차로,2023.7.16 19:00,308,0,108,416,1
연산터널→연산교차로,2023.7.16 19:00,207,200,35,442,1
교대→연산교차로,2023.7.16 20:00,215,0,200,415,1
부산시청→연산교차로,2023.7.16 20:00,309,276,145,730,1
사직운동장→연산교차로,2023.7.16 20:00,139,337,7,483,1
신리→연산교차로,2023.7.16 20:00,258,151,9,418,1
안락→연산교차로,2023.7.16 20:00,329,0,81,410,1
연산터널→연산교차로,2023.7.16 20:00,175,179,19,373,1
교대→연산교차로,2023.7.16 21:00,206,0,166,372,1
부산시청→연산교차로,2023.7.16 21:00,319,227,111,657,1
사직운동장→연산교차로,2023.7.16 21:00,119,302,21,442,1
신리→연산교차로,2023.7.16 21:00,213,124,10,347,1
안락→연산교차로,2023.7.16 21:00,285,0,83,368,1
연산터널→연산교차로,2023.7.16 21:00,169,165,27,361,1
교대→연산교차로,2023.7.16 22:00,132,0,140,272,1
부산시청→연산교차로,2023.7.16 22:00,277,179,82,538,1
사직운동장→연산교차로,2023.7.16 22:00,105,252,23,380,1
신리→연산교차로,2023.7.16 22:00,183,112,9,304,1
안락→연산교차로,2023.7.16 22:00,230,0,55,285,1
연산터널→연산교차로,2023.7.16 22:00,121,137,34,292,1
교대→연산교차로,2023.7.16 23:00,118,0,130,248,1
부산시청→연산교차로,2023.7.16 23:00,201,140,80,421,1
사직운동장→연산교차로,2023.7.16 23:00,72,179,30,281,1
신리→연산교차로,2023.7.16 23:00,147,80,5,232,1
안락→연산교차로,2023.7.16 23:00,169,0,46,215,1
연산터널→연산교차로,2023.7.16 23:00,114,136,40,290,1
교대→연산교차로,2023.7.17 00:00,91,0,119,210,0
부산시청→연산교차로,2023.7.17 00:00,176,117,73,366,0
사직운동장→연산교차로,2023.7.17 00:00,56,158,11,225,0
신리→연산교차로,2023.7.17 00:00,111,62,12,185,0
안락→연산교차로,2023.7.17 00:00,152,0,38,190,0
연산터널→연산교차로,2023.7.17 00:00,71,102,26,199,0
교대→연산교차로,2023.7.17 01:00,47,0,80,127,0
부산시청→연산교차로,2023.7.17 01:00,119,83,52,254,0
사직운동장→연산교차로,2023.7.17 01:00,48,112,6,166,0
신리→연산교차로,2023.7.17 01:00,85,57,5,147,0
안락→연산교차로,2023.7.17 01:00,109,0,24,133,0
연산터널→연산교차로,2023.7.17 01:00,67,81,20,168,0
교대→연산교차로,2023.7.17 02:00,58,0,74,132,0
부산시청→연산교차로,2023.7.17 02:00,107,60,44,211,0
사직운동장→연산교차로,2023.7.17 02:00,48,88,12,148,0
신리→연산교차로,2023.7.17 02:00,52,40,8,100,0
안락→연산교차로,2023.7.17 02:00,101,0,27,128,0
연산터널→연산교차로,2023.7.17 02:00,65,74,15,154,0
교대→연산교차로,2023.7.17 03:00,36,0,78,114,0
부산시청→연산교차로,2023.7.17 03:00,114,54,39,207,0
사직운동장→연산교차로,2023.7.17 03:00,33,94,11,138,0
신리→연산교차로,2023.7.17 03:00,59,20,6,85,0
안락→연산교차로,2023.7.17 03:00,98,0,23,121,0
연산터널→연산교차로,2023.7.17 03:00,52,76,25,153,0
교대→연산교차로,2023.7.17 04:00,42,0,75,117,0
부산시청→연산교차로,2023.7.17 04:00,115,70,41,226,0
사직운동장→연산교차로,2023.7.17 04:00,47,104,7,158,0
신리→연산교차로,2023.7.17 04:00,68,41,2,111,0
안락→연산교차로,2023.7.17 04:00,142,0,28,170,0
연산터널→연산교차로,2023.7.17 04:00,63,69,9,141,0
교대→연산교차로,2023.7.17 05:00,104,0,114,218,0
부산시청→연산교차로,2023.7.17 05:00,220,148,77,445,0
사직운동장→연산교차로,2023.7.17 05:00,50,146,28,224,0
신리→연산교차로,2023.7.17 05:00,222,90,10,322,0
안락→연산교차로,2023.7.17 05:00,310,0,47,357,0
연산터널→연산교차로,2023.7.17 05:00,128,136,22,286,0
교대→연산교차로,2023.7.17 06:00,197,0,203,400,0
부산시청→연산교차로,2023.7.17 06:00,377,258,127,762,0
사직운동장→연산교차로,2023.7.17 06:00,94,297,50,441,0
신리→연산교차로,2023.7.17 06:00,373,175,21,569,0
안락→연산교차로,2023.7.17 06:00,496,0,104,600,0
연산터널→연산교차로,2023.7.17 06:00,229,212,42,483,0
교대→연산교차로,2023.7.17 07:00,269,0,409,678,0
부산시청→연산교차로,2023.7.17 07:00,560,359,221,1140,0
사직운동장→연산교차로,2023.7.17 07:00,188,516,69,773,0
신리→연산교차로,2023.7.17 07:00,418,291,25,734,0
안락→연산교차로,2023.7.17 07:00,618,0,72,690,0
연산터널→연산교차로,2023.7.17 07:00,288,385,38,711,0
교대→연산교차로,2023.7.17 08:00,314,0,517,831,0
부산시청→연산교차로,2023.7.17 08:00,564,432,362,1358,0
사직운동장→연산교차로,2023.7.17 08:00,271,642,66,979,0
신리→연산교차로,2023.7.17 08:00,505,351,22,878,0
안락→연산교차로,2023.7.17 08:00,586,0,105,691,0
연산터널→연산교차로,2023.7.17 08:00,310,378,38,726,0
교대→연산교차로,2023.7.17 09:00,299,0,499,798,0
부산시청→연산교차로,2023.7.17 09:00,531,395,285,1211,0
사직운동장→연산교차로,2023.7.17 09:00,231,588,91,910,0
신리→연산교차로,2023.7.17 09:00,463,341,42,846,0
안락→연산교차로,2023.7.17 09:00,591,0,110,701,0
연산터널→연산교차로,2023.7.17 09:00,318,351,42,711,0
교대→연산교차로,2023.7.17 10:00,273,0,481,754,0
부산시청→연산교차로,2023.7.17 10:00,603,341,266,1210,0
사직운동장→연산교차로,2023.7.17 10:00,282,572,76,930,0
신리→연산교차로,2023.7.17 10:00,455,296,58,809,0
안락→연산교차로,2023.7.17 10:00,558,0,176,734,0
연산터널→연산교차로,2023.7.17 10:00,307,336,51,694,0
교대→연산교차로,2023.7.17 11:00,316,0,481,797,0
부산시청→연산교차로,2023.7.17 11:00,585,358,254,1197,0
사직운동장→연산교차로,2023.7.17 11:00,325,598,57,980,0
신리→연산교차로,2023.7.17 11:00,453,266,56,775,0
안락→연산교차로,2023.7.17 11:00,534,0,174,708,0
연산터널→연산교차로,2023.7.17 11:00,271,315,53,639,0
교대→연산교차로,2023.7.17 12:00,310,0,415,725,0
부산시청→연산교차로,2023.7.17 12:00,563,353,259,1175,0
사직운동장→연산교차로,2023.7.17 12:00,231,566,76,873,0
신리→연산교차로,2023.7.17 12:00,422,260,55,737,0
안락→연산교차로,2023.7.17 12:00,462,0,157,619,0
연산터널→연산교차로,2023.7.17 12:00,309,266,46,621,0
교대→연산교차로,2023.7.17 13:00,337,0,418,755,0
부산시청→연산교차로,2023.7.17 13:00,561,425,268,1254,0
사직운동장→연산교차로,2023.7.17 13:00,347,580,85,1012,0
신리→연산교차로,2023.7.17 13:00,448,259,56,763,0
안락→연산교차로,2023.7.17 13:00,447,0,112,559,0
연산터널→연산교차로,2023.7.17 13:00,236,286,38,560,0
교대→연산교차로,2023.7.17 14:00,348,0,525,873,0
부산시청→연산교차로,2023.7.17 14:00,596,463,315,1374,0
사직운동장→연산교차로,2023.7.17 14:00,397,675,88,1160,0
신리→연산교차로,2023.7.17 14:00,489,294,77,860,0
안락→연산교차로,2023.7.17 14:00,439,0,117,556,0
연산터널→연산교차로,2023.7.17 14:00,235,296,39,570,0
교대→연산교차로,2023.7.17 15:00,368,0,515,883,0
부산시청→연산교차로,2023.7.17 15:00,570,487,347,1404,0
사직운동장→연산교차로,2023.7.17 15:00,350,669,73,1092,0
신리→연산교차로,2023.7.17 15:00,442,264,69,775,0
안락→연산교차로,2023.7.17 15:00,441,0,119,560,0
연산터널→연산교차로,2023.7.17 15:00,256,289,45,590,0
교대→연산교차로,2023.7.17 16:00,374,0,565,939,0
부산시청→연산교차로,2023.7.17 16:00,608,507,348,1463,0
사직운동장→연산교차로,2023.7.17 16:00,300,674,65,1039,0
신리→연산교차로,2023.7.17 16:00,481,276,72,829,0
안락→연산교차로,2023.7.17 16:00,446,0,107,553,0
연산터널→연산교차로,2023.7.17 16:00,257,281,38,576,0
교대→연산교차로,2023.7.17 17:00,378,0,532,910,0
부산시청→연산교차로,2023.7.17 17:00,589,544,328,1461,0
사직운동장→연산교차로,2023.7.17 17:00,317,693,34,1044,0
신리→연산교차로,2023.7.17 17:00,481,252,52,785,0
안락→연산교차로,2023.7.17 17:00,446,0,107,553,0
연산터널→연산교차로,2023.7.17 17:00,248,274,45,567,0
교대→연산교차로,2023.7.17 18:00,379,0,561,940,0
부산시청→연산교차로,2023.7.17 18:00,610,579,323,1512,0
사직운동장→연산교차로,2023.7.17 18:00,369,675,52,1096,0
신리→연산교차로,2023.7.17 18:00,511,260,42,813,0
안락→연산교차로,2023.7.17 18:00,466,0,118,584,0
연산터널→연산교차로,2023.7.17 18:00,234,288,60,582,0
교대→연산교차로,2023.7.17 19:00,295,0,430,725,0
부산시청→연산교차로,2023.7.17 19:00,512,429,279,1220,0
사직운동장→연산교차로,2023.7.17 19:00,172,550,79,801,0
신리→연산교차로,2023.7.17 19:00,397,224,51,672,0
안락→연산교차로,2023.7.17 19:00,426,0,130,556,0
연산터널→연산교차로,2023.7.17 19:00,200,259,54,513,0
교대→연산교차로,2023.7.17 20:00,283,0,327,610,0
부산시청→연산교차로,2023.7.17 20:00,500,355,237,1092,0
사직운동장→연산교차로,2023.7.17 20:00,177,522,57,756,0
신리→연산교차로,2023.7.17 20:00,305,212,25,542,0
안락→연산교차로,2023.7.17 20:00,384,0,143,527,0
연산터널→연산교차로,2023.7.17 20:00,191,279,50,520,0
교대→연산교차로,2023.7.17 21:00,268,0,248,516,0
부산시청→연산교차로,2023.7.17 21:00,465,324,215,1004,0
사직운동장→연산교차로,2023.7.17 21:00,172,412,67,651,0
신리→연산교차로,2023.7.17 21:00,301,174,22,497,0
안락→연산교차로,2023.7.17 21:00,387,0,103,490,0
연산터널→연산교차로,2023.7.17 21:00,236,234,46,516,0
교대→연산교차로,2023.7.17 22:00,232,0,243,475,0
부산시청→연산교차로,2023.7.17 22:00,408,258,183,849,0
사직운동장→연산교차로,2023.7.17 22:00,146,357,59,562,0
신리→연산교차로,2023.7.17 22:00,217,164,33,414,0
안락→연산교차로,2023.7.17 22:00,320,0,109,429,0
연산터널→연산교차로,2023.7.17 22:00,178,230,76,484,0
교대→연산교차로,2023.7.17 23:00,166,0,202,368,0
부산시청→연산교차로,2023.7.17 23:00,298,192,129,619,0
사직운동장→연산교차로,2023.7.17 23:00,128,296,63,487,0
신리→연산교차로,2023.7.17 23:00,170,109,16,295,0
안락→연산교차로,2023.7.17 23:00,241,0,82,323,0
연산터널→연산교차로,2023.7.17 23:00,138,184,65,387,0
교대→연산교차로,2023.7.18 00:00,112,0,189,301,0
부산시청→연산교차로,2023.7.18 00:00,217,145,92,454,0
사직운동장→연산교차로,2023.7.18 00:00,87,220,39,346,0
신리→연산교차로,2023.7.18 00:00,148,89,28,265,0
안락→연산교차로,2023.7.18 00:00,178,0,51,229,0
연산터널→연산교차로,2023.7.18 00:00,138,184,69,391,0
교대→연산교차로,2023.7.18 01:00,95,0,166,261,0
부산시청→연산교차로,2023.7.18 01:00,179,100,67,346,0
사직운동장→연산교차로,2023.7.18 01:00,47,158,41,246,0
신리→연산교차로,2023.7.18 01:00,109,56,17,182,0
안락→연산교차로,2023.7.18 01:00,142,0,32,174,0
연산터널→연산교차로,2023.7.18 01:00,92,109,69,270,0
교대→연산교차로,2023.7.18 02:00,75,0,121,196,0
부산시청→연산교차로,2023.7.18 02:00,169,83,60,312,0
사직운동장→연산교차로,2023.7.18 02:00,47,134,25,206,0
신리→연산교차로,2023.7.18 02:00,76,51,21,148,0
안락→연산교차로,2023.7.18 02:00,126,0,31,157,0
연산터널→연산교차로,2023.7.18 02:00,89,121,32,242,0
교대→연산교차로,2023.7.18 03:00,64,0,95,159,0
부산시청→연산교차로,2023.7.18 03:00,153,58,47,258,0
사직운동장→연산교차로,2023.7.18 03:00,25,131,24,180,0
신리→연산교차로,2023.7.18 03:00,74,44,9,127,0
안락→연산교차로,2023.7.18 03:00,105,0,30,135,0
연산터널→연산교차로,2023.7.18 03:00,95,109,34,238,0
교대→연산교차로,2023.7.18 04:00,55,0,94,149,0
부산시청→연산교차로,2023.7.18 04:00,143,68,54,265,0
사직운동장→연산교차로,2023.7.18 04:00,36,115,29,180,0
신리→연산교차로,2023.7.18 04:00,83,45,8,136,0
안락→연산교차로,2023.7.18 04:00,148,0,41,189,0
연산터널→연산교차로,2023.7.18 04:00,77,87,26,190,0
교대→연산교차로,2023.7.18 05:00,83,0,125,208,0
부산시청→연산교차로,2023.7.18 05:00,216,134,71,421,0
사직운동장→연산교차로,2023.7.18 05:00,58,165,24,247,0
신리→연산교차로,2023.7.18 05:00,195,101,11,307,0
안락→연산교차로,2023.7.18 05:00,287,0,56,343,0
연산터널→연산교차로,2023.7.18 05:00,128,150,38,316,0
교대→연산교차로,2023.7.18 06:00,176,0,208,384,0
부산시청→연산교차로,2023.7.18 06:00,357,246,120,723,0
사직운동장→연산교차로,2023.7.18 06:00,124,288,43,455,0
신리→연산교차로,2023.7.18 06:00,322,179,22,523,0
안락→연산교차로,2023.7.18 06:00,439,0,87,526,0
연산터널→연산교차로,2023.7.18 06:00,222,222,26,470,0
교대→연산교차로,2023.7.18 07:00,271,0,372,643,0
부산시청→연산교차로,2023.7.18 07:00,550,348,233,1131,0
사직운동장→연산교차로,2023.7.18 07:00,205,470,60,735,0
신리→연산교차로,2023.7.18 07:00,462,268,22,752,0
안락→연산교차로,2023.7.18 07:00,628,0,81,709,0
연산터널→연산교차로,2023.7.18 07:00,300,354,51,705,0
교대→연산교차로,2023.7.18 08:00,303,0,476,779,0
부산시청→연산교차로,2023.7.18 08:00,541,412,302,1255,0
사직운동장→연산교차로,2023.7.18 08:00,276,635,63,974,0
신리→연산교차로,2023.7.18 08:00,495,338,22,855,0
안락→연산교차로,2023.7.18 08:00,617,0,99,716,0
연산터널→연산교차로,2023.7.18 08:00,311,368,30,709,0
교대→연산교차로,2023.7.18 09:00,284,0,538,822,0
부산시청→연산교차로,2023.7.18 09:00,517,348,312,1177,0
사직운동장→연산교차로,2023.7.18 09:00,278,580,94,952,0
신리→연산교차로,2023.7.18 09:00,461,333,45,839,0
안락→연산교차로,2023.7.18 09:00,552,0,125,677,0
연산터널→연산교차로,2023.7.18 09:00,266,374,49,689,0
교대→연산교차로,2023.7.18 10:00,291,0,491,782,0
부산시청→연산교차로,2023.7.18 10:00,547,370,255,1172,0
사직운동장→연산교차로,2023.7.18 10:00,284,589,75,948,0
신리→연산교차로,2023.7.18 10:00,423,280,60,763,0
안락→연산교차로,2023.7.18 10:00,565,0,120,685,0
연산터널→연산교차로,2023.7.18 10:00,280,337,36,653,0
교대→연산교차로,2023.7.18 11:00,290,0,478,768,0
부산시청→연산교차로,2023.7.18 11:00,548,369,287,1204,0
사직운동장→연산교차로,2023.7.18 11:00,321,544,80,945,0
신리→연산교차로,2023.7.18 11:00,427,244,68,739,0
안락→연산교차로,2023.7.18 11:00,520,0,148,668,0
연산터널→연산교차로,2023.7.18 11:00,271,320,58,649,0
교대→연산교차로,2023.7.18 12:00,267,0,397,664,0
부산시청→연산교차로,2023.7.18 12:00,517,359,251,1127,0
사직운동장→연산교차로,2023.7.18 12:00,277,520,79,876,0
신리→연산교차로,2023.7.18 12:00,405,241,44,690,0
안락→연산교차로,2023.7.18 12:00,468,0,142,610,0
연산터널→연산교차로,2023.7.18 12:00,290,292,52,634,0
교대→연산교차로,2023.7.18 13:00,319,0,444,763,0
부산시청→연산교차로,2023.7.18 13:00,516,439,250,1205,0
사직운동장→연산교차로,2023.7.18 13:00,278,588,62,928,0
신리→연산교차로,2023.7.18 13:00,407,264,47,718,0
안락→연산교차로,2023.7.18 13:00,407,0,114,521,0
연산터널→연산교차로,2023.7.18 13:00,223,269,41,533,0
교대→연산교차로,2023.7.18 14:00,349,0,515,864,0
부산시청→연산교차로,2023.7.18 14:00,528,451,260,1239,0
사직운동장→연산교차로,2023.7.18 14:00,352,605,87,1044,0
신리→연산교차로,2023.7.18 14:00,434,282,44,760,0
안락→연산교차로,2023.7.18 14:00,402,0,153,555,0
연산터널→연산교차로,2023.7.18 14:00,228,265,58,551,0
교대→연산교차로,2023.7.18 15:00,336,0,478,814,0
부산시청→연산교차로,2023.7.18 15:00,556,475,316,1347,0
사직운동장→연산교차로,2023.7.18 15:00,237,611,75,923,0
신리→연산교차로,2023.7.18 15:00,432,268,43,743,0
안락→연산교차로,2023.7.18 15:00,413,0,109,522,0
연산터널→연산교차로,2023.7.18 15:00,244,260,45,549,0
교대→연산교차로,2023.7.18 16:00,342,0,474,816,0
부산시청→연산교차로,2023.7.18 16:00,584,486,320,1390,0
사직운동장→연산교차로,2023.7.18 16:00,232,645,42,919,0
신리→연산교차로,2023.7.18 16:00,454,261,51,766,0
안락→연산교차로,2023.7.18 16:00,431,0,110,541,0
연산터널→연산교차로,2023.7.18 16:00,227,257,33,517,0
교대→연산교차로,2023.7.18 17:00,336,0,457,793,0
부산시청→연산교차로,2023.7.18 17:00,530,517,314,1361,0
사직운동장→연산교차로,2023.7.18 17:00,216,668,48,932,0
신리→연산교차로,2023.7.18 17:00,525,264,46,835,0
안락→연산교차로,2023.7.18 17:00,408,0,132,540,0
연산터널→연산교차로,2023.7.18 17:00,212,277,41,530,0
교대→연산교차로,2023.7.18 18:00,344,0,523,867,0
부산시청→연산교차로,2023.7.18 18:00,526,561,333,1420,0
사직운동장→연산교차로,2023.7.18 18:00,234,659,37,930,0
신리→연산교차로,2023.7.18 18:00,495,247,39,781,0
안락→연산교차로,2023.7.18 18:00,408,0,101,509,0
연산터널→연산교차로,2023.7.18 18:00,213,263,42,518,0
교대→연산교차로,2023.7.18 19:00,305,0,323,628,0
부산시청→연산교차로,2023.7.18 19:00,519,446,232,1197,0
사직운동장→연산교차로,2023.7.18 19:00,205,532,8,745,0
신리→연산교차로,2023.7.18 19:00,288,207,19,514,0
안락→연산교차로,2023.7.18 19:00,352,0,94,446,0
연산터널→연산교차로,2023.7.18 19:00,194,238,31,463,0
교대→연산교차로,2023.7.18 20:00,299,0,239,538,0
부산시청→연산교차로,2023.7.18 20:00,446,356,203,1005,0
사직운동장→연산교차로,2023.7.18 20:00,161,402,1,564,0
신리→연산교차로,2023.7.18 20:00,281,178,13,472,0
안락→연산교차로,2023.7.18 20:00,338,0,81,419,0
연산터널→연산교차로,2023.7.18 20:00,199,227,31,457,0
교대→연산교차로,2023.7.18 21:00,267,0,205,472,0
부산시청→연산교차로,2023.7.18 21:00,314,357,193,864,0
사직운동장→연산교차로,2023.7.18 21:00,180,377,4,561,0
신리→연산교차로,2023.7.18 21:00,241,158,7,406,0
안락→연산교차로,2023.7.18 21:00,362,0,94,456,0
연산터널→연산교차로,2023.7.18 21:00,208,208,22,438,0
교대→연산교차로,2023.7.18 22:00,218,0,145,363,0
부산시청→연산교차로,2023.7.18 22:00,331,234,136,701,0
사직운동장→연산교차로,2023.7.18 22:00,132,322,11,465,0
신리→연산교차로,2023.7.18 22:00,191,171,10,372,0
안락→연산교차로,2023.7.18 22:00,300,0,72,372,0
연산터널→연산교차로,2023.7.18 22:00,149,153,22,324,0
교대→연산교차로,2023.7.18 23:00,138,0,116,254,0
부산시청→연산교차로,2023.7.18 23:00,260,135,105,500,0
사직운동장→연산교차로,2023.7.18 23:00,82,216,22,320,0
신리→연산교차로,2023.7.18 23:00,139,92,5,236,0
안락→연산교차로,2023.7.18 23:00,207,0,48,255,0
연산터널→연산교차로,2023.7.18 23:00,112,121,25,258,0
교대→연산교차로,2023.7.19 00:00,79,0,110,189,0
부산시청→연산교차로,2023.7.19 00:00,157,124,81,362,0
사직운동장→연산교차로,2023.7.19 00:00,57,159,15,231,0
신리→연산교차로,2023.7.19 00:00,127,69,7,203,0
안락→연산교차로,2023.7.19 00:00,149,0,37,186,0
연산터널→연산교차로,2023.7.19 00:00,106,138,24,268,0
교대→연산교차로,2023.7.19 01:00,91,0,133,224,0
부산시청→연산교차로,2023.7.19 01:00,159,94,61,314,0
사직운동장→연산교차로,2023.7.19 01:00,26,121,12,159,0
신리→연산교차로,2023.7.19 01:00,77,47,9,133,0
안락→연산교차로,2023.7.19 01:00,124,0,30,154,0
연산터널→연산교차로,2023.7.19 01:00,89,90,31,210,0
교대→연산교차로,2023.7.19 02:00,53,0,112,165,0
부산시청→연산교차로,2023.7.19 02:00,166,113,49,328,0
사직운동장→연산교차로,2023.7.19 02:00,40,102,19,161,0
신리→연산교차로,2023.7.19 02:00,83,51,7,141,0
안락→연산교차로,2023.7.19 02:00,115,0,31,146,0
연산터널→연산교차로,2023.7.19 02:00,78,99,25,202,0
교대→연산교차로,2023.7.19 03:00,49,0,93,142,0
부산시청→연산교차로,2023.7.19 03:00,129,58,37,224,0
사직운동장→연산교차로,2023.7.19 03:00,18,117,19,154,0
신리→연산교차로,2023.7.19 03:00,56,36,5,97,0
안락→연산교차로,2023.7.19 03:00,107,0,28,135,0
연산터널→연산교차로,2023.7.19 03:00,56,74,31,161,0
교대→연산교차로,2023.7.19 04:00,45,0,76,121,0
부산시청→연산교차로,2023.7.19 04:00,123,79,43,245,0
사직운동장→연산교차로,2023.7.19 04:00,31,97,5,133,0
신리→연산교차로,2023.7.19 04:00,81,39,4,124,0
안락→연산교차로,2023.7.19 04:00,158,0,24,182,0
연산터널→연산교차로,2023.7.19 04:00,68,71,13,152,0
교대→연산교차로,2023.7.19 05:00,93,0,116,209,0
부산시청→연산교차로,2023.7.19 05:00,208,151,77,436,0
사직운동장→연산교차로,2023.7.19 05:00,42,163,29,234,0
신리→연산교차로,2023.7.19 05:00,177,88,12,277,0
안락→연산교차로,2023.7.19 05:00,315,0,51,366,0
연산터널→연산교차로,2023.7.19 05:00,132,122,28,282,0
교대→연산교차로,2023.7.19 06:00,195,0,207,402,0
부산시청→연산교차로,2023.7.19 06:00,353,234,111,698,0
사직운동장→연산교차로,2023.7.19 06:00,89,278,42,409,0
신리→연산교차로,2023.7.19 06:00,326,180,22,528,0
안락→연산교차로,2023.7.19 06:00,493,0,99,592,0
연산터널→연산교차로,2023.7.19 06:00,229,228,36,493,0
교대→연산교차로,2023.7.19 07:00,252,0,387,639,0
부산시청→연산교차로,2023.7.19 07:00,529,365,201,1095,0
사직운동장→연산교차로,2023.7.19 07:00,165,493,60,718,0
신리→연산교차로,2023.7.19 07:00,455,262,36,753,0
안락→연산교차로,2023.7.19 07:00,626,0,81,707,0
연산터널→연산교차로,2023.7.19 07:00,285,364,51,700,0
교대→연산교차로,2023.7.19 08:00,302,0,502,804,0
부산시청→연산교차로,2023.7.19 08:00,560,429,332,1321,0
사직운동장→연산교차로,2023.7.19 08:00,186,639,82,907,0
신리→연산교차로,2023.7.19 08:00,506,324,24,854,0
안락→연산교차로,2023.7.19 08:00,593,0,118,711,0
연산터널→연산교차로,2023.7.19 08:00,319,383,30,732,0
교대→연산교차로,2023.7.19 09:00,291,0,508,799,0
부산시청→연산교차로,2023.7.19 09:00,522,370,288,1180,0
사직운동장→연산교차로,2023.7.19 09:00,188,557,92,837,0
신리→연산교차로,2023.7.19 09:00,478,312,57,847,0
안락→연산교차로,2023.7.19 09:00,582,0,130,712,0
연산터널→연산교차로,2023.7.19 09:00,317,373,40,730,0
교대→연산교차로,2023.7.19 10:00,289,0,472,761,0
부산시청→연산교차로,2023.7.19 10:00,544,359,268,1171,0
사직운동장→연산교차로,2023.7.19 10:00,216,577,90,883,0
신리→연산교차로,2023.7.19 10:00,478,294,44,816,0
안락→연산교차로,2023.7.19 10:00,549,0,173,722,0
연산터널→연산교차로,2023.7.19 10:00,320,336,53,709,0
교대→연산교차로,2023.7.19 11:00,292,0,406,698,0
부산시청→연산교차로,2023.7.19 11:00,569,377,235,1181,0
사직운동장→연산교차로,2023.7.19 11:00,217,564,89,870,0
신리→연산교차로,2023.7.19 11:00,476,272,54,802,0
안락→연산교차로,2023.7.19 11:00,520,0,195,715,0
연산터널→연산교차로,2023.7.19 11:00,266,321,54,641,0
교대→연산교차로,2023.7.19 12:00,288,0,384,672,0
부산시청→연산교차로,2023.7.19 12:00,582,355,258,1195,0
사직운동장→연산교차로,2023.7.19 12:00,172,543,69,784,0
신리→연산교차로,2023.7.19 12:00,420,245,62,727,0
안락→연산교차로,2023.7.19 12:00,473,0,172,645,0
연산터널→연산교차로,2023.7.19 12:00,260,282,48,590,0
교대→연산교차로,2023.7.19 13:00,318,0,394,712,0
부산시청→연산교차로,2023.7.19 13:00,559,446,277,1282,0
사직운동장→연산교차로,2023.7.19 13:00,205,630,85,920,0
신리→연산교차로,2023.7.19 13:00,392,282,52,726,0
안락→연산교차로,2023.7.19 13:00,444,0,133,577,0
연산터널→연산교차로,2023.7.19 13:00,248,275,41,564,0
교대→연산교차로,2023.7.19 14:00,340,0,537,877,0
부산시청→연산교차로,2023.7.19 14:00,543,443,288,1274,0
사직운동장→연산교차로,2023.7.19 14:00,221,607,103,931,0
신리→연산교차로,2023.7.19 14:00,468,280,54,802,0
안락→연산교차로,2023.7.19 14:00,419,0,146,565,0
연산터널→연산교차로,2023.7.19 14:00,237,279,33,549,0
교대→연산교차로,2023.7.19 15:00,338,0,460,798,0
부산시청→연산교차로,2023.7.19 15:00,583,490,270,1343,0
사직운동장→연산교차로,2023.7.19 15:00,247,646,60,953,0
신리→연산교차로,2023.7.19 15:00,454,264,50,768,0
안락→연산교차로,2023.7.19 15:00,428,0,140,568,0
연산터널→연산교차로,2023.7.19 15:00,245,282,48,575,0
교대→연산교차로,2023.7.19 16:00,361,0,523,884,0
부산시청→연산교차로,2023.7.19 16:00,613,526,319,1458,0
사직운동장→연산교차로,2023.7.19 16:00,235,666,68,969,0
신리→연산교차로,2023.7.19 16:00,510,294,48,852,0
안락→연산교차로,2023.7.19 16:00,457,0,99,556,0
연산터널→연산교차로,2023.7.19 16:00,242,275,57,574,0
교대→연산교차로,2023.7.19 17:00,372,0,514,886,0
부산시청→연산교차로,2023.7.19 17:00,616,509,293,1418,0
사직운동장→연산교차로,2023.7.19 17:00,220,705,38,963,0
신리→연산교차로,2023.7.19 17:00,561,279,58,898,0
안락→연산교차로,2023.7.19 17:00,435,0,99,534,0
연산터널→연산교차로,2023.7.19 17:00,227,290,42,559,0
교대→연산교차로,2023.7.19 18:00,364,0,527,891,0
부산시청→연산교차로,2023.7.19 18:00,595,568,336,1499,0
사직운동장→연산교차로,2023.7.19 18:00,244,701,59,1004,0
신리→연산교차로,2023.7.19 18:00,511,272,42,825,0
안락→연산교차로,2023.7.19 18:00,439,0,126,565,0
연산터널→연산교차로,2023.7.19 18:00,242,266,56,564,0
교대→연산교차로,2023.7.19 19:00,333,0,384,717,0
부산시청→연산교차로,2023.7.19 19:00,529,435,278,1242,0
사직운동장→연산교차로,2023.7.19 19:00,186,594,84,864,0
신리→연산교차로,2023.7.19 19:00,331,201,47,579,0
안락→연산교차로,2023.7.19 19:00,434,0,98,532,0
연산터널→연산교차로,2023.7.19 19:00,208,269,58,535,0
교대→연산교차로,2023.7.19 20:00,293,0,315,608,0
부산시청→연산교차로,2023.7.19 20:00,470,346,244,1060,0
사직운동장→연산교차로,2023.7.19 20:00,161,505,106,772,0
신리→연산교차로,2023.7.19 20:00,332,208,38,578,0
안락→연산교차로,2023.7.19 20:00,365,0,121,486,0
연산터널→연산교차로,2023.7.19 20:00,189,257,57,503,0
교대→연산교차로,2023.7.19 21:00,287,0,350,637,0
부산시청→연산교차로,2023.7.19 21:00,485,315,218,1018,0
사직운동장→연산교차로,2023.7.19 21:00,158,475,91,724,0
신리→연산교차로,2023.7.19 21:00,291,191,21,503,0
안락→연산교차로,2023.7.19 21:00,399,0,105,504,0
연산터널→연산교차로,2023.7.19 21:00,227,272,76,575,0
교대→연산교차로,2023.7.19 22:00,235,0,237,472,0
부산시청→연산교차로,2023.7.19 22:00,395,268,169,832,0
사직운동장→연산교차로,2023.7.19 22:00,153,348,95,596,0
신리→연산교차로,2023.7.19 22:00,248,171,22,441,0
안락→연산교차로,2023.7.19 22:00,339,0,109,448,0
연산터널→연산교차로,2023.7.19 22:00,186,265,56,507,0
교대→연산교차로,2023.7.19 23:00,190,0,175,365,0
부산시청→연산교차로,2023.7.19 23:00,334,195,132,661,0
사직운동장→연산교차로,2023.7.19 23:00,119,301,66,486,0
신리→연산교차로,2023.7.19 23:00,210,119,19,348,0
안락→연산교차로,2023.7.19 23:00,264,0,56,320,0
연산터널→연산교차로,2023.7.19 23:00,151,197,59,407,0
교대→연산교차로,2023.7.20 00:00,140,0,203,343,0
부산시청→연산교차로,2023.7.20 00:00,277,174,140,591,0
사직운동장→연산교차로,2023.7.20 00:00,77,225,59,361,0
신리→연산교차로,2023.7.20 00:00,176,101,23,300,0
안락→연산교차로,2023.7.20 00:00,216,0,75,291,0
연산터널→연산교차로,2023.7.20 00:00,150,191,79,420,0
교대→연산교차로,2023.7.20 01:00,105,0,155,260,0
부산시청→연산교차로,2023.7.20 01:00,204,112,89,405,0
사직운동장→연산교차로,2023.7.20 01:00,53,180,49,282,0
신리→연산교차로,2023.7.20 01:00,135,82,13,230,0
안락→연산교차로,2023.7.20 01:00,167,0,63,230,0
연산터널→연산교차로,2023.7.20 01:00,123,135,40,298,0
교대→연산교차로,2023.7.20 02:00,89,0,132,221,0
부산시청→연산교차로,2023.7.20 02:00,185,78,69,332,0
사직운동장→연산교차로,2023.7.20 02:00,42,165,26,233,0
신리→연산교차로,2023.7.20 02:00,96,55,12,163,0
안락→연산교차로,2023.7.20 02:00,130,0,39,169,0
연산터널→연산교차로,2023.7.20 02:00,121,141,54,316,0
교대→연산교차로,2023.7.20 03:00,63,0,117,180,0
부산시청→연산교차로,2023.7.20 03:00,165,80,52,297,0
사직운동장→연산교차로,2023.7.20 03:00,42,132,25,199,0
신리→연산교차로,2023.7.20 03:00,81,51,15,147,0
안락→연산교차로,2023.7.20 03:00,131,0,36,167,0
연산터널→연산교차로,2023.7.20 03:00,97,125,43,265,0
교대→연산교차로,2023.7.20 04:00,63,0,103,166,0
부산시청→연산교차로,2023.7.20 04:00,163,76,58,297,0
사직운동장→연산교차로,2023.7.20 04:00,37,133,11,181,0
신리→연산교차로,2023.7.20 04:00,88,48,9,145,0
안락→연산교차로,2023.7.20 04:00,170,0,34,204,0
연산터널→연산교차로,2023.7.20 04:00,88,115,29,232,0
교대→연산교차로,2023.7.20 05:00,112,0,116,228,0
부산시청→연산교차로,2023.7.20 05:00,219,153,89,461,0
사직운동장→연산교차로,2023.7.20 05:00,64,194,38,296,0
신리→연산교차로,2023.7.20 05:00,206,92,17,315,0
안락→연산교차로,2023.7.20 05:00,343,0,62,405,0
연산터널→연산교차로,2023.7.20 05:00,146,152,37,335,0
교대→연산교차로,2023.7.20 06:00,193,0,212,405,0
부산시청→연산교차로,2023.7.20 06:00,369,255,112,736,0
사직운동장→연산교차로,2023.7.20 06:00,99,279,57,435,0
신리→연산교차로,2023.7.20 06:00,351,196,21,568,0
안락→연산교차로,2023.7.20 06:00,460,0,92,552,0
연산터널→연산교차로,2023.7.20 06:00,209,223,42,474,0
교대→연산교차로,2023.7.20 07:00,286,0,382,668,0
부산시청→연산교차로,2023.7.20 07:00,542,358,228,1128,0
사직운동장→연산교차로,2023.7.20 07:00,163,483,81,727,0
신리→연산교차로,2023.7.20 07:00,432,280,32,744,0
안락→연산교차로,2023.7.20 07:00,625,0,88,713,0
연산터널→연산교차로,2023.7.20 07:00,282,358,33,673,0
교대→연산교차로,2023.7.20 08:00,292,0,537,829,0
부산시청→연산교차로,2023.7.20 08:00,569,450,307,1326,0
사직운동장→연산교차로,2023.7.20 08:00,196,639,62,897,0
신리→연산교차로,2023.7.20 08:00,479,342,34,855,0
안락→연산교차로,2023.7.20 08:00,638,0,121,759,0
연산터널→연산교차로,2023.7.20 08:00,310,369,38,717,0
교대→연산교차로,2023.7.20 09:00,290,0,486,776,0
부산시청→연산교차로,2023.7.20 09:00,501,366,305,1172,0
사직운동장→연산교차로,2023.7.20 09:00,190,551,85,826,0
신리→연산교차로,2023.7.20 09:00,476,321,52,849,0
안락→연산교차로,2023.7.20 09:00,576,0,129,705,0
연산터널→연산교차로,2023.7.20 09:00,276,374,35,685,0
교대→연산교차로,2023.7.20 10:00,292,0,463,755,0
부산시청→연산교차로,2023.7.20 10:00,518,360,280,1158,0
사직운동장→연산교차로,2023.7.20 10:00,183,598,63,844,0
신리→연산교차로,2023.7.20 10:00,419,284,61,764,0
안락→연산교차로,2023.7.20 10:00,557,0,159,716,0
연산터널→연산교차로,2023.7.20 10:00,298,317,39,654,0
교대→연산교차로,2023.7.20 11:00,308,0,453,761,0
부산시청→연산교차로,2023.7.20 11:00,538,361,286,1185,0
사직운동장→연산교차로,2023.7.20 11:00,195,570,67,832,0
신리→연산교차로,2023.7.20 11:00,428,235,57,720,0
안락→연산교차로,2023.7.20 11:00,528,0,196,724,0
연산터널→연산교차로,2023.7.20 11:00,278,284,57,619,0
교대→연산교차로,2023.7.20 12:00,303,0,409,712,0
부산시청→연산교차로,2023.7.20 12:00,534,338,260,1132,0
사직운동장→연산교차로,2023.7.20 12:00,188,562,56,806,0
신리→연산교차로,2023.7.20 12:00,384,245,49,678,0
안락→연산교차로,2023.7.20 12:00,488,0,156,644,0
연산터널→연산교차로,2023.7.20 12:00,274,265,43,582,0
교대→연산교차로,2023.7.20 13:00,344,0,425,769,0
부산시청→연산교차로,2023.7.20 13:00,561,429,301,1291,0
사직운동장→연산교차로,2023.7.20 13:00,220,583,87,890,0
신리→연산교차로,2023.7.20 13:00,466,294,51,811,0
안락→연산교차로,2023.7.20 13:00,466,0,163,629,0
연산터널→연산교차로,2023.7.20 13:00,242,264,41,547,0
교대→연산교차로,2023.7.20 14:00,344,0,482,826,0
부산시청→연산교차로,2023.7.20 14:00,545,413,323,1281,0
사직운동장→연산교차로,2023.7.20 14:00,197,653,86,936,0
신리→연산교차로,2023.7.20 14:00,417,268,66,751,0
안락→연산교차로,2023.7.20 14:00,432,0,154,586,0
연산터널→연산교차로,2023.7.20 14:00,232,292,49,573,0
교대→연산교차로,2023.7.20 15:00,364,0,491,855,0
부산시청→연산교차로,2023.7.20 15:00,611,461,282,1354,0
사직운동장→연산교차로,2023.7.20 15:00,219,633,64,916,0
신리→연산교차로,2023.7.20 15:00,424,291,56,771,0
안락→연산교차로,2023.7.20 15:00,432,0,135,567,0
연산터널→연산교차로,2023.7.20 15:00,213,298,42,553,0
교대→연산교차로,2023.7.20 16:00,344,0,510,854,0
부산시청→연산교차로,2023.7.20 16:00,619,512,315,1446,0
사직운동장→연산교차로,2023.7.20 16:00,219,698,54,971,0
신리→연산교차로,2023.7.20 16:00,498,260,46,804,0
안락→연산교차로,2023.7.20 16:00,450,0,142,592,0
연산터널→연산교차로,2023.7.20 16:00,244,269,49,562,0
교대→연산교차로,2023.7.20 17:00,368,0,540,908,0
부산시청→연산교차로,2023.7.20 17:00,610,550,323,1483,0
사직운동장→연산교차로,2023.7.20 17:00,222,684,51,957,0
신리→연산교차로,2023.7.20 17:00,510,277,47,834,0
안락→연산교차로,2023.7.20 17:00,440,0,127,567,0
연산터널→연산교차로,2023.7.20 17:00,214,290,30,534,0
교대→연산교차로,2023.7.20 18:00,373,0,571,944,0
부산시청→연산교차로,2023.7.20 18:00,621,555,309,1485,0
사직운동장→연산교차로,2023.7.20 18:00,236,687,50,973,0
신리→연산교차로,2023.7.20 18:00,510,263,50,823,0
안락→연산교차로,2023.7.20 18:00,456,0,117,573,0
연산터널→연산교차로,2023.7.20 18:00,226,279,47,552,0
교대→연산교차로,2023.7.20 19:00,338,0,446,784,0
부산시청→연산교차로,2023.7.20 19:00,564,417,268,1249,0
사직운동장→연산교차로,2023.7.20 19:00,201,558,70,829,0
신리→연산교차로,2023.7.20 19:00,363,212,43,618,0
안락→연산교차로,2023.7.20 19:00,419,0,96,515,0
연산터널→연산교차로,2023.7.20 19:00,217,278,52,547,0
교대→연산교차로,2023.7.20 20:00,305,0,352,657,0
부산시청→연산교차로,2023.7.20 20:00,443,386,267,1096,0
사직운동장→연산교차로,2023.7.20 20:00,175,519,99,793,0
신리→연산교차로,2023.7.20 20:00,307,207,42,556,0
안락→연산교차로,2023.7.20 20:00,393,0,120,513,0
연산터널→연산교차로,2023.7.20 20:00,222,264,54,540,0
교대→연산교차로,2023.7.20 21:00,276,0,322,598,0
부산시청→연산교차로,2023.7.20 21:00,498,348,222,1068,0
사직운동장→연산교차로,2023.7.20 21:00,176,437,87,700,0
신리→연산교차로,2023.7.20 21:00,293,197,32,522,0
안락→연산교차로,2023.7.20 21:00,420,0,101,521,0
연산터널→연산교차로,2023.7.20 21:00,247,249,43,539,0
교대→연산교차로,2023.7.20 22:00,257,0,247,504,0
부산시청→연산교차로,2023.7.20 22:00,437,258,203,898,0
사직운동장→연산교차로,2023.7.20 22:00,139,376,64,579,0
신리→연산교차로,2023.7.20 22:00,268,161,23,452,0
안락→연산교차로,2023.7.20 22:00,333,0,109,442,0
연산터널→연산교차로,2023.7.20 22:00,188,244,56,488,0
교대→연산교차로,2023.7.20 23:00,194,0,242,436,0
부산시청→연산교차로,2023.7.20 23:00,327,223,141,691,0
사직운동장→연산교차로,2023.7.20 23:00,136,298,53,487,0
신리→연산교차로,2023.7.20 23:00,223,129,32,384,0
안락→연산교차로,2023.7.20 23:00,236,0,82,318,0
연산터널→연산교차로,2023.7.20 23:00,172,202,56,430,0
교대→연산교차로,2023.7.21 00:00,136,0,236,372,0
부산시청→연산교차로,2023.7.21 00:00,258,174,127,559,0
사직운동장→연산교차로,2023.7.21 00:00,76,241,68,385,0
신리→연산교차로,2023.7.21 00:00,148,84,26,258,0
안락→연산교차로,2023.7.21 00:00,218,0,75,293,0
연산터널→연산교차로,2023.7.21 00:00,152,194,72,418,0
교대→연산교차로,2023.7.21 01:00,115,0,201,316,0
부산시청→연산교차로,2023.7.21 01:00,239,128,92,459,0
사직운동장→연산교차로,2023.7.21 01:00,60,208,55,323,0
신리→연산교차로,2023.7.21 01:00,131,81,25,237,0
안락→연산교차로,2023.7.21 01:00,168,0,58,226,0
연산터널→연산교차로,2023.7.21 01:00,126,174,56,356,0
교대→연산교차로,2023.7.21 02:00,93,0,166,259,0
부산시청→연산교차로,2023.7.21 02:00,164,83,67,314,0
사직운동장→연산교차로,2023.7.21 02:00,45,154,30,229,0
신리→연산교차로,2023.7.21 02:00,115,54,15,184,0
안락→연산교차로,2023.7.21 02:00,133,0,38,171,0
연산터널→연산교차로,2023.7.21 02:00,96,109,67,272,0
교대→연산교차로,2023.7.21 03:00,65,0,122,187,0
부산시청→연산교차로,2023.7.21 03:00,159,84,43,286,0
사직운동장→연산교차로,2023.7.21 03:00,34,137,20,191,0
신리→연산교차로,2023.7.21 03:00,75,46,12,133,0
안락→연산교차로,2023.7.21 03:00,125,0,44,169,0
연산터널→연산교차로,2023.7.21 03:00,78,112,33,223,0
교대→연산교차로,2023.7.21 04:00,71,0,103,174,0
부산시청→연산교차로,2023.7.21 04:00,159,63,56,278,0
사직운동장→연산교차로,2023.7.21 04:00,28,124,24,176,0
신리→연산교차로,2023.7.21 04:00,83,52,4,139,0
안락→연산교차로,2023.7.21 04:00,157,0,33,190,0
연산터널→연산교차로,2023.7.21 04:00,78,111,33,222,0
교대→연산교차로,2023.7.21 05:00,108,0,143,251,0
부산시청→연산교차로,2023.7.21 05:00,222,142,80,444,0
사직운동장→연산교차로,2023.7.21 05:00,55,205,34,294,0
신리→연산교차로,2023.7.21 05:00,208,83,11,302,0
안락→연산교차로,2023.7.21 05:00,334,0,63,397,0
연산터널→연산교차로,2023.7.21 05:00,101,158,30,289,0
교대→연산교차로,2023.7.21 06:00,160,0,221,381,0
부산시청→연산교차로,2023.7.21 06:00,349,253,132,734,0
사직운동장→연산교차로,2023.7.21 06:00,91,300,47,438,0
신리→연산교차로,2023.7.21 06:00,302,181,33,516,0
안락→연산교차로,2023.7.21 06:00,502,0,108,610,0
연산터널→연산교차로,2023.7.21 06:00,199,207,45,451,0
교대→연산교차로,2023.7.21 07:00,262,0,380,642,0
부산시청→연산교차로,2023.7.21 07:00,525,356,229,1110,0
사직운동장→연산교차로,2023.7.21 07:00,158,460,65,683,0
신리→연산교차로,2023.7.21 07:00,438,263,27,728,0
안락→연산교차로,2023.7.21 07:00,600,0,84,684,0
연산터널→연산교차로,2023.7.21 07:00,291,364,46,701,0
교대→연산교차로,2023.7.21 08:00,308,0,537,845,0
부산시청→연산교차로,2023.7.21 08:00,553,402,332,1287,0
사직운동장→연산교차로,2023.7.21 08:00,193,642,71,906,0
신리→연산교차로,2023.7.21 08:00,501,324,33,858,0
안락→연산교차로,2023.7.21 08:00,635,0,127,762,0
연산터널→연산교차로,2023.7.21 08:00,288,391,44,723,0
교대→연산교차로,2023.7.21 09:00,282,0,486,768,0
부산시청→연산교차로,2023.7.21 09:00,529,387,297,1213,0
사직운동장→연산교차로,2023.7.21 09:00,186,585,88,859,0
신리→연산교차로,2023.7.21 09:00,486,340,55,881,0
안락→연산교차로,2023.7.21 09:00,571,0,117,688,0
연산터널→연산교차로,2023.7.21 09:00,298,360,47,705,0
교대→연산교차로,2023.7.21 10:00,297,0,477,774,0
부산시청→연산교차로,2023.7.21 10:00,547,379,265,1191,0
사직운동장→연산교차로,2023.7.21 10:00,200,597,67,864,0
신리→연산교차로,2023.7.21 10:00,485,292,61,838,0
안락→연산교차로,2023.7.21 10:00,531,0,156,687,0
연산터널→연산교차로,2023.7.21 10:00,287,336,55,678,0
교대→연산교차로,2023.7.21 11:00,295,0,477,772,0
부산시청→연산교차로,2023.7.21 11:00,571,369,284,1224,0
사직운동장→연산교차로,2023.7.21 11:00,180,583,56,819,0
신리→연산교차로,2023.7.21 11:00,469,276,72,817,0
안락→연산교차로,2023.7.21 11:00,530,0,144,674,0
연산터널→연산교차로,2023.7.21 11:00,297,327,63,687,0
교대→연산교차로,2023.7.21 12:00,279,0,437,716,0
부산시청→연산교차로,2023.7.21 12:00,589,380,290,1259,0
사직운동장→연산교차로,2023.7.21 12:00,188,593,74,855,0
신리→연산교차로,2023.7.21 12:00,459,277,76,812,0
안락→연산교차로,2023.7.21 12:00,458,0,164,622,0
연산터널→연산교차로,2023.7.21 12:00,296,292,51,639,0
교대→연산교차로,2023.7.21 13:00,355,0,465,820,0
부산시청→연산교차로,2023.7.21 13:00,625,481,283,1389,0
사직운동장→연산교차로,2023.7.21 13:00,195,579,85,859,0
신리→연산교차로,2023.7.21 13:00,458,273,72,803,0
안락→연산교차로,2023.7.21 13:00,431,0,113,544,0
연산터널→연산교차로,2023.7.21 13:00,229,286,38,553,0
교대→연산교차로,2023.7.21 14:00,356,0,522,878,0
부산시청→연산교차로,2023.7.21 14:00,579,446,312,1337,0
사직운동장→연산교차로,2023.7.21 14:00,205,635,83,923,0
신리→연산교차로,2023.7.21 14:00,488,288,65,841,0
안락→연산교차로,2023.7.21 14:00,431,0,101,532,0
연산터널→연산교차로,2023.7.21 14:00,230,277,44,551,0
교대→연산교차로,2023.7.21 15:00,357,0,488,845,0
부산시청→연산교차로,2023.7.21 15:00,596,473,315,1384,0
사직운동장→연산교차로,2023.7.21 15:00,224,706,83,1013,0
신리→연산교차로,2023.7.21 15:00,471,290,65,826,0
안락→연산교차로,2023.7.21 15:00,432,0,125,557,0
연산터널→연산교차로,2023.7.21 15:00,227,293,49,569,0
교대→연산교차로,2023.7.21 16:00,354,0,503,857,0
부산시청→연산교차로,2023.7.21 16:00,632,537,331,1500,0
사직운동장→연산교차로,2023.7.21 16:00,220,701,32,953,0
신리→연산교차로,2023.7.21 16:00,506,301,48,855,0
안락→연산교차로,2023.7.21 16:00,431,0,126,557,0
연산터널→연산교차로,2023.7.21 16:00,228,276,43,547,0
교대→연산교차로,2023.7.21 17:00,373,0,563,936,0
부산시청→연산교차로,2023.7.21 17:00,631,551,309,1491,0
사직운동장→연산교차로,2023.7.21 17:00,226,702,58,986,0
신리→연산교차로,2023.7.21 17:00,566,305,47,918,0
안락→연산교차로,2023.7.21 17:00,457,0,105,562,0
연산터널→연산교차로,2023.7.21 17:00,243,277,37,557,0
교대→연산교차로,2023.7.21 18:00,360,0,569,929,0
부산시청→연산교차로,2023.7.21 18:00,664,550,334,1548,0
사직운동장→연산교차로,2023.7.21 18:00,256,670,64,990,0
신리→연산교차로,2023.7.21 18:00,486,242,53,781,0
안락→연산교차로,2023.7.21 18:00,461,0,120,581,0
연산터널→연산교차로,2023.7.21 18:00,238,277,50,565,0
교대→연산교차로,2023.7.21 19:00,346,0,423,769,0
부산시청→연산교차로,2023.7.21 19:00,529,419,314,1262,0
사직운동장→연산교차로,2023.7.21 19:00,213,625,58,896,0
신리→연산교차로,2023.7.21 19:00,409,246,48,703,0
안락→연산교차로,2023.7.21 19:00,428,0,103,531,0
연산터널→연산교차로,2023.7.21 19:00,225,250,51,526,0
교대→연산교차로,2023.7.21 20:00,342,0,391,733,0
부산시청→연산교차로,2023.7.21 20:00,500,354,238,1092,0
사직운동장→연산교차로,2023.7.21 20:00,180,570,109,859,0
신리→연산교차로,2023.7.21 20:00,346,197,32,575,0
안락→연산교차로,2023.7.21 20:00,416,0,118,534,0
연산터널→연산교차로,2023.7.21 20:00,210,275,74,559,0
교대→연산교차로,2023.7.21 21:00,318,0,386,704,0
부산시청→연산교차로,2023.7.21 21:00,509,324,214,1047,0
사직운동장→연산교차로,2023.7.21 21:00,239,473,61,773,0
신리→연산교차로,2023.7.21 21:00,339,214,27,580,0
안락→연산교차로,2023.7.21 21:00,440,0,118,558,0
연산터널→연산교차로,2023.7.21 21:00,236,275,63,574,0
교대→연산교차로,2023.7.21 22:00,284,0,303,587,0
부산시청→연산교차로,2023.7.21 22:00,456,313,193,962,0
사직운동장→연산교차로,2023.7.21 22:00,176,441,83,700,0
신리→연산교차로,2023.7.21 22:00,318,160,19,497,0
안락→연산교차로,2023.7.21 22:00,342,0,119,461,0
연산터널→연산교차로,2023.7.21 22:00,215,259,67,541,0
교대→연산교차로,2023.7.21 23:00,220,0,251,471,0
부산시청→연산교차로,2023.7.21 23:00,347,279,118,744,0
사직운동장→연산교차로,2023.7.21 23:00,120,305,98,523,0
신리→연산교차로,2023.7.21 23:00,251,152,23,426,0
안락→연산교차로,2023.7.21 23:00,330,0,99,429,0
연산터널→연산교차로,2023.7.21 23:00,186,198,47,431,0
교대→연산교차로,2023.7.22 00:00,198,0,249,447,0
부산시청→연산교차로,2023.7.22 00:00,310,204,129,643,0
사직운동장→연산교차로,2023.7.22 00:00,86,280,84,450,0
신리→연산교차로,2023.7.22 00:00,216,128,14,358,0
안락→연산교차로,2023.7.22 00:00,258,0,91,349,0
연산터널→연산교차로,2023.7.22 00:00,163,205,60,428,0
교대→연산교차로,2023.7.22 01:00,147,0,265,412,0
부산시청→연산교차로,2023.7.22 01:00,274,165,108,547,0
사직운동장→연산교차로,2023.7.22 01:00,73,215,59,347,0
신리→연산교차로,2023.7.22 01:00,176,95,19,290,0
안락→연산교차로,2023.7.22 01:00,202,0,76,278,0
연산터널→연산교차로,2023.7.22 01:00,114,167,50,331,0
교대→연산교차로,2023.7.22 02:00,119,0,224,343,0
부산시청→연산교차로,2023.7.22 02:00,255,135,90,480,0
사직운동장→연산교차로,2023.7.22 02:00,65,214,46,325,0
신리→연산교차로,2023.7.22 02:00,119,92,17,228,0
안락→연산교차로,2023.7.22 02:00,209,0,52,261,0
연산터널→연산교차로,2023.7.22 02:00,140,189,54,383,0
교대→연산교차로,2023.7.22 03:00,98,0,166,264,0
부산시청→연산교차로,2023.7.22 03:00,202,104,82,388,0
사직운동장→연산교차로,2023.7.22 03:00,65,177,47,289,0
신리→연산교차로,2023.7.22 03:00,118,71,16,205,0
안락→연산교차로,2023.7.22 03:00,146,0,32,178,0
연산터널→연산교차로,2023.7.22 03:00,124,148,55,327,0
교대→연산교차로,2023.7.22 04:00,93,0,124,217,0
부산시청→연산교차로,2023.7.22 04:00,210,99,60,369,0
사직운동장→연산교차로,2023.7.22 04:00,46,133,34,213,0
신리→연산교차로,2023.7.22 04:00,103,64,15,182,0
안락→연산교차로,2023.7.22 04:00,215,0,51,266,0
연산터널→연산교차로,2023.7.22 04:00,81,132,25,238,0
교대→연산교차로,2023.7.22 05:00,100,0,152,252,0
부산시청→연산교차로,2023.7.22 05:00,247,160,94,501,0
사직운동장→연산교차로,2023.7.22 05:00,62,174,51,287,0
신리→연산교차로,2023.7.22 05:00,198,85,14,297,0
안락→연산교차로,2023.7.22 05:00,278,0,70,348,0
연산터널→연산교차로,2023.7.22 05:00,104,126,31,261,0
교대→연산교차로,2023.7.22 06:00,149,0,177,326,0
부산시청→연산교차로,2023.7.22 06:00,318,197,118,633,0
사직운동장→연산교차로,2023.7.22 06:00,84,231,44,359,0
신리→연산교차로,2023.7.22 06:00,250,172,16,438,0
안락→연산교차로,2023.7.22 06:00,384,0,83,467,0
연산터널→연산교차로,2023.7.22 06:00,184,155,36,375,0
교대→연산교차로,2023.7.22 07:00,183,0,198,381,0
부산시청→연산교차로,2023.7.22 07:00,385,233,146,764,0
사직운동장→연산교차로,2023.7.22 07:00,106,306,54,466,0
신리→연산교차로,2023.7.22 07:00,255,154,33,442,0
안락→연산교차로,2023.7.22 07:00,433,0,89,522,0
연산터널→연산교차로,2023.7.22 07:00,187,205,55,447,0
교대→연산교차로,2023.7.22 08:00,263,0,298,561,0
부산시청→연산교차로,2023.7.22 08:00,454,322,200,976,0
사직운동장→연산교차로,2023.7.22 08:00,170,500,56,726,0
신리→연산교차로,2023.7.22 08:00,420,231,36,687,0
안락→연산교차로,2023.7.22 08:00,498,0,119,617,0
연산터널→연산교차로,2023.7.22 08:00,234,276,59,569,0
교대→연산교차로,2023.7.22 09:00,269,0,392,661,0
부산시청→연산교차로,2023.7.22 09:00,488,327,270,1085,0
사직운동장→연산교차로,2023.7.22 09:00,182,568,59,809,0
신리→연산교차로,2023.7.22 09:00,445,265,79,789,0
안락→연산교차로,2023.7.22 09:00,579,0,138,717,0
연산터널→연산교차로,2023.7.22 09:00,298,312,56,666,0
교대→연산교차로,2023.7.22 10:00,303,0,476,779,0
부산시청→연산교차로,2023.7.22 10:00,579,372,290,1241,0
사직운동장→연산교차로,2023.7.22 10:00,195,631,60,886,0
신리→연산교차로,2023.7.22 10:00,497,293,73,863,0
안락→연산교차로,2023.7.22 10:00,539,0,128,667,0
연산터널→연산교차로,2023.7.22 10:00,307,365,57,729,0
교대→연산교차로,2023.7.22 11:00,305,0,499,804,0
부산시청→연산교차로,2023.7.22 11:00,608,384,318,1310,0
사직운동장→연산교차로,2023.7.22 11:00,192,606,60,858,0
신리→연산교차로,2023.7.22 11:00,464,272,75,811,0
안락→연산교차로,2023.7.22 11:00,551,0,175,726,0
연산터널→연산교차로,2023.7.22 11:00,278,287,40,605,0
교대→연산교차로,2023.7.22 12:00,324,0,447,771,0
부산시청→연산교차로,2023.7.22 12:00,605,380,314,1299,0
사직운동장→연산교차로,2023.7.22 12:00,199,626,43,868,0
신리→연산교차로,2023.7.22 12:00,476,293,83,852,0
안락→연산교차로,2023.7.22 12:00,579,0,182,761,0
연산터널→연산교차로,2023.7.22 12:00,304,353,61,718,0
교대→연산교차로,2023.7.22 13:00,355,0,428,783,0
부산시청→연산교차로,2023.7.22 13:00,628,499,332,1459,0
사직운동장→연산교차로,2023.7.22 13:00,223,684,57,964,0
신리→연산교차로,2023.7.22 13:00,480,289,73,842,0
안락→연산교차로,2023.7.22 13:00,457,0,157,614,0
연산터널→연산교차로,2023.7.22 13:00,228,291,54,573,0
교대→연산교차로,2023.7.22 14:00,349,0,432,781,0
부산시청→연산교차로,2023.7.22 14:00,590,485,320,1395,0
사직운동장→연산교차로,2023.7.22 14:00,218,664,41,923,0
신리→연산교차로,2023.7.22 14:00,439,298,74,811,0
안락→연산교차로,2023.7.22 14:00,437,0,112,549,0
연산터널→연산교차로,2023.7.22 14:00,264,274,45,583,0
교대→연산교차로,2023.7.22 15:00,357,0,411,768,0
부산시청→연산교차로,2023.7.22 15:00,657,476,325,1458,0
사직운동장→연산교차로,2023.7.22 15:00,218,648,53,919,0
신리→연산교차로,2023.7.22 15:00,455,271,62,788,0
안락→연산교차로,2023.7.22 15:00,454,0,104,558,0
연산터널→연산교차로,2023.7.22 15:00,228,280,58,566,0
교대→연산교차로,2023.7.22 16:00,347,0,406,753,0
부산시청→연산교차로,2023.7.22 16:00,647,478,299,1424,0
사직운동장→연산교차로,2023.7.22 16:00,233,658,59,950,0
신리→연산교차로,2023.7.22 16:00,478,323,56,857,0
안락→연산교차로,2023.7.22 16:00,462,0,102,564,0
연산터널→연산교차로,2023.7.22 16:00,240,280,32,552,0
교대→연산교차로,2023.7.22 17:00,345,0,388,733,0
부산시청→연산교차로,2023.7.22 17:00,618,465,303,1386,0
사직운동장→연산교차로,2023.7.22 17:00,215,650,72,937,0
신리→연산교차로,2023.7.22 17:00,447,314,46,807,0
안락→연산교차로,2023.7.22 17:00,462,0,109,571,0
연산터널→연산교차로,2023.7.22 17:00,249,277,54,580,0
교대→연산교차로,2023.7.22 18:00,341,0,389,730,0
부산시청→연산교차로,2023.7.22 18:00,571,414,259,1244,0
사직운동장→연산교차로,2023.7.22 18:00,201,597,61,859,0
신리→연산교차로,2023.7.22 18:00,397,262,42,701,0
안락→연산교차로,2023.7.22 18:00,456,0,102,558,0
연산터널→연산교차로,2023.7.22 18:00,253,274,56,583,0
교대→연산교차로,2023.7.22 19:00,270,0,359,629,0
부산시청→연산교차로,2023.7.22 19:00,506,346,234,1086,0
사직운동장→연산교차로,2023.7.22 19:00,170,479,82,731,0
신리→연산교차로,2023.7.22 19:00,331,196,35,562,0
안락→연산교차로,2023.7.22 19:00,381,0,138,519,0
연산터널→연산교차로,2023.7.22 19:00,214,269,74,557,0
교대→연산교차로,2023.7.22 20:00,304,0,313,617,0
부산시청→연산교차로,2023.7.22 20:00,461,332,226,1019,0
사직운동장→연산교차로,2023.7.22 20:00,165,469,80,714,0
신리→연산교차로,2023.7.22 20:00,359,196,25,580,0
안락→연산교차로,2023.7.22 20:00,425,0,99,524,0
연산터널→연산교차로,2023.7.22 20:00,209,275,53,537,0
교대→연산교차로,2023.7.22 21:00,284,0,305,589,0
부산시청→연산교차로,2023.7.22 21:00,465,333,182,980,0
사직운동장→연산교차로,2023.7.22 21:00,150,426,83,659,0
신리→연산교차로,2023.7.22 21:00,342,219,24,585,0
안락→연산교차로,2023.7.22 21:00,412,0,120,532,0
연산터널→연산교차로,2023.7.22 21:00,251,270,63,584,0
교대→연산교차로,2023.7.22 22:00,260,0,241,501,0
부산시청→연산교차로,2023.7.22 22:00,412,291,185,888,0
사직운동장→연산교차로,2023.7.22 22:00,200,457,52,709,0
신리→연산교차로,2023.7.22 22:00,322,176,20,518,0
안락→연산교차로,2023.7.22 22:00,319,0,112,431,0
연산터널→연산교차로,2023.7.22 22:00,203,241,62,506,0
교대→연산교차로,2023.7.22 23:00,188,0,207,395,0
부산시청→연산교차로,2023.7.22 23:00,363,205,129,697,0
사직운동장→연산교차로,2023.7.22 23:00,111,331,76,518,0
신리→연산교차로,2023.7.22 23:00,258,136,22,416,0
안락→연산교차로,2023.7.22 23:00,273,0,88,361,0
연산터널→연산교차로,2023.7.22 23:00,182,212,44,438,0
교대→연산교차로,2023.7.23 00:00,178,0,243,421,1
부산시청→연산교차로,2023.7.23 00:00,303,214,114,631,1
사직운동장→연산교차로,2023.7.23 00:00,84,281,68,433,1
신리→연산교차로,2023.7.23 00:00,221,114,11,346,1
안락→연산교차로,2023.7.23 00:00,261,0,72,333,1
연산터널→연산교차로,2023.7.23 00:00,136,186,50,372,1
교대→연산교차로,2023.7.23 01:00,142,0,205,347,1
부산시청→연산교차로,2023.7.23 01:00,277,165,102,544,1
사직운동장→연산교차로,2023.7.23 01:00,56,186,48,290,1
신리→연산교차로,2023.7.23 01:00,167,87,12,266,1
안락→연산교차로,2023.7.23 01:00,204,0,49,253,1
연산터널→연산교차로,2023.7.23 01:00,115,181,52,348,1
교대→연산교차로,2023.7.23 02:00,96,0,180,276,1
부산시청→연산교차로,2023.7.23 02:00,234,134,84,452,1
사직운동장→연산교차로,2023.7.23 02:00,64,154,39,257,1
신리→연산교차로,2023.7.23 02:00,129,67,13,209,1
안락→연산교차로,2023.7.23 02:00,172,0,53,225,1
연산터널→연산교차로,2023.7.23 02:00,93,135,44,272,1
교대→연산교차로,2023.7.23 03:00,87,0,140,227,1
부산시청→연산교차로,2023.7.23 03:00,191,100,62,353,1
사직운동장→연산교차로,2023.7.23 03:00,43,150,35,228,1
신리→연산교차로,2023.7.23 03:00,101,63,10,174,1
안락→연산교차로,2023.7.23 03:00,136,0,39,175,1
연산터널→연산교차로,2023.7.23 03:00,100,129,39,268,1
교대→연산교차로,2023.7.23 04:00,70,0,105,175,1
부산시청→연산교차로,2023.7.23 04:00,135,73,57,265,1
사직운동장→연산교차로,2023.7.23 04:00,37,119,23,179,1
신리→연산교차로,2023.7.23 04:00,83,49,4,136,1
안락→연산교차로,2023.7.23 04:00,115,0,21,136,1
연산터널→연산교차로,2023.7.23 04:00,80,86,20,186,1
교대→연산교차로,2023.7.23 05:00,65,0,102,167,1
부산시청→연산교차로,2023.7.23 05:00,169,90,46,305,1
사직운동장→연산교차로,2023.7.23 05:00,28,134,34,196,1
신리→연산교차로,2023.7.23 05:00,104,69,4,177,1
안락→연산교차로,2023.7.23 05:00,166,0,44,210,1
연산터널→연산교차로,2023.7.23 05:00,83,113,25,221,1
교대→연산교차로,2023.7.23 06:00,94,0,104,198,1
부산시청→연산교차로,2023.7.23 06:00,200,122,60,382,1
사직운동장→연산교차로,2023.7.23 06:00,48,150,37,235,1
신리→연산교차로,2023.7.23 06:00,152,74,7,233,1
안락→연산교차로,2023.7.23 06:00,231,0,41,272,1
연산터널→연산교차로,2023.7.23 06:00,132,123,38,293,1
교대→연산교차로,2023.7.23 07:00,133,0,132,265,1
부산시청→연산교차로,2023.7.23 07:00,248,157,82,487,1
사직운동장→연산교차로,2023.7.23 07:00,55,210,32,297,1
신리→연산교차로,2023.7.23 07:00,187,79,19,285,1
안락→연산교차로,2023.7.23 07:00,244,0,51,295,1
연산터널→연산교차로,2023.7.23 07:00,126,119,33,278,1
교대→연산교차로,2023.7.23 08:00,171,0,165,336,1
부산시청→연산교차로,2023.7.23 08:00,284,203,129,616,1
사직운동장→연산교차로,2023.7.23 08:00,107,296,44,447,1
신리→연산교차로,2023.7.23 08:00,261,117,25,403,1
안락→연산교차로,2023.7.23 08:00,333,0,76,409,1
연산터널→연산교차로,2023.7.23 08:00,185,166,29,380,1
교대→연산교차로,2023.7.23 09:00,231,0,233,464,1
부산시청→연산교차로,2023.7.23 09:00,370,273,172,815,1
사직운동장→연산교차로,2023.7.23 09:00,133,374,36,543,1
신리→연산교차로,2023.7.23 09:00,357,201,17,575,1
안락→연산교차로,2023.7.23 09:00,428,0,107,535,1
연산터널→연산교차로,2023.7.23 09:00,259,231,28,518,1
교대→연산교차로,2023.7.23 10:00,275,0,274,549,1
부산시청→연산교차로,2023.7.23 10:00,422,298,198,918,1
사직운동장→연산교차로,2023.7.23 10:00,170,518,57,745,1
신리→연산교차로,2023.7.23 10:00,373,208,31,612,1
안락→연산교차로,2023.7.23 10:00,491,0,106,597,1
연산터널→연산교차로,2023.7.23 10:00,233,271,54,558,1
교대→연산교차로,2023.7.23 11:00,257,0,274,531,1
부산시청→연산교차로,2023.7.23 11:00,465,324,188,977,1
사직운동장→연산교차로,2023.7.23 11:00,176,546,45,767,1
신리→연산교차로,2023.7.23 11:00,416,237,42,695,1
안락→연산교차로,2023.7.23 11:00,421,0,144,565,1
연산터널→연산교차로,2023.7.23 11:00,250,261,45,556,1
교대→연산교차로,2023.7.23 12:00,276,0,303,579,1
부산시청→연산교차로,2023.7.23 12:00,537,350,215,1102,1
사직운동장→연산교차로,2023.7.23 12:00,191,569,49,809,1
신리→연산교차로,2023.7.23 12:00,461,243,36,740,1
안락→연산교차로,2023.7.23 12:00,481,0,142,623,1
연산터널→연산교차로,2023.7.23 12:00,259,252,50,561,1
교대→연산교차로,2023.7.23 13:00,300,0,329,629,1
부산시청→연산교차로,2023.7.23 13:00,505,345,224,1074,1
사직운동장→연산교차로,2023.7.23 13:00,185,578,43,806,1
신리→연산교차로,2023.7.23 13:00,407,223,53,683,1
안락→연산교차로,2023.7.23 13:00,494,0,125,619,1
연산터널→연산교차로,2023.7.23 13:00,269,252,40,561,1
교대→연산교차로,2023.7.23 14:00,306,0,297,603,1
부산시청→연산교차로,2023.7.23 14:00,491,331,220,1042,1
사직운동장→연산교차로,2023.7.23 14:00,194,578,57,829,1
신리→연산교차로,2023.7.23 14:00,412,225,51,688,1
안락→연산교차로,2023.7.23 14:00,501,0,139,640,1
연산터널→연산교차로,2023.7.23 14:00,271,262,60,593,1
교대→연산교차로,2023.7.23 15:00,286,0,325,611,1
부산시청→연산교차로,2023.7.23 15:00,465,317,251,1033,1
사직운동장→연산교차로,2023.7.23 15:00,180,555,58,793,1
신리→연산교차로,2023.7.23 15:00,459,258,47,764,1
안락→연산교차로,2023.7.23 15:00,531,0,198,729,1
연산터널→연산교차로,2023.7.23 15:00,280,264,40,584,1
교대→연산교차로,2023.7.23 16:00,294,0,319,613,1
부산시청→연산교차로,2023.7.23 16:00,511,366,219,1096,1
사직운동장→연산교차로,2023.7.23 16:00,184,543,57,784,1
신리→연산교차로,2023.7.23 16:00,406,299,32,737,1
안락→연산교차로,2023.7.23 16:00,528,0,148,676,1
연산터널→연산교차로,2023.7.23 16:00,230,291,58,579,1
교대→연산교차로,2023.7.23 17:00,306,0,322,628,1
부산시청→연산교차로,2023.7.23 17:00,445,329,223,997,1
사직운동장→연산교차로,2023.7.23 17:00,184,556,51,791,1
신리→연산교차로,2023.7.23 17:00,384,215,39,638,1
안락→연산교차로,2023.7.23 17:00,521,0,162,683,1
연산터널→연산교차로,2023.7.23 17:00,262,268,65,595,1
교대→연산교차로,2023.7.23 18:00,285,0,303,588,1
부산시청→연산교차로,2023.7.23 18:00,443,293,186,922,1
사직운동장→연산교차로,2023.7.23 18:00,161,434,78,673,1
신리→연산교차로,2023.7.23 18:00,357,194,35,586,1
안락→연산교차로,2023.7.23 18:00,452,0,140,592,1
연산터널→연산교차로,2023.7.23 18:00,230,241,59,530,1
교대→연산교차로,2023.7.23 19:00,255,0,289,544,1
부산시청→연산교차로,2023.7.23 19:00,392,237,154,783,1
사직운동장→연산교차로,2023.7.23 19:00,160,448,52,660,1
신리→연산교차로,2023.7.23 19:00,307,194,42,543,1
안락→연산교차로,2023.7.23 19:00,377,0,126,503,1
연산터널→연산교차로,2023.7.23 19:00,220,203,49,472,1
교대→연산교차로,2023.7.23 20:00,265,0,218,483,1
부산시청→연산교차로,2023.7.23 20:00,359,244,153,756,1
사직운동장→연산교차로,2023.7.23 20:00,157,412,47,616,1
신리→연산교차로,2023.7.23 20:00,291,148,21,460,1
안락→연산교차로,2023.7.23 20:00,348,0,87,435,1
연산터널→연산교차로,2023.7.23 20:00,193,212,44,449,1
교대→연산교차로,2023.7.23 21:00,227,0,201,428,1
부산시청→연산교차로,2023.7.23 21:00,354,222,125,701,1
사직운동장→연산교차로,2023.7.23 21:00,115,308,55,478,1
신리→연산교차로,2023.7.23 21:00,281,156,17,454,1
안락→연산교차로,2023.7.23 21:00,339,0,102,441,1
연산터널→연산교차로,2023.7.23 21:00,161,188,41,390,1
교대→연산교차로,2023.7.23 22:00,178,0,171,349,1
부산시청→연산교차로,2023.7.23 22:00,315,198,115,628,1
사직운동장→연산교차로,2023.7.23 22:00,101,286,49,436,1
신리→연산교차로,2023.7.23 22:00,233,119,23,375,1
안락→연산교차로,2023.7.23 22:00,274,0,71,345,1
연산터널→연산교차로,2023.7.23 22:00,154,176,54,384,1
교대→연산교차로,2023.7.23 23:00,141,0,139,280,1
부산시청→연산교차로,2023.7.23 23:00,220,138,93,451,1
사직운동장→연산교차로,2023.7.23 23:00,122,246,34,402,1
신리→연산교차로,2023.7.23 23:00,169,110,20,299,1
안락→연산교차로,2023.7.23 23:00,177,0,47,224,1
연산터널→연산교차로,2023.7.23 23:00,124,136,59,319,1
교대→연산교차로,2023.7.24 00:00,94,0,120,214,0
부산시청→연산교차로,2023.7.24 00:00,203,105,82,390,0
사직운동장→연산교차로,2023.7.24 00:00,74,189,29,292,0
신리→연산교차로,2023.7.24 00:00,140,58,17,215,0
안락→연산교차로,2023.7.24 00:00,147,0,41,188,0
연산터널→연산교차로,2023.7.24 00:00,102,105,67,274,0
교대→연산교차로,2023.7.24 01:00,62,0,126,188,0
부산시청→연산교차로,2023.7.24 01:00,136,79,50,265,0
사직운동장→연산교차로,2023.7.24 01:00,24,126,30,180,0
신리→연산교차로,2023.7.24 01:00,77,42,14,133,0
안락→연산교차로,2023.7.24 01:00,116,0,37,153,0
연산터널→연산교차로,2023.7.24 01:00,79,91,51,221,0
교대→연산교차로,2023.7.24 02:00,52,0,92,144,0
부산시청→연산교차로,2023.7.24 02:00,121,65,41,227,0
사직운동장→연산교차로,2023.7.24 02:00,29,116,17,162,0
신리→연산교차로,2023.7.24 02:00,78,23,7,108,0
안락→연산교차로,2023.7.24 02:00,96,0,26,122,0
연산터널→연산교차로,2023.7.24 02:00,49,79,36,164,0
교대→연산교차로,2023.7.24 03:00,42,0,66,108,0
부산시청→연산교차로,2023.7.24 03:00,121,68,42,231,0
사직운동장→연산교차로,2023.7.24 03:00,22,91,6,119,0
신리→연산교차로,2023.7.24 03:00,54,36,5,95,0
안락→연산교차로,2023.7.24 03:00,100,0,23,123,0
연산터널→연산교차로,2023.7.24 03:00,63,88,30,181,0
교대→연산교차로,2023.7.24 04:00,46,0,67,113,0
부산시청→연산교차로,2023.7.24 04:00,119,65,37,221,0
사직운동장→연산교차로,2023.7.24 04:00,25,81,13,119,0
신리→연산교차로,2023.7.24 04:00,87,44,4,135,0
안락→연산교차로,2023.7.24 04:00,152,0,32,184,0
연산터널→연산교차로,2023.7.24 04:00,67,89,15,171,0
교대→연산교차로,2023.7.24 05:00,79,0,120,199,0
부산시청→연산교차로,2023.7.24 05:00,213,157,76,446,0
사직운동장→연산교차로,2023.7.24 05:00,52,151,20,223,0
신리→연산교차로,2023.7.24 05:00,201,84,7,292,0
안락→연산교차로,2023.7.24 05:00,295,0,64,359,0
연산터널→연산교차로,2023.7.24 05:00,115,125,17,257,0
교대→연산교차로,2023.7.24 06:00,152,0,200,352,0
부산시청→연산교차로,2023.7.24 06:00,342,249,105,696,0
사직운동장→연산교차로,2023.7.24 06:00,82,276,46,404,0
신리→연산교차로,2023.7.24 06:00,339,180,24,543,0
안락→연산교차로,2023.7.24 06:00,465,0,101,566,0
연산터널→연산교차로,2023.7.24 06:00,232,228,38,498,0
교대→연산교차로,2023.7.24 07:00,252,0,408,660,0
부산시청→연산교차로,2023.7.24 07:00,517,352,209,1078,0
사직운동장→연산교차로,2023.7.24 07:00,178,462,62,702,0
신리→연산교차로,2023.7.24 07:00,460,277,22,759,0
안락→연산교차로,2023.7.24 07:00,613,0,80,693,0
연산터널→연산교차로,2023.7.24 07:00,268,345,48,661,0
교대→연산교차로,2023.7.24 08:00,284,0,493,777,0
부산시청→연산교차로,2023.7.24 08:00,548,404,285,1237,0
사직운동장→연산교차로,2023.7.24 08:00,193,625,74,892,0
신리→연산교차로,2023.7.24 08:00,474,340,29,843,0
안락→연산교차로,2023.7.24 08:00,581,0,125,706,0
연산터널→연산교차로,2023.7.24 08:00,317,375,31,723,0
교대→연산교차로,2023.7.24 09:00,293,0,528,821,0
부산시청→연산교차로,2023.7.24 09:00,522,393,303,1218,0
사직운동장→연산교차로,2023.7.24 09:00,190,587,91,868,0
신리→연산교차로,2023.7.24 09:00,483,322,48,853,0
안락→연산교차로,2023.7.24 09:00,551,0,112,663,0
연산터널→연산교차로,2023.7.24 09:00,298,368,39,705,0
교대→연산교차로,2023.7.24 10:00,302,0,441,743,0
부산시청→연산교차로,2023.7.24 10:00,579,364,292,1235,0
사직운동장→연산교차로,2023.7.24 10:00,210,581,78,869,0
신리→연산교차로,2023.7.24 10:00,441,279,70,790,0
안락→연산교차로,2023.7.24 10:00,560,0,135,695,0
연산터널→연산교차로,2023.7.24 10:00,294,356,57,707,0
교대→연산교차로,2023.7.24 11:00,300,0,513,813,0
부산시청→연산교차로,2023.7.24 11:00,564,363,274,1201,0
사직운동장→연산교차로,2023.7.24 11:00,212,593,79,884,0
신리→연산교차로,2023.7.24 11:00,468,296,62,826,0
안락→연산교차로,2023.7.24 11:00,529,0,193,722,0
연산터널→연산교차로,2023.7.24 11:00,304,310,47,661,0
교대→연산교차로,2023.7.24 12:00,282,0,430,712,0
부산시청→연산교차로,2023.7.24 12:00,521,358,271,1150,0
사직운동장→연산교차로,2023.7.24 12:00,176,538,60,774,0
신리→연산교차로,2023.7.24 12:00,427,240,69,736,0
안락→연산교차로,2023.7.24 12:00,434,0,166,600,0
연산터널→연산교차로,2023.7.24 12:00,300,265,47,612,0
교대→연산교차로,2023.7.24 13:00,342,0,492,834,0
부산시청→연산교차로,2023.7.24 13:00,590,465,237,1292,0
사직운동장→연산교차로,2023.7.24 13:00,210,605,83,898,0
신리→연산교차로,2023.7.24 13:00,412,271,87,770,0
안락→연산교차로,2023.7.24 13:00,447,0,123,570,0
연산터널→연산교차로,2023.7.24 13:00,237,288,37,562,0
교대→연산교차로,2023.7.24 14:00,326,0,521,847,0
부산시청→연산교차로,2023.7.24 14:00,550,462,297,1309,0
사직운동장→연산교차로,2023.7.24 14:00,227,585,83,895,0
신리→연산교차로,2023.7.24 14:00,480,285,69,834,0
안락→연산교차로,2023.7.24 14:00,427,0,115,542,0
연산터널→연산교차로,2023.7.24 14:00,249,267,43,559,0
교대→연산교차로,2023.7.24 15:00,346,0,539,885,0
부산시청→연산교차로,2023.7.24 15:00,574,507,299,1380,0
사직운동장→연산교차로,2023.7.24 15:00,214,650,85,949,0
신리→연산교차로,2023.7.24 15:00,416,289,61,766,0
안락→연산교차로,2023.7.24 15:00,414,0,116,530,0
연산터널→연산교차로,2023.7.24 15:00,239,279,43,561,0
교대→연산교차로,2023.7.24 16:00,350,0,564,914,0
부산시청→연산교차로,2023.7.24 16:00,592,539,318,1449,0
사직운동장→연산교차로,2023.7.24 16:00,212,667,78,957,0
신리→연산교차로,2023.7.24 16:00,484,282,64,830,0
안락→연산교차로,2023.7.24 16:00,431,0,108,539,0
연산터널→연산교차로,2023.7.24 16:00,229,283,41,553,0
교대→연산교차로,2023.7.24 17:00,356,0,534,890,0
부산시청→연산교차로,2023.7.24 17:00,627,504,296,1427,0
사직운동장→연산교차로,2023.7.24 17:00,223,684,36,943,0
신리→연산교차로,2023.7.24 17:00,501,264,58,823,0
안락→연산교차로,2023.7.24 17:00,461,0,107,568,0
연산터널→연산교차로,2023.7.24 17:00,234,275,40,549,0
교대→연산교차로,2023.7.24 18:00,363,0,565,928,0
부산시청→연산교차로,2023.7.24 18:00,614,560,352,1526,0
사직운동장→연산교차로,2023.7.24 18:00,236,705,45,986,0
신리→연산교차로,2023.7.24 18:00,490,271,45,806,0
안락→연산교차로,2023.7.24 18:00,445,0,102,547,0
연산터널→연산교차로,2023.7.24 18:00,214,274,51,539,0
교대→연산교차로,2023.7.24 19:00,313,0,379,692,0
부산시청→연산교차로,2023.7.24 19:00,528,395,289,1212,0
사직운동장→연산교차로,2023.7.24 19:00,196,549,67,812,0
신리→연산교차로,2023.7.24 19:00,337,200,44,581,0
안락→연산교차로,2023.7.24 19:00,402,0,88,490,0
연산터널→연산교차로,2023.7.24 19:00,218,252,39,509,0
교대→연산교차로,2023.7.24 20:00,316,0,307,623,0
부산시청→연산교차로,2023.7.24 20:00,444,326,251,1021,0
사직운동장→연산교차로,2023.7.24 20:00,140,456,76,672,0
신리→연산교차로,2023.7.24 20:00,313,192,36,541,0
안락→연산교차로,2023.7.24 20:00,387,0,105,492,0
연산터널→연산교차로,2023.7.24 20:00,218,259,46,523,0
교대→연산교차로,2023.7.24 21:00,266,0,270,536,0
부산시청→연산교차로,2023.7.24 21:00,475,299,210,984,0
사직운동장→연산교차로,2023.7.24 21:00,154,429,84,667,0
신리→연산교차로,2023.7.24 21:00,277,172,27,476,0
안락→연산교차로,2023.7.24 21:00,362,0,100,462,0
연산터널→연산교차로,2023.7.24 21:00,213,264,62,539,0
교대→연산교차로,2023.7.24 22:00,197,0,227,424,0
부산시청→연산교차로,2023.7.24 22:00,386,231,132,749,0
사직운동장→연산교차로,2023.7.24 22:00,161,357,73,591,0
신리→연산교차로,2023.7.24 22:00,244,163,27,434,0
안락→연산교차로,2023.7.24 22:00,315,0,100,415,0
연산터널→연산교차로,2023.7.24 22:00,177,220,57,454,0
교대→연산교차로,2023.7.24 23:00,175,0,209,384,0
부산시청→연산교차로,2023.7.24 23:00,289,176,124,589,0
사직운동장→연산교차로,2023.7.24 23:00,101,271,62,434,0
신리→연산교차로,2023.7.24 23:00,167,129,32,328,0
안락→연산교차로,2023.7.24 23:00,212,0,79,291,0
연산터널→연산교차로,2023.7.24 23:00,147,190,77,414,0
교대→연산교차로,2023.7.25 00:00,127,0,170,297,0
부산시청→연산교차로,2023.7.25 00:00,236,132,87,455,0
사직운동장→연산교차로,2023.7.25 00:00,68,228,51,347,0
신리→연산교차로,2023.7.25 00:00,153,76,20,249,0
안락→연산교차로,2023.7.25 00:00,209,0,59,268,0
연산터널→연산교차로,2023.7.25 00:00,151,153,66,370,0
교대→연산교차로,2023.7.25 01:00,85,0,154,239,0
부산시청→연산교차로,2023.7.25 01:00,181,88,78,347,0
사직운동장→연산교차로,2023.7.25 01:00,53,176,33,262,0
신리→연산교차로,2023.7.25 01:00,93,57,18,168,0
안락→연산교차로,2023.7.25 01:00,139,0,44,183,0
연산터널→연산교차로,2023.7.25 01:00,118,120,49,287,0
교대→연산교차로,2023.7.25 02:00,75,0,117,192,0
부산시청→연산교차로,2023.7.25 02:00,158,79,68,305,0
사직운동장→연산교차로,2023.7.25 02:00,40,148,28,216,0
신리→연산교차로,2023.7.25 02:00,92,45,12,149,0
안락→연산교차로,2023.7.25 02:00,108,0,29,137,0
연산터널→연산교차로,2023.7.25 02:00,88,131,36,255,0
교대→연산교차로,2023.7.25 03:00,70,0,108,178,0
부산시청→연산교차로,2023.7.25 03:00,144,62,58,264,0
사직운동장→연산교차로,2023.7.25 03:00,31,108,27,166,0
신리→연산교차로,2023.7.25 03:00,73,44,16,133,0
안락→연산교차로,2023.7.25 03:00,94,0,30,124,0
연산터널→연산교차로,2023.7.25 03:00,76,98,49,223,0
교대→연산교차로,2023.7.25 04:00,48,0,85,133,0
부산시청→연산교차로,2023.7.25 04:00,143,81,55,279,0
사직운동장→연산교차로,2023.7.25 04:00,22,128,18,168,0
신리→연산교차로,2023.7.25 04:00,64,48,14,126,0
안락→연산교차로,2023.7.25 04:00,182,0,31,213,0
연산터널→연산교차로,2023.7.25 04:00,78,99,40,217,0
교대→연산교차로,2023.7.25 05:00,88,0,119,207,0
부산시청→연산교차로,2023.7.25 05:00,226,138,79,443,0
사직운동장→연산교차로,2023.7.25 05:00,56,184,39,279,0
신리→연산교차로,2023.7.25 05:00,227,86,20,333,0
안락→연산교차로,2023.7.25 05:00,312,0,58,370,0
연산터널→연산교차로,2023.7.25 05:00,136,143,30,309,0
교대→연산교차로,2023.7.25 06:00,185,0,191,376,0
부산시청→연산교차로,2023.7.25 06:00,341,231,121,693,0
사직운동장→연산교차로,2023.7.25 06:00,85,302,51,438,0
신리→연산교차로,2023.7.25 06:00,347,171,24,542,0
안락→연산교차로,2023.7.25 06:00,498,0,102,600,0
연산터널→연산교차로,2023.7.25 06:00,214,211,29,454,0
교대→연산교차로,2023.7.25 07:00,251,0,361,612,0
부산시청→연산교차로,2023.7.25 07:00,539,336,224,1099,0
사직운동장→연산교차로,2023.7.25 07:00,158,463,69,690,0
신리→연산교차로,2023.7.25 07:00,466,255,34,755,0
안락→연산교차로,2023.7.25 07:00,611,0,80,691,0
연산터널→연산교차로,2023.7.25 07:00,269,370,34,673,0
교대→연산교차로,2023.7.25 08:00,302,0,508,810,0
부산시청→연산교차로,2023.7.25 08:00,548,419,328,1295,0
사직운동장→연산교차로,2023.7.25 08:00,174,608,95,877,0
신리→연산교차로,2023.7.25 08:00,459,360,36,855,0
안락→연산교차로,2023.7.25 08:00,604,0,97,701,0
연산터널→연산교차로,2023.7.25 08:00,323,373,34,730,0
교대→연산교차로,2023.7.25 09:00,286,0,508,794,0
부산시청→연산교차로,2023.7.25 09:00,484,348,242,1074,0
사직운동장→연산교차로,2023.7.25 09:00,188,595,96,879,0
신리→연산교차로,2023.7.25 09:00,455,318,52,825,0
안락→연산교차로,2023.7.25 09:00,569,0,123,692,0
연산터널→연산교차로,2023.7.25 09:00,312,370,33,715,0
교대→연산교차로,2023.7.25 10:00,300,0,468,768,0
부산시청→연산교차로,2023.7.25 10:00,560,382,279,1221,0
사직운동장→연산교차로,2023.7.25 10:00,205,586,64,855,0
신리→연산교차로,2023.7.25 10:00,505,264,54,823,0
안락→연산교차로,2023.7.25 10:00,551,0,149,700,0
연산터널→연산교차로,2023.7.25 10:00,300,369,60,729,0
교대→연산교차로,2023.7.25 11:00,314,0,483,797,0
부산시청→연산교차로,2023.7.25 11:00,579,386,269,1234,0
사직운동장→연산교차로,2023.7.25 11:00,188,592,85,865,0
신리→연산교차로,2023.7.25 11:00,506,273,55,834,0
안락→연산교차로,2023.7.25 11:00,499,0,169,668,0
연산터널→연산교차로,2023.7.25 11:00,283,301,58,642,0
교대→연산교차로,2023.7.25 12:00,289,0,440,729,0
부산시청→연산교차로,2023.7.25 12:00,550,354,305,1209,0
사직운동장→연산교차로,2023.7.25 12:00,185,542,81,808,0
신리→연산교차로,2023.7.25 12:00,423,254,56,733,0
안락→연산교차로,2023.7.25 12:00,476,0,161,637,0
연산터널→연산교차로,2023.7.25 12:00,257,286,48,591,0
교대→연산교차로,2023.7.25 13:00,341,0,498,839,0
부산시청→연산교차로,2023.7.25 13:00,543,449,316,1308,0
사직운동장→연산교차로,2023.7.25 13:00,213,624,71,908,0
신리→연산교차로,2023.7.25 13:00,451,283,47,781,0
안락→연산교차로,2023.7.25 13:00,405,0,142,547,0
연산터널→연산교차로,2023.7.25 13:00,229,276,42,547,0
교대→연산교차로,2023.7.25 14:00,344,0,561,905,0
부산시청→연산교차로,2023.7.25 14:00,618,435,296,1349,0
사직운동장→연산교차로,2023.7.25 14:00,210,643,75,928,0
신리→연산교차로,2023.7.25 14:00,422,288,72,782,0
안락→연산교차로,2023.7.25 14:00,419,0,143,562,0
연산터널→연산교차로,2023.7.25 14:00,265,250,51,566,0
교대→연산교차로,2023.7.25 15:00,339,0,491,830,0
부산시청→연산교차로,2023.7.25 15:00,587,491,330,1408,0
사직운동장→연산교차로,2023.7.25 15:00,232,647,87,966,0
신리→연산교차로,2023.7.25 15:00,485,277,64,826,0
안락→연산교차로,2023.7.25 15:00,443,0,104,547,0
연산터널→연산교차로,2023.7.25 15:00,249,257,35,541,0
교대→연산교차로,2023.7.25 16:00,353,0,497,850,0
부산시청→연산교차로,2023.7.25 16:00,613,522,293,1428,0
사직운동장→연산교차로,2023.7.25 16:00,240,655,55,950,0
신리→연산교차로,2023.7.25 16:00,505,280,62,847,0
안락→연산교차로,2023.7.25 16:00,441,0,104,545,0
연산터널→연산교차로,2023.7.25 16:00,226,285,35,546,0
교대→연산교차로,2023.7.25 17:00,381,0,548,929,0
부산시청→연산교차로,2023.7.25 17:00,611,553,304,1468,0
사직운동장→연산교차로,2023.7.25 17:00,255,677,70,1002,0
신리→연산교차로,2023.7.25 17:00,501,267,61,829,0
안락→연산교차로,2023.7.25 17:00,454,0,111,565,0
연산터널→연산교차로,2023.7.25 17:00,221,276,57,554,0
교대→연산교차로,2023.7.25 18:00,380,0,558,938,0
부산시청→연산교차로,2023.7.25 18:00,619,552,349,1520,0
사직운동장→연산교차로,2023.7.25 18:00,239,703,59,1001,0
신리→연산교차로,2023.7.25 18:00,494,276,43,813,0
안락→연산교차로,2023.7.25 18:00,469,0,106,575,0
연산터널→연산교차로,2023.7.25 18:00,235,283,63,581,0
교대→연산교차로,2023.7.25 19:00,311,0,412,723,0
부산시청→연산교차로,2023.7.25 19:00,551,417,290,1258,0
사직운동장→연산교차로,2023.7.25 19:00,184,551,80,815,0
신리→연산교차로,2023.7.25 19:00,401,231,40,672,0
안락→연산교차로,2023.7.25 19:00,422,0,92,514,0
연산터널→연산교차로,2023.7.25 19:00,214,262,48,524,0
교대→연산교차로,2023.7.25 20:00,311,0,343,654,0
부산시청→연산교차로,2023.7.25 20:00,455,336,224,1015,0
사직운동장→연산교차로,2023.7.25 20:00,140,505,73,718,0
신리→연산교차로,2023.7.25 20:00,330,177,37,544,0
안락→연산교차로,2023.7.25 20:00,408,0,103,511,0
연산터널→연산교차로,2023.7.25 20:00,206,260,47,513,0
교대→연산교차로,2023.7.25 21:00,287,0,314,601,0
부산시청→연산교차로,2023.7.25 21:00,473,347,242,1062,0
사직운동장→연산교차로,2023.7.25 21:00,155,447,80,682,0
신리→연산교차로,2023.7.25 21:00,314,191,51,556,0
안락→연산교차로,2023.7.25 21:00,387,0,113,500,0
연산터널→연산교차로,2023.7.25 21:00,225,280,60,565,0
교대→연산교차로,2023.7.25 22:00,230,0,264,494,0
부산시청→연산교차로,2023.7.25 22:00,447,268,151,866,0
사직운동장→연산교차로,2023.7.25 22:00,128,365,73,566,0
신리→연산교차로,2023.7.25 22:00,256,165,43,464,0
안락→연산교차로,2023.7.25 22:00,350,0,106,456,0
연산터널→연산교차로,2023.7.25 22:00,193,255,60,508,0
교대→연산교차로,2023.7.25 23:00,192,0,228,420,0
부산시청→연산교차로,2023.7.25 23:00,315,190,120,625,0
사직운동장→연산교차로,2023.7.25 23:00,101,310,63,474,0
신리→연산교차로,2023.7.25 23:00,217,139,33,389,0
안락→연산교차로,2023.7.25 23:00,251,0,70,321,0
연산터널→연산교차로,2023.7.25 23:00,165,205,58,428,0
교대→연산교차로,2023.7.26 00:00,104,0,226,330,0
부산시청→연산교차로,2023.7.26 00:00,281,134,117,532,0
사직운동장→연산교차로,2023.7.26 00:00,79,276,71,426,0
신리→연산교차로,2023.7.26 00:00,160,91,20,271,0
안락→연산교차로,2023.7.26 00:00,206,0,57,263,0
연산터널→연산교차로,2023.7.26 00:00,134,174,78,386,0
교대→연산교차로,2023.7.26 01:00,115,0,161,276,0
부산시청→연산교차로,2023.7.26 01:00,164,108,87,359,0
사직운동장→연산교차로,2023.7.26 01:00,30,188,60,278,0
신리→연산교차로,2023.7.26 01:00,123,61,17,201,0
안락→연산교차로,2023.7.26 01:00,163,0,52,215,0
연산터널→연산교차로,2023.7.26 01:00,132,152,46,330,0
교대→연산교차로,2023.7.26 02:00,80,0,138,218,0
부산시청→연산교차로,2023.7.26 02:00,165,72,65,302,0
사직운동장→연산교차로,2023.7.26 02:00,38,156,24,218,0
신리→연산교차로,2023.7.26 02:00,116,49,14,179,0
안락→연산교차로,2023.7.26 02:00,124,0,37,161,0
연산터널→연산교차로,2023.7.26 02:00,94,111,45,250,0
교대→연산교차로,2023.7.26 03:00,63,0,125,188,0
부산시청→연산교차로,2023.7.26 03:00,152,81,52,285,0
사직운동장→연산교차로,2023.7.26 03:00,38,139,42,219,0
신리→연산교차로,2023.7.26 03:00,73,40,19,132,0
안락→연산교차로,2023.7.26 03:00,103,0,34,137,0
연산터널→연산교차로,2023.7.26 03:00,93,91,44,228,0
교대→연산교차로,2023.7.26 04:00,51,0,88,139,0
부산시청→연산교차로,2023.7.26 04:00,166,83,42,291,0
사직운동장→연산교차로,2023.7.26 04:00,33,120,19,172,0
신리→연산교차로,2023.7.26 04:00,81,65,13,159,0
안락→연산교차로,2023.7.26 04:00,170,0,35,205,0
연산터널→연산교차로,2023.7.26 04:00,81,104,30,215,0
교대→연산교차로,2023.7.26 05:00,85,0,112,197,0
부산시청→연산교차로,2023.7.26 05:00,210,147,91,448,0
사직운동장→연산교차로,2023.7.26 05:00,45,169,32,246,0
신리→연산교차로,2023.7.26 05:00,200,95,10,305,0
안락→연산교차로,2023.7.26 05:00,317,0,67,384,0
연산터널→연산교차로,2023.7.26 05:00,134,141,34,309,0
교대→연산교차로,2023.7.26 06:00,180,0,210,390,0
부산시청→연산교차로,2023.7.26 06:00,369,259,117,745,0
사직운동장→연산교차로,2023.7.26 06:00,97,280,49,426,0
신리→연산교차로,2023.7.26 06:00,336,190,29,555,0
안락→연산교차로,2023.7.26 06:00,472,0,93,565,0
연산터널→연산교차로,2023.7.26 06:00,203,233,40,476,0
교대→연산교차로,2023.7.26 07:00,239,0,367,606,0
부산시청→연산교차로,2023.7.26 07:00,508,335,199,1042,0
사직운동장→연산교차로,2023.7.26 07:00,170,486,73,729,0
신리→연산교차로,2023.7.26 07:00,492,257,24,773,0
안락→연산교차로,2023.7.26 07:00,583,0,104,687,0
연산터널→연산교차로,2023.7.26 07:00,282,331,47,660,0
교대→연산교차로,2023.7.26 08:00,307,0,515,822,0
부산시청→연산교차로,2023.7.26 08:00,565,409,336,1310,0
사직운동장→연산교차로,2023.7.26 08:00,179,638,91,908,0
신리→연산교차로,2023.7.26 08:00,499,337,35,871,0
안락→연산교차로,2023.7.26 08:00,611,0,129,740,0
연산터널→연산교차로,2023.7.26 08:00,310,372,46,728,0
교대→연산교차로,2023.7.26 09:00,306,0,480,786,0
부산시청→연산교차로,2023.7.26 09:00,530,384,299,1213,0
사직운동장→연산교차로,2023.7.26 09:00,180,581,78,839,0
신리→연산교차로,2023.7.26 09:00,437,301,39,777,0
안락→연산교차로,2023.7.26 09:00,567,0,124,691,0
연산터널→연산교차로,2023.7.26 09:00,316,341,48,705,0
교대→연산교차로,2023.7.26 10:00,296,0,484,780,0
부산시청→연산교차로,2023.7.26 10:00,555,358,283,1196,0
사직운동장→연산교차로,2023.7.26 10:00,204,589,74,867,0
신리→연산교차로,2023.7.26 10:00,476,273,58,807,0
안락→연산교차로,2023.7.26 10:00,542,0,136,678,0
연산터널→연산교차로,2023.7.26 10:00,284,313,47,644,0
교대→연산교차로,2023.7.26 11:00,294,0,458,752,0
부산시청→연산교차로,2023.7.26 11:00,602,365,267,1234,0
사직운동장→연산교차로,2023.7.26 11:00,193,590,65,848,0
신리→연산교차로,2023.7.26 11:00,451,286,76,813,0
안락→연산교차로,2023.7.26 11:00,515,0,179,694,0
연산터널→연산교차로,2023.7.26 11:00,258,328,42,628,0
교대→연산교차로,2023.7.26 12:00,296,0,394,690,0
부산시청→연산교차로,2023.7.26 12:00,560,380,257,1197,0
사직운동장→연산교차로,2023.7.26 12:00,205,569,61,835,0
신리→연산교차로,2023.7.26 12:00,442,260,53,755,0
안락→연산교차로,2023.7.26 12:00,480,0,157,637,0
연산터널→연산교차로,2023.7.26 12:00,276,270,49,595,0
교대→연산교차로,2023.7.26 13:00,335,0,470,805,0
부산시청→연산교차로,2023.7.26 13:00,588,431,285,1304,0
사직운동장→연산교차로,2023.7.26 13:00,198,615,76,889,0
신리→연산교차로,2023.7.26 13:00,422,294,52,768,0
안락→연산교차로,2023.7.26 13:00,428,0,131,559,0
연산터널→연산교차로,2023.7.26 13:00,244,268,31,543,0
교대→연산교차로,2023.7.26 14:00,344,0,460,804,0
부산시청→연산교차로,2023.7.26 14:00,559,447,310,1316,0
사직운동장→연산교차로,2023.7.26 14:00,199,642,98,939,0
신리→연산교차로,2023.7.26 14:00,469,304,62,835,0
안락→연산교차로,2023.7.26 14:00,438,0,112,550,0
연산터널→연산교차로,2023.7.26 14:00,235,278,54,567,0
교대→연산교차로,2023.7.26 15:00,358,0,499,857,0
부산시청→연산교차로,2023.7.26 15:00,605,465,290,1360,0
사직운동장→연산교차로,2023.7.26 15:00,222,618,81,921,0
신리→연산교차로,2023.7.26 15:00,402,287,62,751,0
안락→연산교차로,2023.7.26 15:00,441,0,125,566,0
연산터널→연산교차로,2023.7.26 15:00,223,290,41,554,0
교대→연산교차로,2023.7.26 16:00,352,0,510,862,0
부산시청→연산교차로,2023.7.26 16:00,627,496,349,1472,0
사직운동장→연산교차로,2023.7.26 16:00,231,676,57,964,0
신리→연산교차로,2023.7.26 16:00,517,293,60,870,0
안락→연산교차로,2023.7.26 16:00,451,0,115,566,0
연산터널→연산교차로,2023.7.26 16:00,240,284,43,567,0
교대→연산교차로,2023.7.26 17:00,357,0,496,853,0
부산시청→연산교차로,2023.7.26 17:00,625,507,327,1459,0
사직운동장→연산교차로,2023.7.26 17:00,237,686,49,972,0
신리→연산교차로,2023.7.26 17:00,500,306,44,850,0
안락→연산교차로,2023.7.26 17:00,447,0,124,571,0
연산터널→연산교차로,2023.7.26 17:00,239,284,39,562,0
교대→연산교차로,2023.7.26 18:00,359,0,544,903,0
부산시청→연산교차로,2023.7.26 18:00,583,577,317,1477,0
사직운동장→연산교차로,2023.7.26 18:00,249,689,49,987,0
신리→연산교차로,2023.7.26 18:00,479,282,34,795,0
안락→연산교차로,2023.7.26 18:00,462,0,97,559,0
연산터널→연산교차로,2023.7.26 18:00,233,282,44,559,0
교대→연산교차로,2023.7.26 19:00,337,0,413,750,0
부산시청→연산교차로,2023.7.26 19:00,557,450,290,1297,0
사직운동장→연산교차로,2023.7.26 19:00,210,590,78,878,0
신리→연산교차로,2023.7.26 19:00,354,246,48,648,0
안락→연산교차로,2023.7.26 19:00,414,0,109,523,0
연산터널→연산교차로,2023.7.26 19:00,190,287,67,544,0
교대→연산교차로,2023.7.26 20:00,334,0,333,667,0
부산시청→연산교차로,2023.7.26 20:00,473,371,261,1105,0
사직운동장→연산교차로,2023.7.26 20:00,168,506,92,766,0
신리→연산교차로,2023.7.26 20:00,326,201,36,563,0
안락→연산교차로,2023.7.26 20:00,421,0,115,536,0
연산터널→연산교차로,2023.7.26 20:00,211,271,50,532,0
교대→연산교차로,2023.7.26 21:00,275,0,293,568,0
부산시청→연산교차로,2023.7.26 21:00,469,290,212,971,0
사직운동장→연산교차로,2023.7.26 21:00,195,457,79,731,0
신리→연산교차로,2023.7.26 21:00,322,194,34,550,0
안락→연산교차로,2023.7.26 21:00,413,0,95,508,0
연산터널→연산교차로,2023.7.26 21:00,247,258,70,575,0
교대→연산교차로,2023.7.26 22:00,257,0,254,511,0
부산시청→연산교차로,2023.7.26 22:00,408,257,180,845,0
사직운동장→연산교차로,2023.7.26 22:00,136,339,81,556,0
신리→연산교차로,2023.7.26 22:00,234,177,27,438,0
안락→연산교차로,2023.7.26 22:00,367,0,106,473,0
연산터널→연산교차로,2023.7.26 22:00,184,221,64,469,0
교대→연산교차로,2023.7.26 23:00,176,0,220,396,0
부산시청→연산교차로,2023.7.26 23:00,282,192,148,622,0
사직운동장→연산교차로,2023.7.26 23:00,121,319,73,513,0
신리→연산교차로,2023.7.26 23:00,230,113,27,370,0
안락→연산교차로,2023.7.26 23:00,243,0,80,323,0
연산터널→연산교차로,2023.7.26 23:00,174,191,63,428,0
교대→연산교차로,2023.7.27 00:00,135,0,212,347,0
부산시청→연산교차로,2023.7.27 00:00,257,165,115,537,0
사직운동장→연산교차로,2023.7.27 00:00,69,222,58,349,0
신리→연산교차로,2023.7.27 00:00,168,94,26,288,0
안락→연산교차로,2023.7.27 00:00,225,0,72,297,0
연산터널→연산교차로,2023.7.27 00:00,133,171,57,361,0
교대→연산교차로,2023.7.27 01:00,99,0,166,265,0
부산시청→연산교차로,2023.7.27 01:00,190,108,80,378,0
사직운동장→연산교차로,2023.7.27 01:00,49,179,41,269,0
신리→연산교차로,2023.7.27 01:00,113,72,18,203,0
안락→연산교차로,2023.7.27 01:00,159,0,49,208,0
연산터널→연산교차로,2023.7.27 01:00,108,132,58,298,0
교대→연산교차로,2023.7.27 02:00,85,0,135,220,0
부산시청→연산교차로,2023.7.27 02:00,191,83,68,342,0
사직운동장→연산교차로,2023.7.27 02:00,41,192,39,272,0
신리→연산교차로,2023.7.27 02:00,84,55,16,155,0
안락→연산교차로,2023.7.27 02:00,121,0,31,152,0
연산터널→연산교차로,2023.7.27 02:00,98,139,38,275,0
교대→연산교차로,2023.7.27 03:00,64,0,111,175,0
부산시청→연산교차로,2023.7.27 03:00,151,69,55,275,0
사직운동장→연산교차로,2023.7.27 03:00,20,146,33,199,0
신리→연산교차로,2023.7.27 03:00,81,38,11,130,0
안락→연산교차로,2023.7.27 03:00,123,0,27,150,0
연산터널→연산교차로,2023.7.27 03:00,82,104,44,230,0
교대→연산교차로,2023.7.27 04:00,59,0,98,157,0
부산시청→연산교차로,2023.7.27 04:00,150,90,47,287,0
사직운동장→연산교차로,2023.7.27 04:00,30,127,20,177,0
신리→연산교차로,2023.7.27 04:00,94,44,12,150,0
안락→연산교차로,2023.7.27 04:00,169,0,34,203,0
연산터널→연산교차로,2023.7.27 04:00,87,100,35,222,0
교대→연산교차로,2023.7.27 05:00,97,0,120,217,0
부산시청→연산교차로,2023.7.27 05:00,242,156,90,488,0
사직운동장→연산교차로,2023.7.27 05:00,62,178,31,271,0
신리→연산교차로,2023.7.27 05:00,183,89,9,281,0
안락→연산교차로,2023.7.27 05:00,326,0,61,387,0
연산터널→연산교차로,2023.7.27 05:00,117,162,32,311,0
교대→연산교차로,2023.7.27 06:00,178,0,201,379,0
부산시청→연산교차로,2023.7.27 06:00,370,253,134,757,0
사직운동장→연산교차로,2023.7.27 06:00,96,297,45,438,0
신리→연산교차로,2023.7.27 06:00,349,180,30,559,0
안락→연산교차로,2023.7.27 06:00,490,0,114,604,0
연산터널→연산교차로,2023.7.27 06:00,216,198,31,445,0
교대→연산교차로,2023.7.27 07:00,235,0,359,594,0
부산시청→연산교차로,2023.7.27 07:00,475,340,206,1021,0
사직운동장→연산교차로,2023.7.27 07:00,163,488,57,708,0
신리→연산교차로,2023.7.27 07:00,439,266,34,739,0
안락→연산교차로,2023.7.27 07:00,608,0,91,699,0
연산터널→연산교차로,2023.7.27 07:00,294,337,40,671,0
교대→연산교차로,2023.7.27 08:00,288,0,527,815,0
부산시청→연산교차로,2023.7.27 08:00,600,408,304,1312,0
사직운동장→연산교차로,2023.7.27 08:00,178,658,70,906,0
신리→연산교차로,2023.7.27 08:00,484,329,35,848,0
안락→연산교차로,2023.7.27 08:00,617,0,99,716,0
연산터널→연산교차로,2023.7.27 08:00,297,375,29,701,0
교대→연산교차로,2023.7.27 09:00,315,0,502,817,0
부산시청→연산교차로,2023.7.27 09:00,512,382,289,1183,0
사직운동장→연산교차로,2023.7.27 09:00,179,600,76,855,0
신리→연산교차로,2023.7.27 09:00,485,315,41,841,0
안락→연산교차로,2023.7.27 09:00,560,0,135,695,0
연산터널→연산교차로,2023.7.27 09:00,295,349,38,682,0
교대→연산교차로,2023.7.27 10:00,312,0,461,773,0
부산시청→연산교차로,2023.7.27 10:00,516,376,279,1171,0
사직운동장→연산교차로,2023.7.27 10:00,204,565,67,836,0
신리→연산교차로,2023.7.27 10:00,475,254,46,775,0
안락→연산교차로,2023.7.27 10:00,531,0,163,694,0
연산터널→연산교차로,2023.7.27 10:00,287,326,56,669,0
교대→연산교차로,2023.7.27 11:00,295,0,448,743,0
부산시청→연산교차로,2023.7.27 11:00,569,390,236,1195,0
사직운동장→연산교차로,2023.7.27 11:00,181,592,79,852,0
신리→연산교차로,2023.7.27 11:00,443,295,60,798,0
안락→연산교차로,2023.7.27 11:00,501,0,151,652,0
연산터널→연산교차로,2023.7.27 11:00,263,284,63,610,0
교대→연산교차로,2023.7.27 12:00,295,0,414,709,0
부산시청→연산교차로,2023.7.27 12:00,586,341,274,1201,0
사직운동장→연산교차로,2023.7.27 12:00,186,538,65,789,0
신리→연산교차로,2023.7.27 12:00,420,289,47,756,0
안락→연산교차로,2023.7.27 12:00,488,0,203,691,0
연산터널→연산교차로,2023.7.27 12:00,285,291,42,618,0
교대→연산교차로,2023.7.27 13:00,350,0,429,779,0
부산시청→연산교차로,2023.7.27 13:00,556,430,260,1246,0
사직운동장→연산교차로,2023.7.27 13:00,215,620,66,901,0
신리→연산교차로,2023.7.27 13:00,430,276,42,748,0
안락→연산교차로,2023.7.27 13:00,432,0,144,576,0
연산터널→연산교차로,2023.7.27 13:00,212,289,45,546,0
교대→연산교차로,2023.7.27 14:00,366,0,496,862,0
부산시청→연산교차로,2023.7.27 14:00,666,469,295,1430,0
사직운동장→연산교차로,2023.7.27 14:00,209,607,85,901,0
신리→연산교차로,2023.7.27 14:00,430,252,58,740,0
안락→연산교차로,2023.7.27 14:00,440,0,142,582,0
연산터널→연산교차로,2023.7.27 14:00,237,281,44,562,0
교대→연산교차로,2023.7.27 15:00,355,0,453,808,0
부산시청→연산교차로,2023.7.27 15:00,600,469,325,1394,0
사직운동장→연산교차로,2023.7.27 15:00,223,673,77,973,0
신리→연산교차로,2023.7.27 15:00,475,277,53,805,0
안락→연산교차로,2023.7.27 15:00,435,0,110,545,0
연산터널→연산교차로,2023.7.27 15:00,230,280,46,556,0
교대→연산교차로,2023.7.27 16:00,359,0,480,839,0
부산시청→연산교차로,2023.7.27 16:00,594,505,325,1424,0
사직운동장→연산교차로,2023.7.27 16:00,221,688,60,969,0
신리→연산교차로,2023.7.27 16:00,490,297,58,845,0
안락→연산교차로,2023.7.27 16:00,424,0,130,554,0
연산터널→연산교차로,2023.7.27 16:00,233,282,38,553,0
교대→연산교차로,2023.7.27 17:00,363,0,510,873,0
부산시청→연산교차로,2023.7.27 17:00,626,527,341,1494,0
사직운동장→연산교차로,2023.7.27 17:00,250,685,45,980,0
신리→연산교차로,2023.7.27 17:00,501,289,52,842,0
안락→연산교차로,2023.7.27 17:00,444,0,106,550,0
연산터널→연산교차로,2023.7.27 17:00,231,273,40,544,0
교대→연산교차로,2023.7.27 18:00,360,0,563,923,0
부산시청→연산교차로,2023.7.27 18:00,616,580,298,1494,0
사직운동장→연산교차로,2023.7.27 18:00,227,662,50,939,0
신리→연산교차로,2023.7.27 18:00,457,277,39,773,0
안락→연산교차로,2023.7.27 18:00,449,0,83,532,0
연산터널→연산교차로,2023.7.27 18:00,223,270,41,534,0
교대→연산교차로,2023.7.27 19:00,357,0,446,803,0
부산시청→연산교차로,2023.7.27 19:00,583,423,254,1260,0
사직운동장→연산교차로,2023.7.27 19:00,200,573,77,850,0
신리→연산교차로,2023.7.27 19:00,374,226,30,630,0
안락→연산교차로,2023.7.27 19:00,428,0,103,531,0
연산터널→연산교차로,2023.7.27 19:00,220,252,61,533,0
교대→연산교차로,2023.7.27 20:00,321,0,370,691,0
부산시청→연산교차로,2023.7.27 20:00,494,382,228,1104,0
사직운동장→연산교차로,2023.7.27 20:00,182,533,81,796,0
신리→연산교차로,2023.7.27 20:00,309,185,31,525,0
안락→연산교차로,2023.7.27 20:00,416,0,104,520,0
연산터널→연산교차로,2023.7.27 20:00,206,251,48,505,0
교대→연산교차로,2023.7.27 21:00,276,0,305,581,0
부산시청→연산교차로,2023.7.27 21:00,463,337,196,996,0
사직운동장→연산교차로,2023.7.27 21:00,183,434,86,703,0
신리→연산교차로,2023.7.27 21:00,324,182,31,537,0
안락→연산교차로,2023.7.27 21:00,376,0,101,477,0
연산터널→연산교차로,2023.7.27 21:00,241,275,57,573,0
교대→연산교차로,2023.7.27 22:00,275,0,268,543,0
부산시청→연산교차로,2023.7.27 22:00,441,261,174,876,0
사직운동장→연산교차로,2023.7.27 22:00,142,333,62,537,0
신리→연산교차로,2023.7.27 22:00,258,194,36,488,0
안락→연산교차로,2023.7.27 22:00,348,0,92,440,0
연산터널→연산교차로,2023.7.27 22:00,190,213,48,451,0
교대→연산교차로,2023.7.27 23:00,183,0,192,375,0
부산시청→연산교차로,2023.7.27 23:00,338,221,123,682,0
사직운동장→연산교차로,2023.7.27 23:00,118,309,78,505,0
신리→연산교차로,2023.7.27 23:00,215,123,25,363,0
안락→연산교차로,2023.7.27 23:00,269,0,66,335,0
연산터널→연산교차로,2023.7.27 23:00,165,187,55,407,0
교대→연산교차로,2023.7.28 00:00,148,0,210,358,0
부산시청→연산교차로,2023.7.28 00:00,266,144,114,524,0
사직운동장→연산교차로,2023.7.28 00:00,76,249,76,401,0
신리→연산교차로,2023.7.28 00:00,172,121,24,317,0
안락→연산교차로,2023.7.28 00:00,201,0,83,284,0
연산터널→연산교차로,2023.7.28 00:00,148,181,70,399,0
교대→연산교차로,2023.7.28 01:00,118,0,171,289,0
부산시청→연산교차로,2023.7.28 01:00,222,130,84,436,0
사직운동장→연산교차로,2023.7.28 01:00,58,198,56,312,0
신리→연산교차로,2023.7.28 01:00,118,59,16,193,0
안락→연산교차로,2023.7.28 01:00,163,0,46,209,0
연산터널→연산교차로,2023.7.28 01:00,136,150,61,347,0
교대→연산교차로,2023.7.28 02:00,97,0,153,250,0
부산시청→연산교차로,2023.7.28 02:00,169,88,56,313,0
사직운동장→연산교차로,2023.7.28 02:00,45,161,38,244,0
신리→연산교차로,2023.7.28 02:00,83,62,16,161,0
안락→연산교차로,2023.7.28 02:00,140,0,53,193,0
연산터널→연산교차로,2023.7.28 02:00,112,108,50,270,0
교대→연산교차로,2023.7.28 03:00,70,0,119,189,0
부산시청→연산교차로,2023.7.28 03:00,130,74,43,247,0
사직운동장→연산교차로,2023.7.28 03:00,34,108,31,173,0
신리→연산교차로,2023.7.28 03:00,74,48,12,134,0
안락→연산교차로,2023.7.28 03:00,108,0,27,135,0
연산터널→연산교차로,2023.7.28 03:00,68,105,32,205,0
교대→연산교차로,2023.7.28 04:00,63,0,102,165,0
부산시청→연산교차로,2023.7.28 04:00,159,92,56,307,0
사직운동장→연산교차로,2023.7.28 04:00,34,120,30,184,0
신리→연산교차로,2023.7.28 04:00,106,53,10,169,0
안락→연산교차로,2023.7.28 04:00,197,0,27,224,0
연산터널→연산교차로,2023.7.28 04:00,85,89,31,205,0
교대→연산교차로,2023.7.28 05:00,111,0,159,270,0
부산시청→연산교차로,2023.7.28 05:00,242,136,84,462,0
사직운동장→연산교차로,2023.7.28 05:00,54,164,37,255,0
신리→연산교차로,2023.7.28 05:00,228,87,10,325,0
안락→연산교차로,2023.7.28 05:00,326,0,62,388,0
연산터널→연산교차로,2023.7.28 05:00,126,148,28,302,0
교대→연산교차로,2023.7.28 06:00,200,0,216,416,0
부산시청→연산교차로,2023.7.28 06:00,361,262,136,759,0
사직운동장→연산교차로,2023.7.28 06:00,91,268,47,406,0
신리→연산교차로,2023.7.28 06:00,329,187,25,541,0
안락→연산교차로,2023.7.28 06:00,514,0,90,604,0
연산터널→연산교차로,2023.7.28 06:00,200,243,44,487,0
교대→연산교차로,2023.7.28 07:00,247,0,357,604,0
부산시청→연산교차로,2023.7.28 07:00,470,344,200,1014,0
사직운동장→연산교차로,2023.7.28 07:00,142,464,69,675,0
신리→연산교차로,2023.7.28 07:00,399,257,31,687,0
안락→연산교차로,2023.7.28 07:00,603,0,82,685,0
연산터널→연산교차로,2023.7.28 07:00,281,357,41,679,0
교대→연산교차로,2023.7.28 08:00,293,0,518,811,0
부산시청→연산교차로,2023.7.28 08:00,556,408,317,1281,0
사직운동장→연산교차로,2023.7.28 08:00,194,624,81,899,0
신리→연산교차로,2023.7.28 08:00,514,337,29,880,0
안락→연산교차로,2023.7.28 08:00,605,0,125,730,0
연산터널→연산교차로,2023.7.28 08:00,337,369,45,751,0
교대→연산교차로,2023.7.28 09:00,296,0,514,810,0
부산시청→연산교차로,2023.7.28 09:00,537,372,288,1197,0
사직운동장→연산교차로,2023.7.28 09:00,197,590,79,866,0
신리→연산교차로,2023.7.28 09:00,465,331,55,851,0
안락→연산교차로,2023.7.28 09:00,541,0,145,686,0
연산터널→연산교차로,2023.7.28 09:00,305,354,52,711,0
교대→연산교차로,2023.7.28 10:00,304,0,454,758,0
부산시청→연산교차로,2023.7.28 10:00,584,376,295,1255,0
사직운동장→연산교차로,2023.7.28 10:00,209,583,44,836,0
신리→연산교차로,2023.7.28 10:00,462,307,81,850,0
안락→연산교차로,2023.7.28 10:00,546,0,127,673,0
연산터널→연산교차로,2023.7.28 10:00,314,364,58,736,0
교대→연산교차로,2023.7.28 11:00,308,0,456,764,0
부산시청→연산교차로,2023.7.28 11:00,573,386,281,1240,0
사직운동장→연산교차로,2023.7.28 11:00,186,605,57,848,0
신리→연산교차로,2023.7.28 11:00,521,285,74,880,0
안락→연산교차로,2023.7.28 11:00,509,0,157,666,0
연산터널→연산교차로,2023.7.28 11:00,303,334,63,700,0
교대→연산교차로,2023.7.28 12:00,297,0,476,773,0
부산시청→연산교차로,2023.7.28 12:00,586,393,254,1233,0
사직운동장→연산교차로,2023.7.28 12:00,198,589,74,861,0
신리→연산교차로,2023.7.28 12:00,463,274,65,802,0
안락→연산교차로,2023.7.28 12:00,517,0,172,689,0
연산터널→연산교차로,2023.7.28 12:00,274,291,39,604,0
교대→연산교차로,2023.7.28 13:00,358,0,463,821,0
부산시청→연산교차로,2023.7.28 13:00,595,468,284,1347,0
사직운동장→연산교차로,2023.7.28 13:00,240,603,90,933,0
신리→연산교차로,2023.7.28 13:00,472,262,68,802,0
안락→연산교차로,2023.7.28 13:00,425,0,126,551,0
연산터널→연산교차로,2023.7.28 13:00,259,288,34,581,0
교대→연산교차로,2023.7.28 14:00,338,0,522,860,0
부산시청→연산교차로,2023.7.28 14:00,648,494,323,1465,0
사직운동장→연산교차로,2023.7.28 14:00,220,654,69,943,0
신리→연산교차로,2023.7.28 14:00,479,286,91,856,0
안락→연산교차로,2023.7.28 14:00,402,0,128,530,0
연산터널→연산교차로,2023.7.28 14:00,242,271,49,562,0
교대→연산교차로,2023.7.28 15:00,344,0,528,872,0
부산시청→연산교차로,2023.7.28 15:00,557,483,288,1328,0
사직운동장→연산교차로,2023.7.28 15:00,223,671,58,952,0
신리→연산교차로,2023.7.28 15:00,492,289,75,856,0
안락→연산교차로,2023.7.28 15:00,441,0,124,565,0
연산터널→연산교차로,2023.7.28 15:00,243,271,52,566,0
교대→연산교차로,2023.7.28 16:00,365,0,502,867,0
부산시청→연산교차로,2023.7.28 16:00,603,527,309,1439,0
사직운동장→연산교차로,2023.7.28 16:00,237,647,47,931,0
신리→연산교차로,2023.7.28 16:00,513,288,76,877,0
안락→연산교차로,2023.7.28 16:00,445,0,121,566,0
연산터널→연산교차로,2023.7.28 16:00,244,291,36,571,0
교대→연산교차로,2023.7.28 17:00,387,0,535,922,0
부산시청→연산교차로,2023.7.28 17:00,645,533,338,1516,0
사직운동장→연산교차로,2023.7.28 17:00,237,718,43,998,0
신리→연산교차로,2023.7.28 17:00,547,283,48,878,0
안락→연산교차로,2023.7.28 17:00,459,0,112,571,0
연산터널→연산교차로,2023.7.28 17:00,218,282,42,542,0
교대→연산교차로,2023.7.28 18:00,383,0,543,926,0
부산시청→연산교차로,2023.7.28 18:00,617,574,359,1550,0
사직운동장→연산교차로,2023.7.28 18:00,226,713,52,991,0
신리→연산교차로,2023.7.28 18:00,503,289,33,825,0
안락→연산교차로,2023.7.28 18:00,460,0,110,570,0
연산터널→연산교차로,2023.7.28 18:00,216,286,39,541,0
교대→연산교차로,2023.7.28 19:00,342,0,476,818,0
부산시청→연산교차로,2023.7.28 19:00,591,404,280,1275,0
사직운동장→연산교차로,2023.7.28 19:00,235,619,54,908,0
신리→연산교차로,2023.7.28 19:00,449,259,39,747,0
안락→연산교차로,2023.7.28 19:00,419,0,98,517,0
연산터널→연산교차로,2023.7.28 19:00,213,256,64,533,0
교대→연산교차로,2023.7.28 20:00,341,0,437,778,0
부산시청→연산교차로,2023.7.28 20:00,514,387,257,1158,0
사직운동장→연산교차로,2023.7.28 20:00,188,548,91,827,0
신리→연산교차로,2023.7.28 20:00,353,228,44,625,0
안락→연산교차로,2023.7.28 20:00,434,0,104,538,0
연산터널→연산교차로,2023.7.28 20:00,234,272,63,569,0
교대→연산교차로,2023.7.28 21:00,310,0,370,680,0
부산시청→연산교차로,2023.7.28 21:00,513,333,191,1037,0
사직운동장→연산교차로,2023.7.28 21:00,189,489,82,760,0
신리→연산교차로,2023.7.28 21:00,313,216,30,559,0
안락→연산교차로,2023.7.28 21:00,424,0,116,540,0
연산터널→연산교차로,2023.7.28 21:00,217,281,69,567,0
교대→연산교차로,2023.7.28 22:00,282,0,317,599,0
부산시청→연산교차로,2023.7.28 22:00,469,314,203,986,0
사직운동장→연산교차로,2023.7.28 22:00,160,397,86,643,0
신리→연산교차로,2023.7.28 22:00,329,179,40,548,0
안락→연산교차로,2023.7.28 22:00,380,0,103,483,0
연산터널→연산교차로,2023.7.28 22:00,199,243,60,502,0
교대→연산교차로,2023.7.28 23:00,211,0,280,491,0
부산시청→연산교차로,2023.7.28 23:00,386,241,172,799,0
사직운동장→연산교차로,2023.7.28 23:00,113,343,109,565,0
신리→연산교차로,2023.7.28 23:00,265,155,16,436,0
안락→연산교차로,2023.7.28 23:00,319,0,90,409,0
연산터널→연산교차로,2023.7.28 23:00,204,240,81,525,0
교대→연산교차로,2023.7.29 00:00,198,0,249,447,0
부산시청→연산교차로,2023.7.29 00:00,310,204,129,643,0
사직운동장→연산교차로,2023.7.29 00:00,86,280,84,450,0
신리→연산교차로,2023.7.29 00:00,216,128,14,358,0
안락→연산교차로,2023.7.29 00:00,258,0,91,349,0
연산터널→연산교차로,2023.7.29 00:00,163,205,60,428,0
교대→연산교차로,2023.7.29 01:00,147,0,265,412,0
부산시청→연산교차로,2023.7.29 01:00,274,165,108,547,0
사직운동장→연산교차로,2023.7.29 01:00,73,215,59,347,0
신리→연산교차로,2023.7.29 01:00,176,95,19,290,0
안락→연산교차로,2023.7.29 01:00,202,0,76,278,0
연산터널→연산교차로,2023.7.29 01:00,114,167,50,331,0
교대→연산교차로,2023.7.29 02:00,119,0,224,343,0
부산시청→연산교차로,2023.7.29 02:00,255,135,90,480,0
사직운동장→연산교차로,2023.7.29 02:00,65,214,46,325,0
신리→연산교차로,2023.7.29 02:00,119,92,17,228,0
안락→연산교차로,2023.7.29 02:00,209,0,52,261,0
연산터널→연산교차로,2023.7.29 02:00,140,189,54,383,0
교대→연산교차로,2023.7.29 03:00,98,0,166,264,0
부산시청→연산교차로,2023.7.29 03:00,202,104,82,388,0
사직운동장→연산교차로,2023.7.29 03:00,65,177,47,289,0
신리→연산교차로,2023.7.29 03:00,118,71,16,205,0
안락→연산교차로,2023.7.29 03:00,146,0,32,178,0
연산터널→연산교차로,2023.7.29 03:00,124,148,55,327,0
교대→연산교차로,2023.7.29 04:00,93,0,124,217,0
부산시청→연산교차로,2023.7.29 04:00,210,99,60,369,0
사직운동장→연산교차로,2023.7.29 04:00,46,133,34,213,0
신리→연산교차로,2023.7.29 04:00,103,64,15,182,0
안락→연산교차로,2023.7.29 04:00,215,0,51,266,0
연산터널→연산교차로,2023.7.29 04:00,81,132,25,238,0
교대→연산교차로,2023.7.29 05:00,100,0,152,252,0
부산시청→연산교차로,2023.7.29 05:00,247,160,94,501,0
사직운동장→연산교차로,2023.7.29 05:00,62,174,51,287,0
신리→연산교차로,2023.7.29 05:00,198,85,14,297,0
안락→연산교차로,2023.7.29 05:00,278,0,70,348,0
연산터널→연산교차로,2023.7.29 05:00,104,126,31,261,0
교대→연산교차로,2023.7.29 06:00,149,0,177,326,0
부산시청→연산교차로,2023.7.29 06:00,318,197,118,633,0
사직운동장→연산교차로,2023.7.29 06:00,84,231,44,359,0
신리→연산교차로,2023.7.29 06:00,250,172,16,438,0
안락→연산교차로,2023.7.29 06:00,384,0,83,467,0
연산터널→연산교차로,2023.7.29 06:00,184,155,36,375,0
교대→연산교차로,2023.7.29 07:00,183,0,198,381,0
부산시청→연산교차로,2023.7.29 07:00,385,233,146,764,0
사직운동장→연산교차로,2023.7.29 07:00,106,306,54,466,0
신리→연산교차로,2023.7.29 07:00,255,154,33,442,0
안락→연산교차로,2023.7.29 07:00,433,0,89,522,0
연산터널→연산교차로,2023.7.29 07:00,187,205,55,447,0
교대→연산교차로,2023.7.29 08:00,263,0,298,561,0
부산시청→연산교차로,2023.7.29 08:00,454,322,200,976,0
사직운동장→연산교차로,2023.7.29 08:00,170,500,56,726,0
신리→연산교차로,2023.7.29 08:00,420,231,36,687,0
안락→연산교차로,2023.7.29 08:00,498,0,119,617,0
연산터널→연산교차로,2023.7.29 08:00,234,276,59,569,0
교대→연산교차로,2023.7.29 09:00,269,0,392,661,0
부산시청→연산교차로,2023.7.29 09:00,488,327,270,1085,0
사직운동장→연산교차로,2023.7.29 09:00,182,568,59,809,0
신리→연산교차로,2023.7.29 09:00,445,265,79,789,0
안락→연산교차로,2023.7.29 09:00,579,0,138,717,0
연산터널→연산교차로,2023.7.29 09:00,298,312,56,666,0
교대→연산교차로,2023.7.29 10:00,303,0,476,779,0
부산시청→연산교차로,2023.7.29 10:00,579,372,290,1241,0
사직운동장→연산교차로,2023.7.29 10:00,195,631,60,886,0
신리→연산교차로,2023.7.29 10:00,497,293,73,863,0
안락→연산교차로,2023.7.29 10:00,539,0,128,667,0
연산터널→연산교차로,2023.7.29 10:00,307,365,57,729,0
교대→연산교차로,2023.7.29 11:00,305,0,499,804,0
부산시청→연산교차로,2023.7.29 11:00,608,384,318,1310,0
사직운동장→연산교차로,2023.7.29 11:00,192,606,60,858,0
신리→연산교차로,2023.7.29 11:00,464,272,75,811,0
안락→연산교차로,2023.7.29 11:00,551,0,175,726,0
연산터널→연산교차로,2023.7.29 11:00,278,287,40,605,0
교대→연산교차로,2023.7.29 12:00,324,0,447,771,0
부산시청→연산교차로,2023.7.29 12:00,605,380,314,1299,0
사직운동장→연산교차로,2023.7.29 12:00,199,626,43,868,0
신리→연산교차로,2023.7.29 12:00,476,293,83,852,0
안락→연산교차로,2023.7.29 12:00,579,0,182,761,0
연산터널→연산교차로,2023.7.29 12:00,304,353,61,718,0
교대→연산교차로,2023.7.29 13:00,355,0,428,783,0
부산시청→연산교차로,2023.7.29 13:00,628,499,332,1459,0
사직운동장→연산교차로,2023.7.29 13:00,223,684,57,964,0
신리→연산교차로,2023.7.29 13:00,480,289,73,842,0
안락→연산교차로,2023.7.29 13:00,457,0,157,614,0
연산터널→연산교차로,2023.7.29 13:00,228,291,54,573,0
교대→연산교차로,2023.7.29 14:00,349,0,432,781,0
부산시청→연산교차로,2023.7.29 14:00,590,485,320,1395,0
사직운동장→연산교차로,2023.7.29 14:00,218,664,41,923,0
신리→연산교차로,2023.7.29 14:00,439,298,74,811,0
안락→연산교차로,2023.7.29 14:00,437,0,112,549,0
연산터널→연산교차로,2023.7.29 14:00,264,274,45,583,0
교대→연산교차로,2023.7.29 15:00,357,0,411,768,0
부산시청→연산교차로,2023.7.29 15:00,657,476,325,1458,0
사직운동장→연산교차로,2023.7.29 15:00,218,648,53,919,0
신리→연산교차로,2023.7.29 15:00,455,271,62,788,0
안락→연산교차로,2023.7.29 15:00,454,0,104,558,0
연산터널→연산교차로,2023.7.29 15:00,228,280,58,566,0
교대→연산교차로,2023.7.29 16:00,347,0,406,753,0
부산시청→연산교차로,2023.7.29 16:00,647,478,299,1424,0
사직운동장→연산교차로,2023.7.29 16:00,233,658,59,950,0
신리→연산교차로,2023.7.29 16:00,478,323,56,857,0
안락→연산교차로,2023.7.29 16:00,462,0,102,564,0
연산터널→연산교차로,2023.7.29 16:00,240,280,32,552,0
교대→연산교차로,2023.7.29 17:00,345,0,388,733,0
부산시청→연산교차로,2023.7.29 17:00,618,465,303,1386,0
사직운동장→연산교차로,2023.7.29 17:00,215,650,72,937,0
신리→연산교차로,2023.7.29 17:00,447,314,46,807,0
안락→연산교차로,2023.7.29 17:00,462,0,109,571,0
연산터널→연산교차로,2023.7.29 17:00,249,277,54,580,0
교대→연산교차로,2023.7.29 18:00,341,0,389,730,0
부산시청→연산교차로,2023.7.29 18:00,571,414,259,1244,0
사직운동장→연산교차로,2023.7.29 18:00,201,597,61,859,0
신리→연산교차로,2023.7.29 18:00,397,262,42,701,0
안락→연산교차로,2023.7.29 18:00,456,0,102,558,0
연산터널→연산교차로,2023.7.29 18:00,253,274,56,583,0
교대→연산교차로,2023.7.29 19:00,270,0,359,629,0
부산시청→연산교차로,2023.7.29 19:00,506,346,234,1086,0
사직운동장→연산교차로,2023.7.29 19:00,170,479,82,731,0
신리→연산교차로,2023.7.29 19:00,331,196,35,562,0
안락→연산교차로,2023.7.29 19:00,381,0,138,519,0
연산터널→연산교차로,2023.7.29 19:00,214,269,74,557,0
교대→연산교차로,2023.7.29 20:00,304,0,313,617,0
부산시청→연산교차로,2023.7.29 20:00,461,332,226,1019,0
사직운동장→연산교차로,2023.7.29 20:00,165,469,80,714,0
신리→연산교차로,2023.7.29 20:00,359,196,25,580,0
안락→연산교차로,2023.7.29 20:00,425,0,99,524,0
연산터널→연산교차로,2023.7.29 20:00,209,275,53,537,0
교대→연산교차로,2023.7.29 21:00,284,0,305,589,0
부산시청→연산교차로,2023.7.29 21:00,465,333,182,980,0
사직운동장→연산교차로,2023.7.29 21:00,150,426,83,659,0
신리→연산교차로,2023.7.29 21:00,342,219,24,585,0
안락→연산교차로,2023.7.29 21:00,412,0,120,532,0
연산터널→연산교차로,2023.7.29 21:00,251,270,63,584,0
교대→연산교차로,2023.7.29 22:00,260,0,241,501,0
부산시청→연산교차로,2023.7.29 22:00,412,291,185,888,0
사직운동장→연산교차로,2023.7.29 22:00,200,457,52,709,0
신리→연산교차로,2023.7.29 22:00,322,176,20,518,0
안락→연산교차로,2023.7.29 22:00,319,0,112,431,0
연산터널→연산교차로,2023.7.29 22:00,203,241,62,506,0
교대→연산교차로,2023.7.29 23:00,188,0,207,395,0
부산시청→연산교차로,2023.7.29 23:00,363,205,129,697,0
사직운동장→연산교차로,2023.7.29 23:00,111,331,76,518,0
신리→연산교차로,2023.7.29 23:00,258,136,22,416,0
안락→연산교차로,2023.7.29 23:00,273,0,88,361,0
연산터널→연산교차로,2023.7.29 23:00,182,212,44,438,0
교대→연산교차로,2023.7.30 00:00,178,0,243,421,1
부산시청→연산교차로,2023.7.30 00:00,303,214,114,631,1
사직운동장→연산교차로,2023.7.30 00:00,84,281,68,433,1
신리→연산교차로,2023.7.30 00:00,221,114,11,346,1
안락→연산교차로,2023.7.30 00:00,261,0,72,333,1
연산터널→연산교차로,2023.7.30 00:00,136,186,50,372,1
교대→연산교차로,2023.7.30 01:00,142,0,205,347,1
부산시청→연산교차로,2023.7.30 01:00,277,165,102,544,1
사직운동장→연산교차로,2023.7.30 01:00,56,186,48,290,1
신리→연산교차로,2023.7.30 01:00,167,87,12,266,1
안락→연산교차로,2023.7.30 01:00,204,0,49,253,1
연산터널→연산교차로,2023.7.30 01:00,115,181,52,348,1
교대→연산교차로,2023.7.30 02:00,96,0,180,276,1
부산시청→연산교차로,2023.7.30 02:00,234,134,84,452,1
사직운동장→연산교차로,2023.7.30 02:00,64,154,39,257,1
신리→연산교차로,2023.7.30 02:00,129,67,13,209,1
안락→연산교차로,2023.7.30 02:00,172,0,53,225,1
연산터널→연산교차로,2023.7.30 02:00,93,135,44,272,1
교대→연산교차로,2023.7.30 03:00,87,0,140,227,1
부산시청→연산교차로,2023.7.30 03:00,191,100,62,353,1
사직운동장→연산교차로,2023.7.30 03:00,43,150,35,228,1
신리→연산교차로,2023.7.30 03:00,101,63,10,174,1
안락→연산교차로,2023.7.30 03:00,136,0,39,175,1
연산터널→연산교차로,2023.7.30 03:00,100,129,39,268,1
교대→연산교차로,2023.7.30 04:00,70,0,105,175,1
부산시청→연산교차로,2023.7.30 04:00,135,73,57,265,1
사직운동장→연산교차로,2023.7.30 04:00,37,119,23,179,1
신리→연산교차로,2023.7.30 04:00,83,49,4,136,1
안락→연산교차로,2023.7.30 04:00,115,0,21,136,1
연산터널→연산교차로,2023.7.30 04:00,80,86,20,186,1
교대→연산교차로,2023.7.30 05:00,65,0,102,167,1
부산시청→연산교차로,2023.7.30 05:00,169,90,46,305,1
사직운동장→연산교차로,2023.7.30 05:00,28,134,34,196,1
신리→연산교차로,2023.7.30 05:00,104,69,4,177,1
안락→연산교차로,2023.7.30 05:00,166,0,44,210,1
연산터널→연산교차로,2023.7.30 05:00,83,113,25,221,1
교대→연산교차로,2023.7.30 06:00,94,0,104,198,1
부산시청→연산교차로,2023.7.30 06:00,200,122,60,382,1
사직운동장→연산교차로,2023.7.30 06:00,48,150,37,235,1
신리→연산교차로,2023.7.30 06:00,152,74,7,233,1
안락→연산교차로,2023.7.30 06:00,231,0,41,272,1
연산터널→연산교차로,2023.7.30 06:00,132,123,38,293,1
교대→연산교차로,2023.7.30 07:00,133,0,132,265,1
부산시청→연산교차로,2023.7.30 07:00,248,157,82,487,1
사직운동장→연산교차로,2023.7.30 07:00,55,210,32,297,1
신리→연산교차로,2023.7.30 07:00,187,79,19,285,1
안락→연산교차로,2023.7.30 07:00,244,0,51,295,1
연산터널→연산교차로,2023.7.30 07:00,126,119,33,278,1
교대→연산교차로,2023.7.30 08:00,171,0,165,336,1
부산시청→연산교차로,2023.7.30 08:00,284,203,129,616,1
사직운동장→연산교차로,2023.7.30 08:00,107,296,44,447,1
신리→연산교차로,2023.7.30 08:00,261,117,25,403,1
안락→연산교차로,2023.7.30 08:00,333,0,76,409,1
연산터널→연산교차로,2023.7.30 08:00,185,166,29,380,1
교대→연산교차로,2023.7.30 09:00,231,0,233,464,1
부산시청→연산교차로,2023.7.30 09:00,370,273,172,815,1
사직운동장→연산교차로,2023.7.30 09:00,133,374,36,543,1
신리→연산교차로,2023.7.30 09:00,357,201,17,575,1
안락→연산교차로,2023.7.30 09:00,428,0,107,535,1
연산터널→연산교차로,2023.7.30 09:00,259,231,28,518,1
교대→연산교차로,2023.7.30 10:00,275,0,274,549,1
부산시청→연산교차로,2023.7.30 10:00,422,298,198,918,1
사직운동장→연산교차로,2023.7.30 10:00,170,518,57,745,1
신리→연산교차로,2023.7.30 10:00,373,208,31,612,1
안락→연산교차로,2023.7.30 10:00,491,0,106,597,1
연산터널→연산교차로,2023.7.30 10:00,233,271,54,558,1
교대→연산교차로,2023.7.30 11:00,257,0,274,531,1
부산시청→연산교차로,2023.7.30 11:00,465,324,188,977,1
사직운동장→연산교차로,2023.7.30 11:00,176,546,45,767,1
신리→연산교차로,2023.7.30 11:00,416,237,42,695,1
안락→연산교차로,2023.7.30 11:00,421,0,144,565,1
연산터널→연산교차로,2023.7.30 11:00,250,261,45,556,1
교대→연산교차로,2023.7.30 12:00,276,0,303,579,1
부산시청→연산교차로,2023.7.30 12:00,537,350,215,1102,1
사직운동장→연산교차로,2023.7.30 12:00,191,569,49,809,1
신리→연산교차로,2023.7.30 12:00,461,243,36,740,1
안락→연산교차로,2023.7.30 12:00,481,0,142,623,1
연산터널→연산교차로,2023.7.30 12:00,259,252,50,561,1
교대→연산교차로,2023.7.30 13:00,300,0,329,629,1
부산시청→연산교차로,2023.7.30 13:00,505,345,224,1074,1
사직운동장→연산교차로,2023.7.30 13:00,185,578,43,806,1
신리→연산교차로,2023.7.30 13:00,407,223,53,683,1
안락→연산교차로,2023.7.30 13:00,494,0,125,619,1
연산터널→연산교차로,2023.7.30 13:00,269,252,40,561,1
교대→연산교차로,2023.7.30 14:00,306,0,297,603,1
부산시청→연산교차로,2023.7.30 14:00,491,331,220,1042,1
사직운동장→연산교차로,2023.7.30 14:00,194,578,57,829,1
신리→연산교차로,2023.7.30 14:00,412,225,51,688,1
안락→연산교차로,2023.7.30 14:00,501,0,139,640,1
연산터널→연산교차로,2023.7.30 14:00,271,262,60,593,1
교대→연산교차로,2023.7.30 15:00,286,0,325,611,1
부산시청→연산교차로,2023.7.30 15:00,465,317,251,1033,1
사직운동장→연산교차로,2023.7.30 15:00,180,555,58,793,1
신리→연산교차로,2023.7.30 15:00,459,258,47,764,1
안락→연산교차로,2023.7.30 15:00,531,0,198,729,1
연산터널→연산교차로,2023.7.30 15:00,280,264,40,584,1
교대→연산교차로,2023.7.30 16:00,294,0,319,613,1
부산시청→연산교차로,2023.7.30 16:00,511,366,219,1096,1
사직운동장→연산교차로,2023.7.30 16:00,184,543,57,784,1
신리→연산교차로,2023.7.30 16:00,406,299,32,737,1
안락→연산교차로,2023.7.30 16:00,528,0,148,676,1
연산터널→연산교차로,2023.7.30 16:00,230,291,58,579,1
교대→연산교차로,2023.7.30 17:00,306,0,322,628,1
부산시청→연산교차로,2023.7.30 17:00,445,329,223,997,1
사직운동장→연산교차로,2023.7.30 17:00,184,556,51,791,1
신리→연산교차로,2023.7.30 17:00,384,215,39,638,1
안락→연산교차로,2023.7.30 17:00,521,0,162,683,1
연산터널→연산교차로,2023.7.30 17:00,262,268,65,595,1
교대→연산교차로,2023.7.30 18:00,285,0,303,588,1
부산시청→연산교차로,2023.7.30 18:00,443,293,186,922,1
사직운동장→연산교차로,2023.7.30 18:00,161,434,78,673,1
신리→연산교차로,2023.7.30 18:00,357,194,35,586,1
안락→연산교차로,2023.7.30 18:00,452,0,140,592,1
연산터널→연산교차로,2023.7.30 18:00,230,241,59,530,1
교대→연산교차로,2023.7.30 19:00,255,0,289,544,1
부산시청→연산교차로,2023.7.30 19:00,392,237,154,783,1
사직운동장→연산교차로,2023.7.30 19:00,160,448,52,660,1
신리→연산교차로,2023.7.30 19:00,307,194,42,543,1
안락→연산교차로,2023.7.30 19:00,377,0,126,503,1
연산터널→연산교차로,2023.7.30 19:00,220,203,49,472,1
교대→연산교차로,2023.7.30 20:00,265,0,218,483,1
부산시청→연산교차로,2023.7.30 20:00,359,244,153,756,1
사직운동장→연산교차로,2023.7.30 20:00,157,412,47,616,1
신리→연산교차로,2023.7.30 20:00,291,148,21,460,1
안락→연산교차로,2023.7.30 20:00,348,0,87,435,1
연산터널→연산교차로,2023.7.30 20:00,193,212,44,449,1
교대→연산교차로,2023.7.30 21:00,227,0,201,428,1
부산시청→연산교차로,2023.7.30 21:00,354,222,125,701,1
사직운동장→연산교차로,2023.7.30 21:00,115,308,55,478,1
신리→연산교차로,2023.7.30 21:00,281,156,17,454,1
안락→연산교차로,2023.7.30 21:00,339,0,102,441,1
연산터널→연산교차로,2023.7.30 21:00,161,188,41,390,1
교대→연산교차로,2023.7.30 22:00,178,0,171,349,1
부산시청→연산교차로,2023.7.30 22:00,315,198,115,628,1
사직운동장→연산교차로,2023.7.30 22:00,101,286,49,436,1
신리→연산교차로,2023.7.30 22:00,233,119,23,375,1
안락→연산교차로,2023.7.30 22:00,274,0,71,345,1
연산터널→연산교차로,2023.7.30 22:00,154,176,54,384,1
교대→연산교차로,2023.7.30 23:00,141,0,139,280,1
부산시청→연산교차로,2023.7.30 23:00,220,138,93,451,1
사직운동장→연산교차로,2023.7.30 23:00,122,246,34,402,1
신리→연산교차로,2023.7.30 23:00,169,110,20,299,1
안락→연산교차로,2023.7.30 23:00,177,0,47,224,1
연산터널→연산교차로,2023.7.30 23:00,124,136,59,319,1
교대→연산교차로,2023.7.31 00:00,94,0,120,214,0
부산시청→연산교차로,2023.7.31 00:00,203,105,82,390,0
사직운동장→연산교차로,2023.7.31 00:00,74,189,29,292,0
신리→연산교차로,2023.7.31 00:00,140,58,17,215,0
안락→연산교차로,2023.7.31 00:00,147,0,41,188,0
연산터널→연산교차로,2023.7.31 00:00,102,105,67,274,0
교대→연산교차로,2023.7.31 01:00,62,0,126,188,0
부산시청→연산교차로,2023.7.31 01:00,136,79,50,265,0
사직운동장→연산교차로,2023.7.31 01:00,24,126,30,180,0
신리→연산교차로,2023.7.31 01:00,77,42,14,133,0
안락→연산교차로,2023.7.31 01:00,116,0,37,153,0
연산터널→연산교차로,2023.7.31 01:00,79,91,51,221,0
교대→연산교차로,2023.7.31 02:00,52,0,92,144,0
부산시청→연산교차로,2023.7.31 02:00,121,65,41,227,0
사직운동장→연산교차로,2023.7.31 02:00,29,116,17,162,0
신리→연산교차로,2023.7.31 02:00,78,23,7,108,0
안락→연산교차로,2023.7.31 02:00,96,0,26,122,0
연산터널→연산교차로,2023.7.31 02:00,49,79,36,164,0
교대→연산교차로,2023.7.31 03:00,42,0,66,108,0
부산시청→연산교차로,2023.7.31 03:00,121,68,42,231,0
사직운동장→연산교차로,2023.7.31 03:00,22,91,6,119,0
신리→연산교차로,2023.7.31 03:00,54,36,5,95,0
안락→연산교차로,2023.7.31 03:00,100,0,23,123,0
연산터널→연산교차로,2023.7.31 03:00,63,88,30,181,0
교대→연산교차로,2023.7.31 04:00,46,0,67,113,0
부산시청→연산교차로,2023.7.31 04:00,119,65,37,221,0
사직운동장→연산교차로,2023.7.31 04:00,25,81,13,119,0
신리→연산교차로,2023.7.31 04:00,87,44,4,135,0
안락→연산교차로,2023.7.31 04:00,152,0,32,184,0
연산터널→연산교차로,2023.7.31 04:00,67,89,15,171,0
교대→연산교차로,2023.7.31 05:00,79,0,120,199,0
부산시청→연산교차로,2023.7.31 05:00,213,157,76,446,0
사직운동장→연산교차로,2023.7.31 05:00,52,151,20,223,0
신리→연산교차로,2023.7.31 05:00,201,84,7,292,0
안락→연산교차로,2023.7.31 05:00,295,0,64,359,0
연산터널→연산교차로,2023.7.31 05:00,115,125,17,257,0
교대→연산교차로,2023.7.31 06:00,152,0,200,352,0
부산시청→연산교차로,2023.7.31 06:00,342,249,105,696,0
사직운동장→연산교차로,2023.7.31 06:00,82,276,46,404,0
신리→연산교차로,2023.7.31 06:00,339,180,24,543,0
안락→연산교차로,2023.7.31 06:00,465,0,101,566,0
연산터널→연산교차로,2023.7.31 06:00,232,228,38,498,0
교대→연산교차로,2023.7.31 07:00,252,0,408,660,0
부산시청→연산교차로,2023.7.31 07:00,517,352,209,1078,0
사직운동장→연산교차로,2023.7.31 07:00,178,462,62,702,0
신리→연산교차로,2023.7.31 07:00,460,277,22,759,0
안락→연산교차로,2023.7.31 07:00,613,0,80,693,0
연산터널→연산교차로,2023.7.31 07:00,268,345,48,661,0
교대→연산교차로,2023.7.31 08:00,284,0,493,777,0
부산시청→연산교차로,2023.7.31 08:00,548,404,285,1237,0
사직운동장→연산교차로,2023.7.31 08:00,193,625,74,892,0
신리→연산교차로,2023.7.31 08:00,474,340,29,843,0
안락→연산교차로,2023.7.31 08:00,581,0,125,706,0
연산터널→연산교차로,2023.7.31 08:00,317,375,31,723,0
교대→연산교차로,2023.7.31 09:00,293,0,528,821,0
부산시청→연산교차로,2023.7.31 09:00,522,393,303,1218,0
사직운동장→연산교차로,2023.7.31 09:00,190,587,91,868,0
신리→연산교차로,2023.7.31 09:00,483,322,48,853,0
안락→연산교차로,2023.7.31 09:00,551,0,112,663,0
연산터널→연산교차로,2023.7.31 09:00,298,368,39,705,0
교대→연산교차로,2023.7.31 10:00,302,0,441,743,0
부산시청→연산교차로,2023.7.31 10:00,579,364,292,1235,0
사직운동장→연산교차로,2023.7.31 10:00,210,581,78,869,0
신리→연산교차로,2023.7.31 10:00,441,279,70,790,0
안락→연산교차로,2023.7.31 10:00,560,0,135,695,0
연산터널→연산교차로,2023.7.31 10:00,294,356,57,707,0
교대→연산교차로,2023.7.31 11:00,300,0,513,813,0
부산시청→연산교차로,2023.7.31 11:00,564,363,274,1201,0
사직운동장→연산교차로,2023.7.31 11:00,212,593,79,884,0
신리→연산교차로,2023.7.31 11:00,468,296,62,826,0
안락→연산교차로,2023.7.31 11:00,529,0,193,722,0
연산터널→연산교차로,2023.7.31 11:00,304,310,47,661,0
교대→연산교차로,2023.7.31 12:00,282,0,430,712,0
부산시청→연산교차로,2023.7.31 12:00,521,358,271,1150,0
사직운동장→연산교차로,2023.7.31 12:00,176,538,60,774,0
신리→연산교차로,2023.7.31 12:00,427,240,69,736,0
안락→연산교차로,2023.7.31 12:00,434,0,166,600,0
연산터널→연산교차로,2023.7.31 12:00,300,265,47,612,0
교대→연산교차로,2023.7.31 13:00,342,0,492,834,0
부산시청→연산교차로,2023.7.31 13:00,590,465,237,1292,0
사직운동장→연산교차로,2023.7.31 13:00,210,605,83,898,0
신리→연산교차로,2023.7.31 13:00,412,271,87,770,0
안락→연산교차로,2023.7.31 13:00,447,0,123,570,0
연산터널→연산교차로,2023.7.31 13:00,237,288,37,562,0
교대→연산교차로,2023.7.31 14:00,326,0,521,847,0
부산시청→연산교차로,2023.7.31 14:00,550,462,297,1309,0
사직운동장→연산교차로,2023.7.31 14:00,227,585,83,895,0
신리→연산교차로,2023.7.31 14:00,480,285,69,834,0
안락→연산교차로,2023.7.31 14:00,427,0,115,542,0
연산터널→연산교차로,2023.7.31 14:00,249,267,43,559,0
교대→연산교차로,2023.7.31 15:00,346,0,539,885,0
부산시청→연산교차로,2023.7.31 15:00,574,507,299,1380,0
사직운동장→연산교차로,2023.7.31 15:00,214,650,85,949,0
신리→연산교차로,2023.7.31 15:00,416,289,61,766,0
안락→연산교차로,2023.7.31 15:00,414,0,116,530,0
연산터널→연산교차로,2023.7.31 15:00,239,279,43,561,0
교대→연산교차로,2023.7.31 16:00,350,0,564,914,0
부산시청→연산교차로,2023.7.31 16:00,592,539,318,1449,0
사직운동장→연산교차로,2023.7.31 16:00,212,667,78,957,0
신리→연산교차로,2023.7.31 16:00,484,282,64,830,0
안락→연산교차로,2023.7.31 16:00,431,0,108,539,0
연산터널→연산교차로,2023.7.31 16:00,229,283,41,553,0
교대→연산교차로,2023.7.31 17:00,356,0,534,890,0
부산시청→연산교차로,2023.7.31 17:00,627,504,296,1427,0
사직운동장→연산교차로,2023.7.31 17:00,223,684,36,943,0
신리→연산교차로,2023.7.31 17:00,501,264,58,823,0
안락→연산교차로,2023.7.31 17:00,461,0,107,568,0
연산터널→연산교차로,2023.7.31 17:00,234,275,40,549,0
교대→연산교차로,2023.7.31 18:00,363,0,565,928,0
부산시청→연산교차로,2023.7.31 18:00,614,560,352,1526,0
사직운동장→연산교차로,2023.7.31 18:00,236,705,45,986,0
신리→연산교차로,2023.7.31 18:00,490,271,45,806,0
안락→연산교차로,2023.7.31 18:00,445,0,102,547,0
연산터널→연산교차로,2023.7.31 18:00,214,274,51,539,0
교대→연산교차로,2023.7.31 19:00,313,0,379,692,0
부산시청→연산교차로,2023.7.31 19:00,528,395,289,1212,0
사직운동장→연산교차로,2023.7.31 19:00,196,549,67,812,0
신리→연산교차로,2023.7.31 19:00,337,200,44,581,0
안락→연산교차로,2023.7.31 19:00,402,0,88,490,0
연산터널→연산교차로,2023.7.31 19:00,218,252,39,509,0
교대→연산교차로,2023.7.31 20:00,316,0,307,623,0
부산시청→연산교차로,2023.7.31 20:00,444,326,251,1021,0
사직운동장→연산교차로,2023.7.31 20:00,140,456,76,672,0
신리→연산교차로,2023.7.31 20:00,313,192,36,541,0
안락→연산교차로,2023.7.31 20:00,387,0,105,492,0
연산터널→연산교차로,2023.7.31 20:00,218,259,46,523,0
교대→연산교차로,2023.7.31 21:00,266,0,270,536,0
부산시청→연산교차로,2023.7.31 21:00,475,299,210,984,0
사직운동장→연산교차로,2023.7.31 21:00,154,429,84,667,0
신리→연산교차로,2023.7.31 21:00,277,172,27,476,0
안락→연산교차로,2023.7.31 21:00,362,0,100,462,0
연산터널→연산교차로,2023.7.31 21:00,213,264,62,539,0
교대→연산교차로,2023.7.31 22:00,197,0,227,424,0
부산시청→연산교차로,2023.7.31 22:00,386,231,132,749,0
사직운동장→연산교차로,2023.7.31 22:00,161,357,73,591,0
신리→연산교차로,2023.7.31 22:00,244,163,27,434,0
안락→연산교차로,2023.7.31 22:00,315,0,100,415,0
연산터널→연산교차로,2023.7.31 22:00,177,220,57,454,0
교대→연산교차로,2023.7.31 23:00,175,0,209,384,0
부산시청→연산교차로,2023.7.31 23:00,289,176,124,589,0
사직운동장→연산교차로,2023.7.31 23:00,101,271,62,434,0
신리→연산교차로,2023.7.31 23:00,167,129,32,328,0
안락→연산교차로,2023.7.31 23:00,212,0,79,291,0
연산터널→연산교차로,2023.7.31 23:00,147,190,77,414,0
교대→연산교차로,2023.8.1 00:00,133,0,158,291,0
부산시청→연산교차로,2023.8.1 00:00,263,148,104,515,0
사직운동장→연산교차로,2023.8.1 00:00,72,208,58,338,0
신리→연산교차로,2023.8.1 00:00,143,93,17,253,0
안락→연산교차로,2023.8.1 00:00,196,0,45,241,0
연산터널→연산교차로,2023.8.1 00:00,116,131,52,299,0
교대→연산교차로,2023.8.1 01:00,102,0,148,250,0
부산시청→연산교차로,2023.8.1 01:00,169,121,75,365,0
사직운동장→연산교차로,2023.8.1 01:00,51,166,35,252,0
신리→연산교차로,2023.8.1 01:00,95,66,16,177,0
안락→연산교차로,2023.8.1 01:00,143,0,35,178,0
연산터널→연산교차로,2023.8.1 01:00,100,125,35,260,0
교대→연산교차로,2023.8.1 02:00,78,0,99,177,0
부산시청→연산교차로,2023.8.1 02:00,144,87,57,288,0
사직운동장→연산교차로,2023.8.1 02:00,38,138,41,217,0
신리→연산교차로,2023.8.1 02:00,102,44,11,157,0
안락→연산교차로,2023.8.1 02:00,131,0,35,166,0
연산터널→연산교차로,2023.8.1 02:00,82,96,32,210,0
교대→연산교차로,2023.8.1 03:00,52,0,97,149,0
부산시청→연산교차로,2023.8.1 03:00,140,72,43,255,0
사직운동장→연산교차로,2023.8.1 03:00,36,112,35,183,0
신리→연산교차로,2023.8.1 03:00,86,21,8,115,0
안락→연산교차로,2023.8.1 03:00,109,0,22,131,0
연산터널→연산교차로,2023.8.1 03:00,90,78,29,197,0
교대→연산교차로,2023.8.1 04:00,58,0,107,165,0
부산시청→연산교차로,2023.8.1 04:00,142,85,41,268,0
사직운동장→연산교차로,2023.8.1 04:00,25,110,26,161,0
신리→연산교차로,2023.8.1 04:00,98,51,8,157,0
안락→연산교차로,2023.8.1 04:00,173,0,46,219,0
연산터널→연산교차로,2023.8.1 04:00,69,86,21,176,0
교대→연산교차로,2023.8.1 05:00,99,0,117,216,0
부산시청→연산교차로,2023.8.1 05:00,241,139,76,456,0
사직운동장→연산교차로,2023.8.1 05:00,65,160,48,273,0
신리→연산교차로,2023.8.1 05:00,225,94,14,333,0
안락→연산교차로,2023.8.1 05:00,290,0,61,351,0
연산터널→연산교차로,2023.8.1 05:00,120,125,23,268,0
교대→연산교차로,2023.8.1 06:00,161,0,197,358,0
부산시청→연산교차로,2023.8.1 06:00,344,238,107,689,0
사직운동장→연산교차로,2023.8.1 06:00,95,286,44,425,0
신리→연산교차로,2023.8.1 06:00,315,168,35,518,0
안락→연산교차로,2023.8.1 06:00,462,0,80,542,0
연산터널→연산교차로,2023.8.1 06:00,202,229,30,461,0
교대→연산교차로,2023.8.1 07:00,228,0,330,558,0
부산시청→연산교차로,2023.8.1 07:00,468,337,210,1015,0
사직운동장→연산교차로,2023.8.1 07:00,162,491,61,714,0
신리→연산교차로,2023.8.1 07:00,398,269,31,698,0
안락→연산교차로,2023.8.1 07:00,577,0,89,666,0
연산터널→연산교차로,2023.8.1 07:00,276,337,35,648,0
교대→연산교차로,2023.8.1 08:00,295,0,532,827,0
부산시청→연산교차로,2023.8.1 08:00,568,405,316,1289,0
사직운동장→연산교차로,2023.8.1 08:00,211,609,59,879,0
신리→연산교차로,2023.8.1 08:00,486,339,32,857,0
안락→연산교차로,2023.8.1 08:00,599,0,99,698,0
연산터널→연산교차로,2023.8.1 08:00,319,378,19,716,0
교대→연산교차로,2023.8.1 09:00,278,0,487,765,0
부산시청→연산교차로,2023.8.1 09:00,508,363,259,1130,0
사직운동장→연산교차로,2023.8.1 09:00,182,613,102,897,0
신리→연산교차로,2023.8.1 09:00,444,306,55,805,0
안락→연산교차로,2023.8.1 09:00,544,0,140,684,0
연산터널→연산교차로,2023.8.1 09:00,308,359,48,715,0
교대→연산교차로,2023.8.1 10:00,294,0,456,750,0
부산시청→연산교차로,2023.8.1 10:00,527,347,261,1135,0
사직운동장→연산교차로,2023.8.1 10:00,217,589,72,878,0
신리→연산교차로,2023.8.1 10:00,477,271,58,806,0
안락→연산교차로,2023.8.1 10:00,523,0,168,691,0
연산터널→연산교차로,2023.8.1 10:00,296,346,57,699,0
교대→연산교차로,2023.8.1 11:00,296,0,448,744,0
부산시청→연산교차로,2023.8.1 11:00,556,386,218,1160,0
사직운동장→연산교차로,2023.8.1 11:00,176,600,74,850,0
신리→연산교차로,2023.8.1 11:00,467,280,65,812,0
안락→연산교차로,2023.8.1 11:00,519,0,177,696,0
연산터널→연산교차로,2023.8.1 11:00,269,295,58,622,0
교대→연산교차로,2023.8.1 12:00,301,0,441,742,0
부산시청→연산교차로,2023.8.1 12:00,539,368,296,1203,0
사직운동장→연산교차로,2023.8.1 12:00,211,553,66,830,0
신리→연산교차로,2023.8.1 12:00,440,260,68,768,0
안락→연산교차로,2023.8.1 12:00,515,0,166,681,0
연산터널→연산교차로,2023.8.1 12:00,297,303,37,637,0
교대→연산교차로,2023.8.1 13:00,333,0,405,738,0
부산시청→연산교차로,2023.8.1 13:00,615,441,242,1298,0
사직운동장→연산교차로,2023.8.1 13:00,221,631,47,899,0
신리→연산교차로,2023.8.1 13:00,406,275,53,734,0
안락→연산교차로,2023.8.1 13:00,422,0,147,569,0
연산터널→연산교차로,2023.8.1 13:00,235,267,48,550,0
교대→연산교차로,2023.8.1 14:00,369,0,470,839,0
부산시청→연산교차로,2023.8.1 14:00,686,465,291,1442,0
사직운동장→연산교차로,2023.8.1 14:00,219,643,53,915,0
신리→연산교차로,2023.8.1 14:00,453,261,70,784,0
안락→연산교차로,2023.8.1 14:00,434,0,100,534,0
연산터널→연산교차로,2023.8.1 14:00,223,271,48,542,0
교대→연산교차로,2023.8.1 15:00,362,0,442,804,0
부산시청→연산교차로,2023.8.1 15:00,642,466,314,1422,0
사직운동장→연산교차로,2023.8.1 15:00,216,647,79,942,0
신리→연산교차로,2023.8.1 15:00,453,255,62,770,0
안락→연산교차로,2023.8.1 15:00,442,0,132,574,0
연산터널→연산교차로,2023.8.1 15:00,234,269,65,568,0
교대→연산교차로,2023.8.1 16:00,338,0,479,817,0
부산시청→연산교차로,2023.8.1 16:00,592,484,334,1410,0
사직운동장→연산교차로,2023.8.1 16:00,226,666,51,943,0
신리→연산교차로,2023.8.1 16:00,463,308,49,820,0
안락→연산교차로,2023.8.1 16:00,454,0,112,566,0
연산터널→연산교차로,2023.8.1 16:00,234,281,38,553,0
교대→연산교차로,2023.8.1 17:00,375,0,552,927,0
부산시청→연산교차로,2023.8.1 17:00,645,514,337,1496,0
사직운동장→연산교차로,2023.8.1 17:00,221,698,59,978,0
신리→연산교차로,2023.8.1 17:00,489,331,46,866,0
안락→연산교차로,2023.8.1 17:00,433,0,128,561,0
연산터널→연산교차로,2023.8.1 17:00,226,288,34,548,0
교대→연산교차로,2023.8.1 18:00,375,0,521,896,0
부산시청→연산교차로,2023.8.1 18:00,612,551,328,1491,0
사직운동장→연산교차로,2023.8.1 18:00,249,687,51,987,0
신리→연산교차로,2023.8.1 18:00,503,287,53,843,0
안락→연산교차로,2023.8.1 18:00,459,0,89,548,0
연산터널→연산교차로,2023.8.1 18:00,237,264,47,548,0
교대→연산교차로,2023.8.1 19:00,337,0,440,777,0
부산시청→연산교차로,2023.8.1 19:00,566,409,291,1266,0
사직운동장→연산교차로,2023.8.1 19:00,213,590,69,872,0
신리→연산교차로,2023.8.1 19:00,388,229,41,658,0
안락→연산교차로,2023.8.1 19:00,405,0,124,529,0
연산터널→연산교차로,2023.8.1 19:00,231,265,52,548,0
교대→연산교차로,2023.8.1 20:00,288,0,320,608,0
부산시청→연산교차로,2023.8.1 20:00,467,339,227,1033,0
사직운동장→연산교차로,2023.8.1 20:00,167,540,84,791,0
신리→연산교차로,2023.8.1 20:00,370,181,34,585,0
안락→연산교차로,2023.8.1 20:00,412,0,124,536,0
연산터널→연산교차로,2023.8.1 20:00,221,255,51,527,0
교대→연산교차로,2023.8.1 21:00,281,0,294,575,0
부산시청→연산교차로,2023.8.1 21:00,451,329,174,954,0
사직운동장→연산교차로,2023.8.1 21:00,192,450,83,725,0
신리→연산교차로,2023.8.1 21:00,295,174,28,497,0
안락→연산교차로,2023.8.1 21:00,356,0,109,465,0
연산터널→연산교차로,2023.8.1 21:00,205,267,65,537,0
교대→연산교차로,2023.8.1 22:00,232,0,241,473,0
부산시청→연산교차로,2023.8.1 22:00,398,275,146,819,0
사직운동장→연산교차로,2023.8.1 22:00,171,408,54,633,0
신리→연산교차로,2023.8.1 22:00,260,173,28,461,0
안락→연산교차로,2023.8.1 22:00,330,0,98,428,0
연산터널→연산교차로,2023.8.1 22:00,207,231,49,487,0
교대→연산교차로,2023.8.1 23:00,183,0,173,356,0
부산시청→연산교차로,2023.8.1 23:00,320,198,114,632,0
사직운동장→연산교차로,2023.8.1 23:00,126,315,73,514,0
신리→연산교차로,2023.8.1 23:00,198,145,18,361,0
안락→연산교차로,2023.8.1 23:00,234,0,60,294,0
연산터널→연산교차로,2023.8.1 23:00,146,176,49,371,0
교대→연산교차로,2023.8.2 00:00,135,0,174,309,0
부산시청→연산교차로,2023.8.2 00:00,248,147,100,495,0
사직운동장→연산교차로,2023.8.2 00:00,81,221,72,374,0
신리→연산교차로,2023.8.2 00:00,163,102,22,287,0
안락→연산교차로,2023.8.2 00:00,195,0,71,266,0
연산터널→연산교차로,2023.8.2 00:00,123,162,50,335,0
교대→연산교차로,2023.8.2 01:00,127,0,153,280,0
부산시청→연산교차로,2023.8.2 01:00,207,125,81,413,0
사직운동장→연산교차로,2023.8.2 01:00,58,176,46,280,0
신리→연산교차로,2023.8.2 01:00,141,60,16,217,0
안락→연산교차로,2023.8.2 01:00,139,0,36,175,0
연산터널→연산교차로,2023.8.2 01:00,111,127,42,280,0
교대→연산교차로,2023.8.2 02:00,83,0,133,216,0
부산시청→연산교차로,2023.8.2 02:00,155,92,63,310,0
사직운동장→연산교차로,2023.8.2 02:00,46,158,37,241,0
신리→연산교차로,2023.8.2 02:00,88,47,9,144,0
안락→연산교차로,2023.8.2 02:00,126,0,33,159,0
연산터널→연산교차로,2023.8.2 02:00,122,99,49,270,0
교대→연산교차로,2023.8.2 03:00,60,0,121,181,0
부산시청→연산교차로,2023.8.2 03:00,150,85,45,280,0
사직운동장→연산교차로,2023.8.2 03:00,33,114,33,180,0
신리→연산교차로,2023.8.2 03:00,86,35,12,133,0
안락→연산교차로,2023.8.2 03:00,100,0,18,118,0
연산터널→연산교차로,2023.8.2 03:00,67,84,40,191,0
교대→연산교차로,2023.8.2 04:00,57,0,90,147,0
부산시청→연산교차로,2023.8.2 04:00,151,82,44,277,0
사직운동장→연산교차로,2023.8.2 04:00,36,136,26,198,0
신리→연산교차로,2023.8.2 04:00,99,41,9,149,0
안락→연산교차로,2023.8.2 04:00,162,0,38,200,0
연산터널→연산교차로,2023.8.2 04:00,82,106,37,225,0
교대→연산교차로,2023.8.2 05:00,113,0,112,225,0
부산시청→연산교차로,2023.8.2 05:00,216,141,80,437,0
사직운동장→연산교차로,2023.8.2 05:00,55,190,41,286,0
신리→연산교차로,2023.8.2 05:00,186,88,14,288,0
안락→연산교차로,2023.8.2 05:00,292,0,55,347,0
연산터널→연산교차로,2023.8.2 05:00,119,140,32,291,0
교대→연산교차로,2023.8.2 06:00,156,0,170,326,0
부산시청→연산교차로,2023.8.2 06:00,321,220,113,654,0
사직운동장→연산교차로,2023.8.2 06:00,95,283,47,425,0
신리→연산교차로,2023.8.2 06:00,287,181,26,494,0
안락→연산교차로,2023.8.2 06:00,448,0,87,535,0
연산터널→연산교차로,2023.8.2 06:00,179,218,55,452,0
교대→연산교차로,2023.8.2 07:00,226,0,279,505,0
부산시청→연산교차로,2023.8.2 07:00,462,301,220,983,0
사직운동장→연산교차로,2023.8.2 07:00,171,474,33,678,0
신리→연산교차로,2023.8.2 07:00,398,252,31,681,0
안락→연산교차로,2023.8.2 07:00,577,0,88,665,0
연산터널→연산교차로,2023.8.2 07:00,275,337,36,648,0
교대→연산교차로,2023.8.2 08:00,275,0,509,784,0
부산시청→연산교차로,2023.8.2 08:00,538,404,335,1277,0
사직운동장→연산교차로,2023.8.2 08:00,205,649,54,908,0
신리→연산교차로,2023.8.2 08:00,487,332,36,855,0
안락→연산교차로,2023.8.2 08:00,580,0,115,695,0
연산터널→연산교차로,2023.8.2 08:00,306,387,38,731,0
교대→연산교차로,2023.8.2 09:00,291,0,430,721,0
부산시청→연산교차로,2023.8.2 09:00,497,371,319,1187,0
사직운동장→연산교차로,2023.8.2 09:00,183,551,76,810,0
신리→연산교차로,2023.8.2 09:00,450,310,55,815,0
안락→연산교차로,2023.8.2 09:00,581,0,130,711,0
연산터널→연산교차로,2023.8.2 09:00,301,342,51,694,0
교대→연산교차로,2023.8.2 10:00,294,0,443,737,0
부산시청→연산교차로,2023.8.2 10:00,599,363,262,1224,0
사직운동장→연산교차로,2023.8.2 10:00,202,573,52,827,0
신리→연산교차로,2023.8.2 10:00,456,293,58,807,0
안락→연산교차로,2023.8.2 10:00,546,0,157,703,0
연산터널→연산교차로,2023.8.2 10:00,263,304,60,627,0
교대→연산교차로,2023.8.2 11:00,294,0,446,740,0
부산시청→연산교차로,2023.8.2 11:00,562,393,275,1230,0
사직운동장→연산교차로,2023.8.2 11:00,209,584,44,837,0
신리→연산교차로,2023.8.2 11:00,479,293,56,828,0
안락→연산교차로,2023.8.2 11:00,531,0,162,693,0
연산터널→연산교차로,2023.8.2 11:00,270,311,67,648,0
교대→연산교차로,2023.8.2 12:00,297,0,437,734,0
부산시청→연산교차로,2023.8.2 12:00,553,354,273,1180,0
사직운동장→연산교차로,2023.8.2 12:00,191,578,52,821,0
신리→연산교차로,2023.8.2 12:00,433,285,59,777,0
안락→연산교차로,2023.8.2 12:00,476,0,171,647,0
연산터널→연산교차로,2023.8.2 12:00,272,287,48,607,0
교대→연산교차로,2023.8.2 13:00,356,0,492,848,0
부산시청→연산교차로,2023.8.2 13:00,582,465,271,1318,0
사직운동장→연산교차로,2023.8.2 13:00,239,605,65,909,0
신리→연산교차로,2023.8.2 13:00,415,275,48,738,0
안락→연산교차로,2023.8.2 13:00,422,0,119,541,0
연산터널→연산교차로,2023.8.2 13:00,231,274,28,533,0
교대→연산교차로,2023.8.2 14:00,350,0,449,799,0
부산시청→연산교차로,2023.8.2 14:00,629,435,290,1354,0
사직운동장→연산교차로,2023.8.2 14:00,197,617,71,885,0
신리→연산교차로,2023.8.2 14:00,418,240,56,714,0
안락→연산교차로,2023.8.2 14:00,432,0,132,564,0
연산터널→연산교차로,2023.8.2 14:00,236,281,46,563,0
교대→연산교차로,2023.8.2 15:00,372,0,424,796,0
부산시청→연산교차로,2023.8.2 15:00,570,449,328,1347,0
사직운동장→연산교차로,2023.8.2 15:00,208,648,67,923,0
신리→연산교차로,2023.8.2 15:00,432,286,73,791,0
안락→연산교차로,2023.8.2 15:00,433,0,113,546,0
연산터널→연산교차로,2023.8.2 15:00,222,281,54,557,0
교대→연산교차로,2023.8.2 16:00,363,0,486,849,0
부산시청→연산교차로,2023.8.2 16:00,619,509,324,1452,0
사직운동장→연산교차로,2023.8.2 16:00,233,648,52,933,0
신리→연산교차로,2023.8.2 16:00,527,292,60,879,0
안락→연산교차로,2023.8.2 16:00,460,0,101,561,0
연산터널→연산교차로,2023.8.2 16:00,264,292,38,594,0
교대→연산교차로,2023.8.2 17:00,354,0,491,845,0
부산시청→연산교차로,2023.8.2 17:00,606,519,356,1481,0
사직운동장→연산교차로,2023.8.2 17:00,243,660,49,952,0
신리→연산교차로,2023.8.2 17:00,453,333,50,836,0
안락→연산교차로,2023.8.2 17:00,467,0,101,568,0
연산터널→연산교차로,2023.8.2 17:00,251,284,43,578,0
교대→연산교차로,2023.8.2 18:00,383,0,542,925,0
부산시청→연산교차로,2023.8.2 18:00,621,560,326,1507,0
사직운동장→연산교차로,2023.8.2 18:00,249,681,47,977,0
신리→연산교차로,2023.8.2 18:00,472,275,37,784,0
안락→연산교차로,2023.8.2 18:00,440,0,117,557,0
연산터널→연산교차로,2023.8.2 18:00,229,270,45,544,0
교대→연산교차로,2023.8.2 19:00,343,0,401,744,0
부산시청→연산교차로,2023.8.2 19:00,537,390,253,1180,0
사직운동장→연산교차로,2023.8.2 19:00,182,573,76,831,0
신리→연산교차로,2023.8.2 19:00,347,220,35,602,0
안락→연산교차로,2023.8.2 19:00,431,0,121,552,0
연산터널→연산교차로,2023.8.2 19:00,226,262,56,544,0
교대→연산교차로,2023.8.2 20:00,308,0,315,623,0
부산시청→연산교차로,2023.8.2 20:00,462,351,227,1040,0
사직운동장→연산교차로,2023.8.2 20:00,193,538,54,785,0
신리→연산교차로,2023.8.2 20:00,359,194,37,590,0
안락→연산교차로,2023.8.2 20:00,410,0,113,523,0
연산터널→연산교차로,2023.8.2 20:00,217,269,53,539,0
교대→연산교차로,2023.8.2 21:00,298,0,286,584,0
부산시청→연산교차로,2023.8.2 21:00,478,344,179,1001,0
사직운동장→연산교차로,2023.8.2 21:00,186,467,69,722,0
신리→연산교차로,2023.8.2 21:00,339,221,30,590,0
안락→연산교차로,2023.8.2 21:00,367,0,103,470,0
연산터널→연산교차로,2023.8.2 21:00,200,249,48,497,0
교대→연산교차로,2023.8.2 22:00,227,0,195,422,0
부산시청→연산교차로,2023.8.2 22:00,386,244,145,775,0
사직운동장→연산교차로,2023.8.2 22:00,213,420,71,704,0
신리→연산교차로,2023.8.2 22:00,252,178,22,452,0
안락→연산교차로,2023.8.2 22:00,348,0,86,434,0
연산터널→연산교차로,2023.8.2 22:00,187,221,54,462,0
교대→연산교차로,2023.8.2 23:00,195,0,211,406,0
부산시청→연산교차로,2023.8.2 23:00,317,217,130,664,0
사직운동장→연산교차로,2023.8.2 23:00,101,279,87,467,0
신리→연산교차로,2023.8.2 23:00,198,98,27,323,0
안락→연산교차로,2023.8.2 23:00,236,0,68,304,0
연산터널→연산교차로,2023.8.2 23:00,153,194,50,397,0
교대→연산교차로,2023.8.3 00:00,148,0,194,342,0
부산시청→연산교차로,2023.8.3 00:00,241,157,117,515,0
사직운동장→연산교차로,2023.8.3 00:00,78,240,70,388,0
신리→연산교차로,2023.8.3 00:00,153,100,18,271,0
안락→연산교차로,2023.8.3 00:00,226,0,56,282,0
연산터널→연산교차로,2023.8.3 00:00,158,154,71,383,0
교대→연산교차로,2023.8.3 01:00,114,0,148,262,0
부산시청→연산교차로,2023.8.3 01:00,182,129,72,383,0
사직운동장→연산교차로,2023.8.3 01:00,59,197,61,317,0
신리→연산교차로,2023.8.3 01:00,130,99,13,242,0
안락→연산교차로,2023.8.3 01:00,151,0,49,200,0
연산터널→연산교차로,2023.8.3 01:00,112,147,44,303,0
교대→연산교차로,2023.8.3 02:00,75,0,125,200,0
부산시청→연산교차로,2023.8.3 02:00,158,90,63,311,0
사직운동장→연산교차로,2023.8.3 02:00,48,155,43,246,0
신리→연산교차로,2023.8.3 02:00,89,43,17,149,0
안락→연산교차로,2023.8.3 02:00,140,0,36,176,0
연산터널→연산교차로,2023.8.3 02:00,94,134,56,284,0
교대→연산교차로,2023.8.3 03:00,71,0,101,172,0
부산시청→연산교차로,2023.8.3 03:00,143,75,47,265,0
사직운동장→연산교차로,2023.8.3 03:00,34,140,30,204,0
신리→연산교차로,2023.8.3 03:00,81,47,8,136,0
안락→연산교차로,2023.8.3 03:00,128,0,33,161,0
연산터널→연산교차로,2023.8.3 03:00,78,105,56,239,0
교대→연산교차로,2023.8.3 04:00,50,0,102,152,0
부산시청→연산교차로,2023.8.3 04:00,138,79,55,272,0
사직운동장→연산교차로,2023.8.3 04:00,35,120,21,176,0
신리→연산교차로,2023.8.3 04:00,99,40,9,148,0
안락→연산교차로,2023.8.3 04:00,180,0,32,212,0
연산터널→연산교차로,2023.8.3 04:00,76,88,32,196,0
교대→연산교차로,2023.8.3 05:00,96,0,125,221,0
부산시청→연산교차로,2023.8.3 05:00,243,150,80,473,0
사직운동장→연산교차로,2023.8.3 05:00,64,181,35,280,0
신리→연산교차로,2023.8.3 05:00,205,101,11,317,0
안락→연산교차로,2023.8.3 05:00,301,0,56,357,0
연산터널→연산교차로,2023.8.3 05:00,131,133,30,294,0
교대→연산교차로,2023.8.3 06:00,168,0,215,383,0
부산시청→연산교차로,2023.8.3 06:00,336,231,121,688,0
사직운동장→연산교차로,2023.8.3 06:00,86,295,52,433,0
신리→연산교차로,2023.8.3 06:00,315,179,20,514,0
안락→연산교차로,2023.8.3 06:00,445,0,89,534,0
연산터널→연산교차로,2023.8.3 06:00,192,220,38,450,0
교대→연산교차로,2023.8.3 07:00,238,0,284,522,0
부산시청→연산교차로,2023.8.3 07:00,500,318,208,1026,0
사직운동장→연산교차로,2023.8.3 07:00,166,457,60,683,0
신리→연산교차로,2023.8.3 07:00,429,262,33,724,0
안락→연산교차로,2023.8.3 07:00,608,0,107,715,0
연산터널→연산교차로,2023.8.3 07:00,293,326,35,654,0
교대→연산교차로,2023.8.3 08:00,285,0,535,820,0
부산시청→연산교차로,2023.8.3 08:00,554,415,306,1275,0
사직운동장→연산교차로,2023.8.3 08:00,203,665,57,925,0
신리→연산교차로,2023.8.3 08:00,506,342,26,874,0
안락→연산교차로,2023.8.3 08:00,612,0,93,705,0
연산터널→연산교차로,2023.8.3 08:00,308,386,28,722,0
교대→연산교차로,2023.8.3 09:00,288,0,455,743,0
부산시청→연산교차로,2023.8.3 09:00,486,361,296,1143,0
사직운동장→연산교차로,2023.8.3 09:00,197,534,81,812,0
신리→연산교차로,2023.8.3 09:00,480,312,52,844,0
안락→연산교차로,2023.8.3 09:00,538,0,117,655,0
연산터널→연산교차로,2023.8.3 09:00,309,342,28,679,0
교대→연산교차로,2023.8.3 10:00,312,0,455,767,0
부산시청→연산교차로,2023.8.3 10:00,527,365,270,1162,0
사직운동장→연산교차로,2023.8.3 10:00,210,570,35,815,0
신리→연산교차로,2023.8.3 10:00,461,286,54,801,0
안락→연산교차로,2023.8.3 10:00,528,0,147,675,0
연산터널→연산교차로,2023.8.3 10:00,312,299,46,657,0
교대→연산교차로,2023.8.3 11:00,293,0,435,728,0
부산시청→연산교차로,2023.8.3 11:00,556,380,276,1212,0
사직운동장→연산교차로,2023.8.3 11:00,229,588,38,855,0
신리→연산교차로,2023.8.3 11:00,479,294,66,839,0
안락→연산교차로,2023.8.3 11:00,535,0,159,694,0
연산터널→연산교차로,2023.8.3 11:00,282,321,43,646,0
교대→연산교차로,2023.8.3 12:00,273,0,439,712,0
부산시청→연산교차로,2023.8.3 12:00,585,369,262,1216,0
사직운동장→연산교차로,2023.8.3 12:00,252,565,0,817,0
신리→연산교차로,2023.8.3 12:00,443,305,36,784,0
안락→연산교차로,2023.8.3 12:00,473,0,160,633,0
연산터널→연산교차로,2023.8.3 12:00,269,314,54,637,0
교대→연산교차로,2023.8.3 13:00,332,0,430,762,0
부산시청→연산교차로,2023.8.3 13:00,608,433,276,1317,0
사직운동장→연산교차로,2023.8.3 13:00,296,611,1,908,0
신리→연산교차로,2023.8.3 13:00,446,319,48,813,0
안락→연산교차로,2023.8.3 13:00,408,0,119,527,0
연산터널→연산교차로,2023.8.3 13:00,245,275,29,549,0
교대→연산교차로,2023.8.3 14:00,364,0,446,810,0
부산시청→연산교차로,2023.8.3 14:00,698,480,361,1539,0
사직운동장→연산교차로,2023.8.3 14:00,281,638,0,919,0
신리→연산교차로,2023.8.3 14:00,408,321,48,777,0
안락→연산교차로,2023.8.3 14:00,368,0,96,464,0
연산터널→연산교차로,2023.8.3 14:00,222,277,56,555,0
교대→연산교차로,2023.8.3 15:00,348,0,414,762,0
부산시청→연산교차로,2023.8.3 15:00,577,486,305,1368,0
사직운동장→연산교차로,2023.8.3 15:00,286,630,0,916,0
신리→연산교차로,2023.8.3 15:00,426,351,51,828,0
안락→연산교차로,2023.8.3 15:00,387,0,118,505,0
연산터널→연산교차로,2023.8.3 15:00,254,271,42,567,0
교대→연산교차로,2023.8.3 16:00,355,0,478,833,0
부산시청→연산교차로,2023.8.3 16:00,595,499,303,1397,0
사직운동장→연산교차로,2023.8.3 16:00,279,632,0,911,0
신리→연산교차로,2023.8.3 16:00,482,343,43,868,0
안락→연산교차로,2023.8.3 16:00,441,0,100,541,0
연산터널→연산교차로,2023.8.3 16:00,250,273,38,561,0
교대→연산교차로,2023.8.3 17:00,379,0,507,886,0
부산시청→연산교차로,2023.8.3 17:00,644,533,316,1493,0
사직운동장→연산교차로,2023.8.3 17:00,270,667,1,938,0
신리→연산교차로,2023.8.3 17:00,526,274,60,860,0
안락→연산교차로,2023.8.3 17:00,455,0,105,560,0
연산터널→연산교차로,2023.8.3 17:00,209,294,38,541,0
교대→연산교차로,2023.8.3 18:00,356,0,533,889,0
부산시청→연산교차로,2023.8.3 18:00,624,557,322,1503,0
사직운동장→연산교차로,2023.8.3 18:00,250,697,0,947,0
신리→연산교차로,2023.8.3 18:00,467,321,56,844,0
안락→연산교차로,2023.8.3 18:00,463,0,83,546,0
연산터널→연산교차로,2023.8.3 18:00,225,268,46,539,0
교대→연산교차로,2023.8.3 19:00,333,0,390,723,0
부산시청→연산교차로,2023.8.3 19:00,549,401,286,1236,0
사직운동장→연산교차로,2023.8.3 19:00,259,597,28,884,0
신리→연산교차로,2023.8.3 19:00,365,230,47,642,0
안락→연산교차로,2023.8.3 19:00,427,0,93,520,0
연산터널→연산교차로,2023.8.3 19:00,217,263,66,546,0
교대→연산교차로,2023.8.3 20:00,321,0,370,691,0
부산시청→연산교차로,2023.8.3 20:00,506,376,213,1095,0
사직운동장→연산교차로,2023.8.3 20:00,262,539,55,856,0
신리→연산교차로,2023.8.3 20:00,325,194,41,560,0
안락→연산교차로,2023.8.3 20:00,411,0,100,511,0
연산터널→연산교차로,2023.8.3 20:00,173,285,61,519,0
교대→연산교차로,2023.8.3 21:00,286,0,277,563,0
부산시청→연산교차로,2023.8.3 21:00,425,325,214,964,0
사직운동장→연산교차로,2023.8.3 21:00,208,493,58,759,0
신리→연산교차로,2023.8.3 21:00,301,227,31,559,0
안락→연산교차로,2023.8.3 21:00,385,0,103,488,0
연산터널→연산교차로,2023.8.3 21:00,235,282,60,577,0
교대→연산교차로,2023.8.3 22:00,274,0,234,508,0
부산시청→연산교차로,2023.8.3 22:00,396,281,151,828,0
사직운동장→연산교차로,2023.8.3 22:00,168,391,55,614,0
신리→연산교차로,2023.8.3 22:00,250,191,19,460,0
안락→연산교차로,2023.8.3 22:00,313,0,88,401,0
연산터널→연산교차로,2023.8.3 22:00,204,206,49,459,0
교대→연산교차로,2023.8.3 23:00,199,0,196,395,0
부산시청→연산교차로,2023.8.3 23:00,316,194,136,646,0
사직운동장→연산교차로,2023.8.3 23:00,108,267,90,465,0
신리→연산교차로,2023.8.3 23:00,219,143,18,380,0
안락→연산교차로,2023.8.3 23:00,265,0,84,349,0
연산터널→연산교차로,2023.8.3 23:00,141,173,60,374,0
교대→연산교차로,2023.8.4 00:00,138,0,186,324,0
부산시청→연산교차로,2023.8.4 00:00,227,159,114,500,0
사직운동장→연산교차로,2023.8.4 00:00,82,235,63,380,0
신리→연산교차로,2023.8.4 00:00,168,128,15,311,0
안락→연산교차로,2023.8.4 00:00,222,0,71,293,0
연산터널→연산교차로,2023.8.4 00:00,144,177,59,380,0
교대→연산교차로,2023.8.4 01:00,107,0,153,260,0
부산시청→연산교차로,2023.8.4 01:00,182,101,64,347,0
사직운동장→연산교차로,2023.8.4 01:00,65,179,47,291,0
신리→연산교차로,2023.8.4 01:00,129,76,23,228,0
안락→연산교차로,2023.8.4 01:00,148,0,31,179,0
연산터널→연산교차로,2023.8.4 01:00,99,126,42,267,0
교대→연산교차로,2023.8.4 02:00,99,0,147,246,0
부산시청→연산교차로,2023.8.4 02:00,167,72,69,308,0
사직운동장→연산교차로,2023.8.4 02:00,42,176,40,258,0
신리→연산교차로,2023.8.4 02:00,89,62,11,162,0
안락→연산교차로,2023.8.4 02:00,131,0,38,169,0
연산터널→연산교차로,2023.8.4 02:00,100,94,36,230,0
교대→연산교차로,2023.8.4 03:00,67,0,122,189,0
부산시청→연산교차로,2023.8.4 03:00,142,78,53,273,0
사직운동장→연산교차로,2023.8.4 03:00,31,135,32,198,0
신리→연산교차로,2023.8.4 03:00,77,48,16,141,0
안락→연산교차로,2023.8.4 03:00,116,0,34,150,0
연산터널→연산교차로,2023.8.4 03:00,81,85,40,206,0
교대→연산교차로,2023.8.4 04:00,61,0,85,146,0
부산시청→연산교차로,2023.8.4 04:00,176,80,40,296,0
사직운동장→연산교차로,2023.8.4 04:00,22,110,29,161,0
신리→연산교차로,2023.8.4 04:00,83,33,6,122,0
안락→연산교차로,2023.8.4 04:00,180,0,37,217,0
연산터널→연산교차로,2023.8.4 04:00,63,89,25,177,0
교대→연산교차로,2023.8.4 05:00,100,0,138,238,0
부산시청→연산교차로,2023.8.4 05:00,242,137,60,439,0
사직운동장→연산교차로,2023.8.4 05:00,62,180,39,281,0
신리→연산교차로,2023.8.4 05:00,195,102,11,308,0
안락→연산교차로,2023.8.4 05:00,296,0,60,356,0
연산터널→연산교차로,2023.8.4 05:00,120,164,34,318,0
교대→연산교차로,2023.8.4 06:00,161,0,181,342,0
부산시청→연산교차로,2023.8.4 06:00,353,229,131,713,0
사직운동장→연산교차로,2023.8.4 06:00,80,283,46,409,0
신리→연산교차로,2023.8.4 06:00,330,178,21,529,0
안락→연산교차로,2023.8.4 06:00,457,0,78,535,0
연산터널→연산교차로,2023.8.4 06:00,206,217,38,461,0
교대→연산교차로,2023.8.4 07:00,232,0,285,517,0
부산시청→연산교차로,2023.8.4 07:00,466,302,205,973,0
사직운동장→연산교차로,2023.8.4 07:00,157,454,40,651,0
신리→연산교차로,2023.8.4 07:00,413,265,30,708,0
안락→연산교차로,2023.8.4 07:00,560,0,93,653,0
연산터널→연산교차로,2023.8.4 07:00,282,302,48,632,0
교대→연산교차로,2023.8.4 08:00,278,0,482,760,0
부산시청→연산교차로,2023.8.4 08:00,583,411,377,1371,0
사직운동장→연산교차로,2023.8.4 08:00,200,637,61,898,0
신리→연산교차로,2023.8.4 08:00,490,339,24,853,0
안락→연산교차로,2023.8.4 08:00,607,0,110,717,0
연산터널→연산교차로,2023.8.4 08:00,301,370,35,706,0
교대→연산교차로,2023.8.4 09:00,304,0,453,757,0
부산시청→연산교차로,2023.8.4 09:00,506,363,289,1158,0
사직운동장→연산교차로,2023.8.4 09:00,207,565,100,872,0
신리→연산교차로,2023.8.4 09:00,496,318,55,869,0
안락→연산교차로,2023.8.4 09:00,567,0,142,709,0
연산터널→연산교차로,2023.8.4 09:00,307,355,49,711,0
교대→연산교차로,2023.8.4 10:00,293,0,487,780,0
부산시청→연산교차로,2023.8.4 10:00,543,361,293,1197,0
사직운동장→연산교차로,2023.8.4 10:00,205,582,55,842,0
신리→연산교차로,2023.8.4 10:00,456,298,63,817,0
안락→연산교차로,2023.8.4 10:00,543,0,159,702,0
연산터널→연산교차로,2023.8.4 10:00,298,338,61,697,0
교대→연산교차로,2023.8.4 11:00,295,0,443,738,0
부산시청→연산교차로,2023.8.4 11:00,595,386,284,1265,0
사직운동장→연산교차로,2023.8.4 11:00,197,573,53,823,0
신리→연산교차로,2023.8.4 11:00,478,285,62,825,0
안락→연산교차로,2023.8.4 11:00,532,0,145,677,0
연산터널→연산교차로,2023.8.4 11:00,274,297,56,627,0
교대→연산교차로,2023.8.4 12:00,299,0,450,749,0
부산시청→연산교차로,2023.8.4 12:00,588,374,272,1234,0
사직운동장→연산교차로,2023.8.4 12:00,198,575,61,834,0
신리→연산교차로,2023.8.4 12:00,435,318,57,810,0
안락→연산교차로,2023.8.4 12:00,526,0,173,699,0
연산터널→연산교차로,2023.8.4 12:00,296,279,55,630,0
교대→연산교차로,2023.8.4 13:00,355,0,427,782,0
부산시청→연산교차로,2023.8.4 13:00,612,438,301,1351,0
사직운동장→연산교차로,2023.8.4 13:00,220,587,69,876,0
신리→연산교차로,2023.8.4 13:00,465,273,59,797,0
안락→연산교차로,2023.8.4 13:00,439,0,124,563,0
연산터널→연산교차로,2023.8.4 13:00,235,292,34,561,0
교대→연산교차로,2023.8.4 14:00,318,0,459,777,0
부산시청→연산교차로,2023.8.4 14:00,596,466,304,1366,0
사직운동장→연산교차로,2023.8.4 14:00,224,662,64,950,0
신리→연산교차로,2023.8.4 14:00,438,314,81,833,0
안락→연산교차로,2023.8.4 14:00,442,0,102,544,0
연산터널→연산교차로,2023.8.4 14:00,231,286,53,570,0
교대→연산교차로,2023.8.4 15:00,372,0,445,817,0
부산시청→연산교차로,2023.8.4 15:00,589,483,288,1360,0
사직운동장→연산교차로,2023.8.4 15:00,218,632,83,933,0
신리→연산교차로,2023.8.4 15:00,481,273,60,814,0
안락→연산교차로,2023.8.4 15:00,444,0,116,560,0
연산터널→연산교차로,2023.8.4 15:00,229,263,59,551,0
교대→연산교차로,2023.8.4 16:00,361,0,439,800,0
부산시청→연산교차로,2023.8.4 16:00,566,509,338,1413,0
사직운동장→연산교차로,2023.8.4 16:00,226,675,73,974,0
신리→연산교차로,2023.8.4 16:00,504,316,59,879,0
안락→연산교차로,2023.8.4 16:00,455,0,104,559,0
연산터널→연산교차로,2023.8.4 16:00,227,282,47,556,0
교대→연산교차로,2023.8.4 17:00,361,0,504,865,0
부산시청→연산교차로,2023.8.4 17:00,636,539,304,1479,0
사직운동장→연산교차로,2023.8.4 17:00,244,695,46,985,0
신리→연산교차로,2023.8.4 17:00,493,319,52,864,0
안락→연산교차로,2023.8.4 17:00,445,0,97,542,0
연산터널→연산교차로,2023.8.4 17:00,234,257,38,529,0
교대→연산교차로,2023.8.4 18:00,369,0,526,895,0
부산시청→연산교차로,2023.8.4 18:00,616,584,352,1552,0
사직운동장→연산교차로,2023.8.4 18:00,231,682,44,957,0
신리→연산교차로,2023.8.4 18:00,550,277,45,872,0
안락→연산교차로,2023.8.4 18:00,447,0,104,551,0
연산터널→연산교차로,2023.8.4 18:00,195,287,56,538,0
교대→연산교차로,2023.8.4 19:00,331,0,399,730,0
부산시청→연산교차로,2023.8.4 19:00,523,395,281,1199,0
사직운동장→연산교차로,2023.8.4 19:00,226,564,71,861,0
신리→연산교차로,2023.8.4 19:00,403,254,33,690,0
안락→연산교차로,2023.8.4 19:00,450,0,101,551,0
연산터널→연산교차로,2023.8.4 19:00,214,268,52,534,0
교대→연산교차로,2023.8.4 20:00,324,0,384,708,0
부산시청→연산교차로,2023.8.4 20:00,494,375,241,1110,0
사직운동장→연산교차로,2023.8.4 20:00,190,527,89,806,0
신리→연산교차로,2023.8.4 20:00,364,213,52,629,0
안락→연산교차로,2023.8.4 20:00,426,0,97,523,0
연산터널→연산교차로,2023.8.4 20:00,226,269,60,555,0
교대→연산교차로,2023.8.4 21:00,290,0,339,629,0
부산시청→연산교차로,2023.8.4 21:00,506,329,193,1028,0
사직운동장→연산교차로,2023.8.4 21:00,165,450,95,710,0
신리→연산교차로,2023.8.4 21:00,355,211,35,601,0
안락→연산교차로,2023.8.4 21:00,384,0,141,525,0
연산터널→연산교차로,2023.8.4 21:00,247,291,52,590,0
교대→연산교차로,2023.8.4 22:00,268,0,289,557,0
부산시청→연산교차로,2023.8.4 22:00,440,295,160,895,0
사직운동장→연산교차로,2023.8.4 22:00,199,472,88,759,0
신리→연산교차로,2023.8.4 22:00,326,173,28,527,0
안락→연산교차로,2023.8.4 22:00,357,0,117,474,0
연산터널→연산교차로,2023.8.4 22:00,231,249,75,555,0
교대→연산교차로,2023.8.4 23:00,212,0,230,442,0
부산시청→연산교차로,2023.8.4 23:00,357,229,141,727,0
사직운동장→연산교차로,2023.8.4 23:00,128,341,90,559,0
신리→연산교차로,2023.8.4 23:00,292,142,27,461,0
안락→연산교차로,2023.8.4 23:00,308,0,96,404,0
연산터널→연산교차로,2023.8.4 23:00,173,201,78,452,0
교대→연산교차로,2023.8.5 00:00,187,0,250,437,0
부산시청→연산교차로,2023.8.5 00:00,299,179,125,603,0
사직운동장→연산교차로,2023.8.5 00:00,109,285,74,468,0
신리→연산교차로,2023.8.5 00:00,229,138,25,392,0
안락→연산교차로,2023.8.5 00:00,273,0,49,322,0
연산터널→연산교차로,2023.8.5 00:00,151,192,54,397,0
교대→연산교차로,2023.8.5 01:00,159,0,237,396,0
부산시청→연산교차로,2023.8.5 01:00,256,153,107,516,0
사직운동장→연산교차로,2023.8.5 01:00,72,256,65,393,0
신리→연산교차로,2023.8.5 01:00,181,104,18,303,0
안락→연산교차로,2023.8.5 01:00,188,0,63,251,0
연산터널→연산교차로,2023.8.5 01:00,156,168,76,400,0
교대→연산교차로,2023.8.5 02:00,132,0,197,329,0
부산시청→연산교차로,2023.8.5 02:00,213,126,77,416,0
사직운동장→연산교차로,2023.8.5 02:00,68,194,45,307,0
신리→연산교차로,2023.8.5 02:00,147,76,18,241,0
안락→연산교차로,2023.8.5 02:00,172,0,56,228,0
연산터널→연산교차로,2023.8.5 02:00,138,150,55,343,0
교대→연산교차로,2023.8.5 03:00,88,0,145,233,0
부산시청→연산교차로,2023.8.5 03:00,202,106,64,372,0
사직운동장→연산교차로,2023.8.5 03:00,53,162,43,258,0
신리→연산교차로,2023.8.5 03:00,103,66,15,184,0
안락→연산교차로,2023.8.5 03:00,126,0,41,167,0
연산터널→연산교차로,2023.8.5 03:00,104,111,55,270,0
교대→연산교차로,2023.8.5 04:00,79,0,109,188,0
부산시청→연산교차로,2023.8.5 04:00,181,86,67,334,0
사직운동장→연산교차로,2023.8.5 04:00,44,167,41,252,0
신리→연산교차로,2023.8.5 04:00,94,62,8,164,0
안락→연산교차로,2023.8.5 04:00,200,0,30,230,0
연산터널→연산교차로,2023.8.5 04:00,95,115,33,243,0
교대→연산교차로,2023.8.5 05:00,105,0,115,220,0
부산시청→연산교차로,2023.8.5 05:00,236,144,72,452,0
사직운동장→연산교차로,2023.8.5 05:00,64,171,40,275,0
신리→연산교차로,2023.8.5 05:00,198,92,9,299,0
안락→연산교차로,2023.8.5 05:00,261,0,52,313,0
연산터널→연산교차로,2023.8.5 05:00,111,157,27,295,0
교대→연산교차로,2023.8.5 06:00,150,0,146,296,0
부산시청→연산교차로,2023.8.5 06:00,309,204,98,611,0
사직운동장→연산교차로,2023.8.5 06:00,85,221,50,356,0
신리→연산교차로,2023.8.5 06:00,253,149,20,422,0
안락→연산교차로,2023.8.5 06:00,378,0,70,448,0
연산터널→연산교차로,2023.8.5 06:00,164,182,30,376,0
교대→연산교차로,2023.8.5 07:00,175,0,175,350,0
부산시청→연산교차로,2023.8.5 07:00,339,212,141,692,0
사직운동장→연산교차로,2023.8.5 07:00,99,332,38,469,0
신리→연산교차로,2023.8.5 07:00,256,152,30,438,0
안락→연산교차로,2023.8.5 07:00,422,0,73,495,0
연산터널→연산교차로,2023.8.5 07:00,170,175,34,379,0
교대→연산교차로,2023.8.5 08:00,262,0,257,519,0
부산시청→연산교차로,2023.8.5 08:00,442,313,174,929,0
사직운동장→연산교차로,2023.8.5 08:00,180,508,43,731,0
신리→연산교차로,2023.8.5 08:00,373,259,57,689,0
안락→연산교차로,2023.8.5 08:00,467,0,101,568,0
연산터널→연산교차로,2023.8.5 08:00,243,282,22,547,0
교대→연산교차로,2023.8.5 09:00,280,0,374,654,0
부산시청→연산교차로,2023.8.5 09:00,505,350,260,1115,0
사직운동장→연산교차로,2023.8.5 09:00,183,586,64,833,0
신리→연산교차로,2023.8.5 09:00,452,287,74,813,0
안락→연산교차로,2023.8.5 09:00,534,0,174,708,0
연산터널→연산교차로,2023.8.5 09:00,304,334,48,686,0
교대→연산교차로,2023.8.5 10:00,305,0,370,675,0
부산시청→연산교차로,2023.8.5 10:00,599,381,289,1269,0
사직운동장→연산교차로,2023.8.5 10:00,204,614,51,869,0
신리→연산교차로,2023.8.5 10:00,470,288,65,823,0
안락→연산교차로,2023.8.5 10:00,515,0,202,717,0
연산터널→연산교차로,2023.8.5 10:00,305,302,61,668,0
교대→연산교차로,2023.8.5 11:00,299,0,411,710,0
부산시청→연산교차로,2023.8.5 11:00,618,394,302,1314,0
사직운동장→연산교차로,2023.8.5 11:00,211,592,42,845,0
신리→연산교차로,2023.8.5 11:00,486,268,88,842,0
안락→연산교차로,2023.8.5 11:00,531,0,200,731,0
연산터널→연산교차로,2023.8.5 11:00,324,316,67,707,0
교대→연산교차로,2023.8.5 12:00,300,0,406,706,0
부산시청→연산교차로,2023.8.5 12:00,607,377,305,1289,0
사직운동장→연산교차로,2023.8.5 12:00,199,626,36,861,0
신리→연산교차로,2023.8.5 12:00,475,304,69,848,0
안락→연산교차로,2023.8.5 12:00,538,0,195,733,0
연산터널→연산교차로,2023.8.5 12:00,297,338,41,676,0
교대→연산교차로,2023.8.5 13:00,351,0,391,742,0
부산시청→연산교차로,2023.8.5 13:00,675,457,318,1450,0
사직운동장→연산교차로,2023.8.5 13:00,206,662,48,916,0
신리→연산교차로,2023.8.5 13:00,474,304,77,855,0
안락→연산교차로,2023.8.5 13:00,460,0,110,570,0
연산터널→연산교차로,2023.8.5 13:00,251,268,52,571,0
교대→연산교차로,2023.8.5 14:00,369,0,411,780,0
부산시청→연산교차로,2023.8.5 14:00,680,475,304,1459,0
사직운동장→연산교차로,2023.8.5 14:00,208,667,57,932,0
신리→연산교차로,2023.8.5 14:00,469,280,66,815,0
안락→연산교차로,2023.8.5 14:00,457,0,124,581,0
연산터널→연산교차로,2023.8.5 14:00,228,287,51,566,0
교대→연산교차로,2023.8.5 15:00,356,0,337,693,0
부산시청→연산교차로,2023.8.5 15:00,602,422,274,1298,0
사직운동장→연산교차로,2023.8.5 15:00,210,668,50,928,0
신리→연산교차로,2023.8.5 15:00,440,278,63,781,0
안락→연산교차로,2023.8.5 15:00,423,0,129,552,0
연산터널→연산교차로,2023.8.5 15:00,227,295,48,570,0
교대→연산교차로,2023.8.5 16:00,336,0,373,709,0
부산시청→연산교차로,2023.8.5 16:00,612,449,303,1364,0
사직운동장→연산교차로,2023.8.5 16:00,210,606,84,900,0
신리→연산교차로,2023.8.5 16:00,440,331,53,824,0
안락→연산교차로,2023.8.5 16:00,443,0,76,519,0
연산터널→연산교차로,2023.8.5 16:00,239,270,49,558,0
교대→연산교차로,2023.8.5 17:00,327,0,380,707,0
부산시청→연산교차로,2023.8.5 17:00,590,428,263,1281,0
사직운동장→연산교차로,2023.8.5 17:00,237,645,73,955,0
신리→연산교차로,2023.8.5 17:00,438,309,33,780,0
안락→연산교차로,2023.8.5 17:00,460,0,92,552,0
연산터널→연산교차로,2023.8.5 17:00,232,271,53,556,0
교대→연산교차로,2023.8.5 18:00,324,0,404,728,0
부산시청→연산교차로,2023.8.5 18:00,551,393,221,1165,0
사직운동장→연산교차로,2023.8.5 18:00,224,559,67,850,0
신리→연산교차로,2023.8.5 18:00,371,213,37,621,0
안락→연산교차로,2023.8.5 18:00,451,0,90,541,0
연산터널→연산교차로,2023.8.5 18:00,202,284,52,538,0
교대→연산교차로,2023.8.5 19:00,318,0,345,663,0
부산시청→연산교차로,2023.8.5 19:00,493,356,207,1056,0
사직운동장→연산교차로,2023.8.5 19:00,173,529,96,798,0
신리→연산교차로,2023.8.5 19:00,328,185,38,551,0
안락→연산교차로,2023.8.5 19:00,397,0,132,529,0
연산터널→연산교차로,2023.8.5 19:00,223,263,67,553,0
교대→연산교차로,2023.8.5 20:00,307,0,296,603,0
부산시청→연산교차로,2023.8.5 20:00,443,322,187,952,0
사직운동장→연산교차로,2023.8.5 20:00,151,481,90,722,0
신리→연산교차로,2023.8.5 20:00,341,165,29,535,0
안락→연산교차로,2023.8.5 20:00,383,0,117,500,0
연산터널→연산교차로,2023.8.5 20:00,227,257,55,539,0
교대→연산교차로,2023.8.5 21:00,297,0,285,582,0
부산시청→연산교차로,2023.8.5 21:00,490,298,177,965,0
사직운동장→연산교차로,2023.8.5 21:00,165,427,85,677,0
신리→연산교차로,2023.8.5 21:00,338,220,35,593,0
안락→연산교차로,2023.8.5 21:00,381,0,142,523,0
연산터널→연산교차로,2023.8.5 21:00,233,262,65,560,0
교대→연산교차로,2023.8.5 22:00,252,0,239,491,0
부산시청→연산교차로,2023.8.5 22:00,379,250,164,793,0
사직운동장→연산교차로,2023.8.5 22:00,211,449,64,724,0
신리→연산교차로,2023.8.5 22:00,317,176,34,527,0
안락→연산교차로,2023.8.5 22:00,313,0,103,416,0
연산터널→연산교차로,2023.8.5 22:00,204,218,66,488,0
교대→연산교차로,2023.8.5 23:00,197,0,220,417,0
부산시청→연산교차로,2023.8.5 23:00,335,253,145,733,0
사직운동장→연산교차로,2023.8.5 23:00,136,354,76,566,0
신리→연산교차로,2023.8.5 23:00,259,149,23,431,0
안락→연산교차로,2023.8.5 23:00,287,0,74,361,0
연산터널→연산교차로,2023.8.5 23:00,188,199,62,449,0
교대→연산교차로,2023.8.6 00:00,159,0,214,373,1
부산시청→연산교차로,2023.8.6 00:00,303,193,132,628,1
사직운동장→연산교차로,2023.8.6 00:00,86,253,65,404,1
신리→연산교차로,2023.8.6 00:00,241,141,31,413,1
안락→연산교차로,2023.8.6 00:00,258,0,66,324,1
연산터널→연산교차로,2023.8.6 00:00,156,181,60,397,1
교대→연산교차로,2023.8.6 01:00,136,0,198,334,1
부산시청→연산교차로,2023.8.6 01:00,261,160,95,516,1
사직운동장→연산교차로,2023.8.6 01:00,76,200,57,333,1
신리→연산교차로,2023.8.6 01:00,170,100,12,282,1
안락→연산교차로,2023.8.6 01:00,171,0,59,230,1
연산터널→연산교차로,2023.8.6 01:00,131,193,59,383,1
교대→연산교차로,2023.8.6 02:00,113,0,165,278,1
부산시청→연산교차로,2023.8.6 02:00,209,115,79,403,1
사직운동장→연산교차로,2023.8.6 02:00,65,208,34,307,1
신리→연산교차로,2023.8.6 02:00,143,82,15,240,1
안락→연산교차로,2023.8.6 02:00,184,0,57,241,1
연산터널→연산교차로,2023.8.6 02:00,114,137,50,301,1
교대→연산교차로,2023.8.6 03:00,88,0,139,227,1
부산시청→연산교차로,2023.8.6 03:00,162,108,67,337,1
사직운동장→연산교차로,2023.8.6 03:00,43,160,56,259,1
신리→연산교차로,2023.8.6 03:00,112,61,12,185,1
안락→연산교차로,2023.8.6 03:00,120,0,49,169,1
연산터널→연산교차로,2023.8.6 03:00,89,131,48,268,1
교대→연산교차로,2023.8.6 04:00,83,0,105,188,1
부산시청→연산교차로,2023.8.6 04:00,165,87,40,292,1
사직운동장→연산교차로,2023.8.6 04:00,31,104,39,174,1
신리→연산교차로,2023.8.6 04:00,84,51,12,147,1
안락→연산교차로,2023.8.6 04:00,122,0,35,157,1
연산터널→연산교차로,2023.8.6 04:00,63,95,21,179,1
교대→연산교차로,2023.8.6 05:00,67,0,88,155,1
부산시청→연산교차로,2023.8.6 05:00,154,106,43,303,1
사직운동장→연산교차로,2023.8.6 05:00,38,120,41,199,1
신리→연산교차로,2023.8.6 05:00,121,61,14,196,1
안락→연산교차로,2023.8.6 05:00,179,0,44,223,1
연산터널→연산교차로,2023.8.6 05:00,105,117,25,247,1
교대→연산교차로,2023.8.6 06:00,116,0,102,218,1
부산시청→연산교차로,2023.8.6 06:00,205,145,62,412,1
사직운동장→연산교차로,2023.8.6 06:00,54,143,23,220,1
신리→연산교차로,2023.8.6 06:00,158,66,18,242,1
안락→연산교차로,2023.8.6 06:00,252,0,44,296,1
연산터널→연산교차로,2023.8.6 06:00,107,128,31,266,1
교대→연산교차로,2023.8.6 07:00,138,0,108,246,1
부산시청→연산교차로,2023.8.6 07:00,235,163,69,467,1
사직운동장→연산교차로,2023.8.6 07:00,76,192,39,307,1
신리→연산교차로,2023.8.6 07:00,188,83,18,289,1
안락→연산교차로,2023.8.6 07:00,213,0,48,261,1
연산터널→연산교차로,2023.8.6 07:00,128,111,34,273,1
교대→연산교차로,2023.8.6 08:00,153,0,157,310,1
부산시청→연산교차로,2023.8.6 08:00,287,211,127,625,1
사직운동장→연산교차로,2023.8.6 08:00,106,321,35,462,1
신리→연산교차로,2023.8.6 08:00,276,129,30,435,1
안락→연산교차로,2023.8.6 08:00,313,0,71,384,1
연산터널→연산교차로,2023.8.6 08:00,168,152,20,340,1
교대→연산교차로,2023.8.6 09:00,211,0,219,430,1
부산시청→연산교차로,2023.8.6 09:00,363,289,179,831,1
사직운동장→연산교차로,2023.8.6 09:00,125,446,43,614,1
신리→연산교차로,2023.8.6 09:00,390,192,33,615,1
안락→연산교차로,2023.8.6 09:00,413,0,89,502,1
연산터널→연산교차로,2023.8.6 09:00,251,217,35,503,1
교대→연산교차로,2023.8.6 10:00,267,0,212,479,1
부산시청→연산교차로,2023.8.6 10:00,436,309,187,932,1
사직운동장→연산교차로,2023.8.6 10:00,160,499,56,715,1
신리→연산교차로,2023.8.6 10:00,396,192,39,627,1
안락→연산교차로,2023.8.6 10:00,455,0,111,566,1
연산터널→연산교차로,2023.8.6 10:00,278,246,43,567,1
교대→연산교차로,2023.8.6 11:00,266,0,295,561,1
부산시청→연산교차로,2023.8.6 11:00,452,349,185,986,1
사직운동장→연산교차로,2023.8.6 11:00,178,515,50,743,1
신리→연산교차로,2023.8.6 11:00,405,217,42,664,1
안락→연산교차로,2023.8.6 11:00,473,0,123,596,1
연산터널→연산교차로,2023.8.6 11:00,249,270,35,554,1
교대→연산교차로,2023.8.6 12:00,272,0,231,503,1
부산시청→연산교차로,2023.8.6 12:00,491,348,236,1075,1
사직운동장→연산교차로,2023.8.6 12:00,181,567,53,801,1
신리→연산교차로,2023.8.6 12:00,400,235,38,673,1
안락→연산교차로,2023.8.6 12:00,475,0,157,632,1
연산터널→연산교차로,2023.8.6 12:00,274,236,47,557,1
교대→연산교차로,2023.8.6 13:00,296,0,295,591,1
부산시청→연산교차로,2023.8.6 13:00,525,356,209,1090,1
사직운동장→연산교차로,2023.8.6 13:00,205,525,33,763,1
신리→연산교차로,2023.8.6 13:00,414,237,46,697,1
안락→연산교차로,2023.8.6 13:00,470,0,142,612,1
연산터널→연산교차로,2023.8.6 13:00,273,264,43,580,1
교대→연산교차로,2023.8.6 14:00,273,0,273,546,1
부산시청→연산교차로,2023.8.6 14:00,502,342,251,1095,1
사직운동장→연산교차로,2023.8.6 14:00,177,544,46,767,1
신리→연산교차로,2023.8.6 14:00,389,218,51,658,1
안락→연산교차로,2023.8.6 14:00,498,0,120,618,1
연산터널→연산교차로,2023.8.6 14:00,219,262,40,521,1
교대→연산교차로,2023.8.6 15:00,297,0,286,583,1
부산시청→연산교차로,2023.8.6 15:00,480,341,213,1034,1
사직운동장→연산교차로,2023.8.6 15:00,191,506,51,748,1
신리→연산교차로,2023.8.6 15:00,386,244,39,669,1
안락→연산교차로,2023.8.6 15:00,514,0,138,652,1
연산터널→연산교차로,2023.8.6 15:00,247,270,40,557,1
교대→연산교차로,2023.8.6 16:00,303,0,293,596,1
부산시청→연산교차로,2023.8.6 16:00,493,331,221,1045,1
사직운동장→연산교차로,2023.8.6 16:00,194,502,36,732,1
신리→연산교차로,2023.8.6 16:00,385,258,30,673,1
안락→연산교차로,2023.8.6 16:00,473,0,146,619,1
연산터널→연산교차로,2023.8.6 16:00,272,276,37,585,1
교대→연산교차로,2023.8.6 17:00,283,0,265,548,1
부산시청→연산교차로,2023.8.6 17:00,430,339,214,983,1
사직운동장→연산교차로,2023.8.6 17:00,193,529,55,777,1
신리→연산교차로,2023.8.6 17:00,348,236,38,622,1
안락→연산교차로,2023.8.6 17:00,497,0,149,646,1
연산터널→연산교차로,2023.8.6 17:00,243,246,49,538,1
교대→연산교차로,2023.8.6 18:00,286,0,269,555,1
부산시청→연산교차로,2023.8.6 18:00,504,298,215,1017,1
사직운동장→연산교차로,2023.8.6 18:00,169,455,56,680,1
신리→연산교차로,2023.8.6 18:00,335,172,49,556,1
안락→연산교차로,2023.8.6 18:00,427,0,131,558,1
연산터널→연산교차로,2023.8.6 18:00,239,239,61,539,1
교대→연산교차로,2023.8.6 19:00,269,0,276,545,1
부산시청→연산교차로,2023.8.6 19:00,415,300,181,896,1
사직운동장→연산교차로,2023.8.6 19:00,185,443,56,684,1
신리→연산교차로,2023.8.6 19:00,274,184,37,495,1
안락→연산교차로,2023.8.6 19:00,363,0,133,496,1
연산터널→연산교차로,2023.8.6 19:00,221,239,54,514,1
교대→연산교차로,2023.8.6 20:00,294,0,276,570,1
부산시청→연산교차로,2023.8.6 20:00,387,273,189,849,1
사직운동장→연산교차로,2023.8.6 20:00,214,431,52,697,1
신리→연산교차로,2023.8.6 20:00,303,175,27,505,1
안락→연산교차로,2023.8.6 20:00,391,0,107,498,1
연산터널→연산교차로,2023.8.6 20:00,205,236,48,489,1
교대→연산교차로,2023.8.6 21:00,236,0,233,469,1
부산시청→연산교차로,2023.8.6 21:00,417,241,148,806,1
사직운동장→연산교차로,2023.8.6 21:00,126,371,59,556,1
신리→연산교차로,2023.8.6 21:00,289,173,33,495,1
안락→연산교차로,2023.8.6 21:00,342,0,90,432,1
연산터널→연산교차로,2023.8.6 21:00,177,198,45,420,1
교대→연산교차로,2023.8.6 22:00,231,0,206,437,1
부산시청→연산교차로,2023.8.6 22:00,301,193,136,630,1
사직운동장→연산교차로,2023.8.6 22:00,107,317,55,479,1
신리→연산교차로,2023.8.6 22:00,237,153,25,415,1
안락→연산교차로,2023.8.6 22:00,268,0,74,342,1
연산터널→연산교차로,2023.8.6 22:00,150,194,69,413,1
교대→연산교차로,2023.8.6 23:00,137,0,155,292,1
부산시청→연산교차로,2023.8.6 23:00,242,153,101,496,1
사직운동장→연산교차로,2023.8.6 23:00,62,213,55,330,1
신리→연산교차로,2023.8.6 23:00,181,104,25,310,1
안락→연산교차로,2023.8.6 23:00,218,0,55,273,1
연산터널→연산교차로,2023.8.6 23:00,125,147,66,338,1
교대→연산교차로,2023.8.7 00:00,105,0,161,266,0
부산시청→연산교차로,2023.8.7 00:00,182,121,86,389,0
사직운동장→연산교차로,2023.8.7 00:00,55,186,43,284,0
신리→연산교차로,2023.8.7 00:00,138,69,15,222,0
안락→연산교차로,2023.8.7 00:00,172,0,38,210,0
연산터널→연산교차로,2023.8.7 00:00,99,131,57,287,0
교대→연산교차로,2023.8.7 01:00,83,0,100,183,0
부산시청→연산교차로,2023.8.7 01:00,160,94,66,320,0
사직운동장→연산교차로,2023.8.7 01:00,41,129,37,207,0
신리→연산교차로,2023.8.7 01:00,82,53,15,150,0
안락→연산교차로,2023.8.7 01:00,123,0,33,156,0
연산터널→연산교차로,2023.8.7 01:00,81,107,61,249,0
교대→연산교차로,2023.8.7 02:00,49,0,84,133,0
부산시청→연산교차로,2023.8.7 02:00,124,76,49,249,0
사직운동장→연산교차로,2023.8.7 02:00,28,106,29,163,0
신리→연산교차로,2023.8.7 02:00,68,45,14,127,0
안락→연산교차로,2023.8.7 02:00,104,0,18,122,0
연산터널→연산교차로,2023.8.7 02:00,56,80,39,175,0
교대→연산교차로,2023.8.7 03:00,54,0,81,135,0
부산시청→연산교차로,2023.8.7 03:00,123,64,47,234,0
사직운동장→연산교차로,2023.8.7 03:00,20,103,25,148,0
신리→연산교차로,2023.8.7 03:00,61,32,11,104,0
안락→연산교차로,2023.8.7 03:00,94,0,26,120,0
연산터널→연산교차로,2023.8.7 03:00,54,68,29,151,0
교대→연산교차로,2023.8.7 04:00,39,0,61,100,0
부산시청→연산교차로,2023.8.7 04:00,123,75,31,229,0
사직운동장→연산교차로,2023.8.7 04:00,25,88,17,130,0
신리→연산교차로,2023.8.7 04:00,75,37,7,119,0
안락→연산교차로,2023.8.7 04:00,142,0,32,174,0
연산터널→연산교차로,2023.8.7 04:00,58,73,17,148,0
교대→연산교차로,2023.8.7 05:00,77,0,112,189,0
부산시청→연산교차로,2023.8.7 05:00,207,154,68,429,0
사직운동장→연산교차로,2023.8.7 05:00,52,162,33,247,0
신리→연산교차로,2023.8.7 05:00,198,97,12,307,0
안락→연산교차로,2023.8.7 05:00,282,0,53,335,0
연산터널→연산교차로,2023.8.7 05:00,112,138,24,274,0
교대→연산교차로,2023.8.7 06:00,140,0,220,360,0
부산시청→연산교차로,2023.8.7 06:00,342,253,117,712,0
사직운동장→연산교차로,2023.8.7 06:00,91,271,46,408,0
신리→연산교차로,2023.8.7 06:00,348,199,21,568,0
안락→연산교차로,2023.8.7 06:00,478,0,84,562,0
연산터널→연산교차로,2023.8.7 06:00,212,241,29,482,0
교대→연산교차로,2023.8.7 07:00,244,0,362,606,0
부산시청→연산교차로,2023.8.7 07:00,502,347,213,1062,0
사직운동장→연산교차로,2023.8.7 07:00,183,495,58,736,0
신리→연산교차로,2023.8.7 07:00,440,295,23,758,0
안락→연산교차로,2023.8.7 07:00,623,0,87,710,0
연산터널→연산교차로,2023.8.7 07:00,281,351,41,673,0
교대→연산교차로,2023.8.7 08:00,282,0,517,799,0
부산시청→연산교차로,2023.8.7 08:00,559,429,345,1333,0
사직운동장→연산교차로,2023.8.7 08:00,185,652,62,899,0
신리→연산교차로,2023.8.7 08:00,497,354,26,877,0
안락→연산교차로,2023.8.7 08:00,614,0,98,712,0
연산터널→연산교차로,2023.8.7 08:00,320,375,22,717,0
교대→연산교차로,2023.8.7 09:00,304,0,473,777,0
부산시청→연산교차로,2023.8.7 09:00,507,392,315,1214,0
사직운동장→연산교차로,2023.8.7 09:00,179,601,91,871,0
신리→연산교차로,2023.8.7 09:00,457,350,43,850,0
안락→연산교차로,2023.8.7 09:00,558,0,143,701,0
연산터널→연산교차로,2023.8.7 09:00,316,376,40,732,0
교대→연산교차로,2023.8.7 10:00,276,0,424,700,0
부산시청→연산교차로,2023.8.7 10:00,587,364,317,1268,0
사직운동장→연산교차로,2023.8.7 10:00,204,583,50,837,0
신리→연산교차로,2023.8.7 10:00,454,289,69,812,0
안락→연산교차로,2023.8.7 10:00,541,0,184,725,0
연산터널→연산교차로,2023.8.7 10:00,297,338,57,692,0
교대→연산교차로,2023.8.7 11:00,302,0,459,761,0
부산시청→연산교차로,2023.8.7 11:00,571,377,281,1229,0
사직운동장→연산교차로,2023.8.7 11:00,178,591,72,841,0
신리→연산교차로,2023.8.7 11:00,524,271,58,853,0
안락→연산교차로,2023.8.7 11:00,515,0,195,710,0
연산터널→연산교차로,2023.8.7 11:00,264,326,50,640,0
교대→연산교차로,2023.8.7 12:00,322,0,413,735,0
부산시청→연산교차로,2023.8.7 12:00,544,374,254,1172,0
사직운동장→연산교차로,2023.8.7 12:00,203,556,55,814,0
신리→연산교차로,2023.8.7 12:00,445,273,47,765,0
안락→연산교차로,2023.8.7 12:00,511,0,151,662,0
연산터널→연산교차로,2023.8.7 12:00,276,293,51,620,0
교대→연산교차로,2023.8.7 13:00,337,0,460,797,0
부산시청→연산교차로,2023.8.7 13:00,589,444,283,1316,0
사직운동장→연산교차로,2023.8.7 13:00,232,609,52,893,0
신리→연산교차로,2023.8.7 13:00,417,308,53,778,0
안락→연산교차로,2023.8.7 13:00,442,0,115,557,0
연산터널→연산교차로,2023.8.7 13:00,221,292,34,547,0
교대→연산교차로,2023.8.7 14:00,342,0,480,822,0
부산시청→연산교차로,2023.8.7 14:00,597,453,295,1345,0
사직운동장→연산교차로,2023.8.7 14:00,231,633,79,943,0
신리→연산교차로,2023.8.7 14:00,449,280,76,805,0
안락→연산교차로,2023.8.7 14:00,429,0,110,539,0
연산터널→연산교차로,2023.8.7 14:00,235,287,43,565,0
교대→연산교차로,2023.8.7 15:00,342,0,453,795,0
부산시청→연산교차로,2023.8.7 15:00,593,504,297,1394,0
사직운동장→연산교차로,2023.8.7 15:00,227,650,76,953,0
신리→연산교차로,2023.8.7 15:00,426,292,55,773,0
안락→연산교차로,2023.8.7 15:00,441,0,121,562,0
연산터널→연산교차로,2023.8.7 15:00,226,289,50,565,0
교대→연산교차로,2023.8.7 16:00,384,0,481,865,0
부산시청→연산교차로,2023.8.7 16:00,600,527,309,1436,0
사직운동장→연산교차로,2023.8.7 16:00,228,669,72,969,0
신리→연산교차로,2023.8.7 16:00,466,303,62,831,0
안락→연산교차로,2023.8.7 16:00,445,0,128,573,0
연산터널→연산교차로,2023.8.7 16:00,239,261,44,544,0
교대→연산교차로,2023.8.7 17:00,370,0,543,913,0
부산시청→연산교차로,2023.8.7 17:00,613,551,341,1505,0
사직운동장→연산교차로,2023.8.7 17:00,244,704,40,988,0
신리→연산교차로,2023.8.7 17:00,502,283,52,837,0
안락→연산교차로,2023.8.7 17:00,455,0,121,576,0
연산터널→연산교차로,2023.8.7 17:00,238,269,36,543,0
교대→연산교차로,2023.8.7 18:00,372,0,530,902,0
부산시청→연산교차로,2023.8.7 18:00,618,572,347,1537,0
사직운동장→연산교차로,2023.8.7 18:00,238,701,50,989,0
신리→연산교차로,2023.8.7 18:00,517,269,43,829,0
안락→연산교차로,2023.8.7 18:00,454,0,117,571,0
연산터널→연산교차로,2023.8.7 18:00,264,264,31,559,0
교대→연산교차로,2023.8.7 19:00,321,0,453,774,0
부산시청→연산교차로,2023.8.7 19:00,523,383,277,1183,0
사직운동장→연산교차로,2023.8.7 19:00,192,578,77,847,0
신리→연산교차로,2023.8.7 19:00,357,212,50,619,0
안락→연산교차로,2023.8.7 19:00,385,0,119,504,0
연산터널→연산교차로,2023.8.7 19:00,228,247,50,525,0
교대→연산교차로,2023.8.7 20:00,309,0,335,644,0
부산시청→연산교차로,2023.8.7 20:00,466,328,246,1040,0
사직운동장→연산교차로,2023.8.7 20:00,175,474,86,735,0
신리→연산교차로,2023.8.7 20:00,308,208,35,551,0
안락→연산교차로,2023.8.7 20:00,391,0,98,489,0
연산터널→연산교차로,2023.8.7 20:00,222,265,59,546,0
교대→연산교차로,2023.8.7 21:00,262,0,287,549,0
부산시청→연산교차로,2023.8.7 21:00,476,295,199,970,0
사직운동장→연산교차로,2023.8.7 21:00,162,390,76,628,0
신리→연산교차로,2023.8.7 21:00,286,152,22,460,0
안락→연산교차로,2023.8.7 21:00,344,0,125,469,0
연산터널→연산교차로,2023.8.7 21:00,209,267,47,523,0
교대→연산교차로,2023.8.7 22:00,228,0,249,477,0
부산시청→연산교차로,2023.8.7 22:00,370,252,155,777,0
사직운동장→연산교차로,2023.8.7 22:00,126,348,79,553,0
신리→연산교차로,2023.8.7 22:00,234,162,20,416,0
안락→연산교차로,2023.8.7 22:00,312,0,86,398,0
연산터널→연산교차로,2023.8.7 22:00,199,233,57,489,0
교대→연산교차로,2023.8.7 23:00,154,0,195,349,0
부산시청→연산교차로,2023.8.7 23:00,280,181,127,588,0
사직운동장→연산교차로,2023.8.7 23:00,79,308,76,463,0
신리→연산교차로,2023.8.7 23:00,186,138,28,352,0
안락→연산교차로,2023.8.7 23:00,223,0,76,299,0
연산터널→연산교차로,2023.8.7 23:00,148,183,61,392,0
교대→연산교차로,2023.8.8 00:00,111,0,157,268,0
부산시청→연산교차로,2023.8.8 00:00,229,131,84,444,0
사직운동장→연산교차로,2023.8.8 00:00,59,232,56,347,0
신리→연산교차로,2023.8.8 00:00,148,80,17,245,0
안락→연산교차로,2023.8.8 00:00,193,0,41,234,0
연산터널→연산교차로,2023.8.8 00:00,130,155,70,355,0
교대→연산교차로,2023.8.8 01:00,95,0,117,212,0
부산시청→연산교차로,2023.8.8 01:00,164,94,81,339,0
사직운동장→연산교차로,2023.8.8 01:00,54,153,45,252,0
신리→연산교차로,2023.8.8 01:00,113,72,14,199,0
안락→연산교차로,2023.8.8 01:00,144,0,36,180,0
연산터널→연산교차로,2023.8.8 01:00,87,129,58,274,0
교대→연산교차로,2023.8.8 02:00,67,0,116,183,0
부산시청→연산교차로,2023.8.8 02:00,163,85,58,306,0
사직운동장→연산교차로,2023.8.8 02:00,36,148,30,214,0
신리→연산교차로,2023.8.8 02:00,84,41,24,149,0
안락→연산교차로,2023.8.8 02:00,118,0,34,152,0
연산터널→연산교차로,2023.8.8 02:00,93,102,61,256,0
교대→연산교차로,2023.8.8 03:00,59,0,96,155,0
부산시청→연산교차로,2023.8.8 03:00,132,75,51,258,0
사직운동장→연산교차로,2023.8.8 03:00,26,125,29,180,0
신리→연산교차로,2023.8.8 03:00,76,40,10,126,0
안락→연산교차로,2023.8.8 03:00,108,0,32,140,0
연산터널→연산교차로,2023.8.8 03:00,79,74,49,202,0
교대→연산교차로,2023.8.8 04:00,57,0,78,135,0
부산시청→연산교차로,2023.8.8 04:00,134,81,47,262,0
사직운동장→연산교차로,2023.8.8 04:00,27,117,29,173,0
신리→연산교차로,2023.8.8 04:00,87,46,9,142,0
안락→연산교차로,2023.8.8 04:00,154,0,34,188,0
연산터널→연산교차로,2023.8.8 04:00,84,86,40,210,0
교대→연산교차로,2023.8.8 05:00,88,0,119,207,0
부산시청→연산교차로,2023.8.8 05:00,242,139,64,445,0
사직운동장→연산교차로,2023.8.8 05:00,48,213,41,302,0
신리→연산교차로,2023.8.8 05:00,199,84,15,298,0
안락→연산교차로,2023.8.8 05:00,282,0,61,343,0
연산터널→연산교차로,2023.8.8 05:00,151,145,34,330,0
교대→연산교차로,2023.8.8 06:00,162,0,227,389,0
부산시청→연산교차로,2023.8.8 06:00,329,232,138,699,0
사직운동장→연산교차로,2023.8.8 06:00,76,276,50,402,0
신리→연산교차로,2023.8.8 06:00,333,194,22,549,0
안락→연산교차로,2023.8.8 06:00,497,0,102,599,0
연산터널→연산교차로,2023.8.8 06:00,222,230,50,502,0
교대→연산교차로,2023.8.8 07:00,229,0,368,597,0
부산시청→연산교차로,2023.8.8 07:00,522,343,216,1081,0
사직운동장→연산교차로,2023.8.8 07:00,161,503,77,741,0
신리→연산교차로,2023.8.8 07:00,437,311,29,777,0
안락→연산교차로,2023.8.8 07:00,597,0,98,695,0
연산터널→연산교차로,2023.8.8 07:00,288,368,41,697,0
교대→연산교차로,2023.8.8 08:00,331,0,531,862,0
부산시청→연산교차로,2023.8.8 08:00,570,438,303,1311,0
사직운동장→연산교차로,2023.8.8 08:00,169,632,72,873,0
신리→연산교차로,2023.8.8 08:00,483,341,37,861,0
안락→연산교차로,2023.8.8 08:00,635,0,83,718,0
연산터널→연산교차로,2023.8.8 08:00,316,388,42,746,0
교대→연산교차로,2023.8.8 09:00,299,0,533,832,0
부산시청→연산교차로,2023.8.8 09:00,513,377,291,1181,0
사직운동장→연산교차로,2023.8.8 09:00,151,565,86,802,0
신리→연산교차로,2023.8.8 09:00,453,332,54,839,0
안락→연산교차로,2023.8.8 09:00,602,0,119,721,0
연산터널→연산교차로,2023.8.8 09:00,278,371,52,701,0
교대→연산교차로,2023.8.8 10:00,298,0,464,762,0
부산시청→연산교차로,2023.8.8 10:00,555,370,302,1227,0
사직운동장→연산교차로,2023.8.8 10:00,192,598,58,848,0
신리→연산교차로,2023.8.8 10:00,466,302,60,828,0
안락→연산교차로,2023.8.8 10:00,571,0,146,717,0
연산터널→연산교차로,2023.8.8 10:00,321,337,60,718,0
교대→연산교차로,2023.8.8 11:00,293,0,499,792,0
부산시청→연산교차로,2023.8.8 11:00,586,382,296,1264,0
사직운동장→연산교차로,2023.8.8 11:00,182,588,76,846,0
신리→연산교차로,2023.8.8 11:00,472,277,69,818,0
안락→연산교차로,2023.8.8 11:00,498,0,195,693,0
연산터널→연산교차로,2023.8.8 11:00,278,312,62,652,0
교대→연산교차로,2023.8.8 12:00,308,0,443,751,0
부산시청→연산교차로,2023.8.8 12:00,550,370,263,1183,0
사직운동장→연산교차로,2023.8.8 12:00,199,597,55,851,0
신리→연산교차로,2023.8.8 12:00,408,246,58,712,0
안락→연산교차로,2023.8.8 12:00,457,0,174,631,0
연산터널→연산교차로,2023.8.8 12:00,279,305,49,633,0
교대→연산교차로,2023.8.8 13:00,344,0,447,791,0
부산시청→연산교차로,2023.8.8 13:00,600,427,279,1306,0
사직운동장→연산교차로,2023.8.8 13:00,237,564,68,869,0
신리→연산교차로,2023.8.8 13:00,358,243,38,639,0
안락→연산교차로,2023.8.8 13:00,460,0,118,578,0
연산터널→연산교차로,2023.8.8 13:00,231,260,50,541,0
교대→연산교차로,2023.8.8 14:00,319,0,441,760,0
부산시청→연산교차로,2023.8.8 14:00,614,487,271,1372,0
사직운동장→연산교차로,2023.8.8 14:00,201,584,83,868,0
신리→연산교차로,2023.8.8 14:00,405,236,42,683,0
안락→연산교차로,2023.8.8 14:00,445,0,107,552,0
연산터널→연산교차로,2023.8.8 14:00,246,267,62,575,0
교대→연산교차로,2023.8.8 15:00,348,0,494,842,0
부산시청→연산교차로,2023.8.8 15:00,600,512,305,1417,0
사직운동장→연산교차로,2023.8.8 15:00,198,616,70,884,0
신리→연산교차로,2023.8.8 15:00,395,247,39,681,0
안락→연산교차로,2023.8.8 15:00,425,0,99,524,0
연산터널→연산교차로,2023.8.8 15:00,251,280,54,585,0
교대→연산교차로,2023.8.8 16:00,350,0,528,878,0
부산시청→연산교차로,2023.8.8 16:00,641,524,311,1476,0
사직운동장→연산교차로,2023.8.8 16:00,236,658,61,955,0
신리→연산교차로,2023.8.8 16:00,448,293,50,791,0
안락→연산교차로,2023.8.8 16:00,443,0,96,539,0
연산터널→연산교차로,2023.8.8 16:00,236,281,49,566,0
교대→연산교차로,2023.8.8 17:00,390,0,527,917,0
부산시청→연산교차로,2023.8.8 17:00,619,550,304,1473,0
사직운동장→연산교차로,2023.8.8 17:00,239,704,35,978,0
신리→연산교차로,2023.8.8 17:00,525,282,69,876,0
안락→연산교차로,2023.8.8 17:00,453,0,116,569,0
연산터널→연산교차로,2023.8.8 17:00,234,284,53,571,0
교대→연산교차로,2023.8.8 18:00,364,0,552,916,0
부산시청→연산교차로,2023.8.8 18:00,606,550,350,1506,0
사직운동장→연산교차로,2023.8.8 18:00,228,716,31,975,0
신리→연산교차로,2023.8.8 18:00,473,255,44,772,0
안락→연산교차로,2023.8.8 18:00,454,0,115,569,0
연산터널→연산교차로,2023.8.8 18:00,216,299,43,558,0
교대→연산교차로,2023.8.8 19:00,325,0,458,783,0
부산시청→연산교차로,2023.8.8 19:00,546,421,272,1239,0
사직운동장→연산교차로,2023.8.8 19:00,199,553,65,817,0
신리→연산교차로,2023.8.8 19:00,363,216,42,621,0
안락→연산교차로,2023.8.8 19:00,417,0,100,517,0
연산터널→연산교차로,2023.8.8 19:00,224,246,57,527,0
교대→연산교차로,2023.8.8 20:00,289,0,370,659,0
부산시청→연산교차로,2023.8.8 20:00,498,390,236,1124,0
사직운동장→연산교차로,2023.8.8 20:00,145,507,92,744,0
신리→연산교차로,2023.8.8 20:00,344,207,32,583,0
안락→연산교차로,2023.8.8 20:00,416,0,97,513,0
연산터널→연산교차로,2023.8.8 20:00,219,276,55,550,0
교대→연산교차로,2023.8.8 21:00,296,0,318,614,0
부산시청→연산교차로,2023.8.8 21:00,479,314,209,1002,0
사직운동장→연산교차로,2023.8.8 21:00,172,458,103,733,0
신리→연산교차로,2023.8.8 21:00,302,181,30,513,0
안락→연산교차로,2023.8.8 21:00,419,0,107,526,0
연산터널→연산교차로,2023.8.8 21:00,230,266,48,544,0
교대→연산교차로,2023.8.8 22:00,269,0,257,526,0
부산시청→연산교차로,2023.8.8 22:00,405,232,174,811,0
사직운동장→연산교차로,2023.8.8 22:00,147,366,83,596,0
신리→연산교차로,2023.8.8 22:00,263,182,26,471,0
안락→연산교차로,2023.8.8 22:00,319,0,114,433,0
연산터널→연산교차로,2023.8.8 22:00,221,217,73,511,0
교대→연산교차로,2023.8.8 23:00,177,0,238,415,0
부산시청→연산교차로,2023.8.8 23:00,320,200,126,646,0
사직운동장→연산교차로,2023.8.8 23:00,109,304,86,499,0
신리→연산교차로,2023.8.8 23:00,202,122,24,348,0
안락→연산교차로,2023.8.8 23:00,255,0,63,318,0
연산터널→연산교차로,2023.8.8 23:00,170,187,75,432,0
교대→연산교차로,2023.8.9 00:00,152,0,212,364,0
부산시청→연산교차로,2023.8.9 00:00,245,157,121,523,0
사직운동장→연산교차로,2023.8.9 00:00,60,267,58,385,0
신리→연산교차로,2023.8.9 00:00,158,90,19,267,0
안락→연산교차로,2023.8.9 00:00,223,0,52,275,0
연산터널→연산교차로,2023.8.9 00:00,141,167,72,380,0
교대→연산교차로,2023.8.9 01:00,84,0,177,261,0
부산시청→연산교차로,2023.8.9 01:00,204,134,72,410,0
사직운동장→연산교차로,2023.8.9 01:00,72,206,50,328,0
신리→연산교차로,2023.8.9 01:00,134,69,21,224,0
안락→연산교차로,2023.8.9 01:00,136,0,37,173,0
연산터널→연산교차로,2023.8.9 01:00,119,164,57,340,0
교대→연산교차로,2023.8.9 02:00,91,0,119,210,0
부산시청→연산교차로,2023.8.9 02:00,144,83,66,293,0
사직운동장→연산교차로,2023.8.9 02:00,40,163,29,232,0
신리→연산교차로,2023.8.9 02:00,89,47,12,148,0
안락→연산교차로,2023.8.9 02:00,135,0,32,167,0
연산터널→연산교차로,2023.8.9 02:00,117,131,46,294,0
교대→연산교차로,2023.8.9 03:00,81,0,127,208,0
부산시청→연산교차로,2023.8.9 03:00,154,83,52,289,0
사직운동장→연산교차로,2023.8.9 03:00,31,139,29,199,0
신리→연산교차로,2023.8.9 03:00,76,44,14,134,0
안락→연산교차로,2023.8.9 03:00,136,0,30,166,0
연산터널→연산교차로,2023.8.9 03:00,79,92,39,210,0
교대→연산교차로,2023.8.9 04:00,55,0,84,139,0
부산시청→연산교차로,2023.8.9 04:00,127,85,36,248,0
사직운동장→연산교차로,2023.8.9 04:00,31,94,23,148,0
신리→연산교차로,2023.8.9 04:00,84,49,6,139,0
안락→연산교차로,2023.8.9 04:00,155,0,31,186,0
연산터널→연산교차로,2023.8.9 04:00,80,97,28,205,0
교대→연산교차로,2023.8.9 05:00,80,0,100,180,0
부산시청→연산교차로,2023.8.9 05:00,214,116,80,410,0
사직운동장→연산교차로,2023.8.9 05:00,54,164,33,251,0
신리→연산교차로,2023.8.9 05:00,185,78,16,279,0
안락→연산교차로,2023.8.9 05:00,260,0,61,321,0
연산터널→연산교차로,2023.8.9 05:00,127,143,29,299,0
교대→연산교차로,2023.8.9 06:00,140,0,215,355,0
부산시청→연산교차로,2023.8.9 06:00,336,227,136,699,0
사직운동장→연산교차로,2023.8.9 06:00,90,262,53,405,0
신리→연산교차로,2023.8.9 06:00,330,177,37,544,0
안락→연산교차로,2023.8.9 06:00,448,0,115,563,0
연산터널→연산교차로,2023.8.9 06:00,192,218,42,452,0
교대→연산교차로,2023.8.9 07:00,246,0,370,616,0
부산시청→연산교차로,2023.8.9 07:00,517,338,188,1043,0
사직운동장→연산교차로,2023.8.9 07:00,183,450,71,704,0
신리→연산교차로,2023.8.9 07:00,436,279,34,749,0
안락→연산교차로,2023.8.9 07:00,605,0,101,706,0
연산터널→연산교차로,2023.8.9 07:00,283,357,38,678,0
교대→연산교차로,2023.8.9 08:00,292,0,500,792,0
부산시청→연산교차로,2023.8.9 08:00,561,404,317,1282,0
사직운동장→연산교차로,2023.8.9 08:00,190,596,78,864,0
신리→연산교차로,2023.8.9 08:00,463,351,35,849,0
안락→연산교차로,2023.8.9 08:00,618,0,107,725,0
연산터널→연산교차로,2023.8.9 08:00,298,371,37,706,0
교대→연산교차로,2023.8.9 09:00,289,0,545,834,0
부산시청→연산교차로,2023.8.9 09:00,545,393,277,1215,0
사직운동장→연산교차로,2023.8.9 09:00,208,565,85,858,0
신리→연산교차로,2023.8.9 09:00,438,318,45,801,0
안락→연산교차로,2023.8.9 09:00,561,0,126,687,0
연산터널→연산교차로,2023.8.9 09:00,289,353,43,685,0
교대→연산교차로,2023.8.9 10:00,284,0,469,753,0
부산시청→연산교차로,2023.8.9 10:00,530,368,259,1157,0
사직운동장→연산교차로,2023.8.9 10:00,191,561,95,847,0
신리→연산교차로,2023.8.9 10:00,468,300,54,822,0
안락→연산교차로,2023.8.9 10:00,545,0,143,688,0
연산터널→연산교차로,2023.8.9 10:00,301,321,39,661,0
교대→연산교차로,2023.8.9 11:00,284,0,468,752,0
부산시청→연산교차로,2023.8.9 11:00,571,369,289,1229,0
사직운동장→연산교차로,2023.8.9 11:00,197,582,75,854,0
신리→연산교차로,2023.8.9 11:00,472,286,66,824,0
안락→연산교차로,2023.8.9 11:00,503,0,187,690,0
연산터널→연산교차로,2023.8.9 11:00,240,322,63,625,0
교대→연산교차로,2023.8.9 12:00,284,0,368,652,0
부산시청→연산교차로,2023.8.9 12:00,539,362,230,1131,0
사직운동장→연산교차로,2023.8.9 12:00,201,525,64,790,0
신리→연산교차로,2023.8.9 12:00,393,240,63,696,0
안락→연산교차로,2023.8.9 12:00,448,0,167,615,0
연산터널→연산교차로,2023.8.9 12:00,248,279,50,577,0
교대→연산교차로,2023.8.9 13:00,319,0,377,696,0
부산시청→연산교차로,2023.8.9 13:00,503,416,291,1210,0
사직운동장→연산교차로,2023.8.9 13:00,187,571,88,846,0
신리→연산교차로,2023.8.9 13:00,396,269,58,723,0
안락→연산교차로,2023.8.9 13:00,387,0,141,528,0
연산터널→연산교차로,2023.8.9 13:00,242,265,49,556,0
교대→연산교차로,2023.8.9 14:00,322,0,504,826,0
부산시청→연산교차로,2023.8.9 14:00,547,453,299,1299,0
사직운동장→연산교차로,2023.8.9 14:00,224,599,65,888,0
신리→연산교차로,2023.8.9 14:00,408,293,82,783,0
안락→연산교차로,2023.8.9 14:00,423,0,134,557,0
연산터널→연산교차로,2023.8.9 14:00,237,263,56,556,0
교대→연산교차로,2023.8.9 15:00,332,0,430,762,0
부산시청→연산교차로,2023.8.9 15:00,520,428,307,1255,0
사직운동장→연산교차로,2023.8.9 15:00,205,638,62,905,0
신리→연산교차로,2023.8.9 15:00,433,281,48,762,0
안락→연산교차로,2023.8.9 15:00,411,0,141,552,0
연산터널→연산교차로,2023.8.9 15:00,250,267,35,552,0
교대→연산교차로,2023.8.9 16:00,322,0,453,775,0
부산시청→연산교차로,2023.8.9 16:00,588,483,287,1358,0
사직운동장→연산교차로,2023.8.9 16:00,241,629,53,923,0
신리→연산교차로,2023.8.9 16:00,457,238,54,749,0
안락→연산교차로,2023.8.9 16:00,405,0,121,526,0
연산터널→연산교차로,2023.8.9 16:00,222,269,35,526,0
교대→연산교차로,2023.8.9 17:00,344,0,533,877,0
부산시청→연산교차로,2023.8.9 17:00,591,518,341,1450,0
사직운동장→연산교차로,2023.8.9 17:00,234,690,40,964,0
신리→연산교차로,2023.8.9 17:00,443,282,61,786,0
안락→연산교차로,2023.8.9 17:00,429,0,128,557,0
연산터널→연산교차로,2023.8.9 17:00,215,279,63,557,0
교대→연산교차로,2023.8.9 18:00,350,0,503,853,0
부산시청→연산교차로,2023.8.9 18:00,591,566,307,1464,0
사직운동장→연산교차로,2023.8.9 18:00,227,683,58,968,0
신리→연산교차로,2023.8.9 18:00,445,243,38,726,0
안락→연산교차로,2023.8.9 18:00,440,0,94,534,0
연산터널→연산교차로,2023.8.9 18:00,223,275,41,539,0
교대→연산교차로,2023.8.9 19:00,191,0,312,503,0
부산시청→연산교차로,2023.8.9 19:00,487,386,236,1109,0
사직운동장→연산교차로,2023.8.9 19:00,168,537,35,740,0
신리→연산교차로,2023.8.9 19:00,282,192,18,492,0
안락→연산교차로,2023.8.9 19:00,369,0,94,463,0
연산터널→연산교차로,2023.8.9 19:00,205,239,59,503,0
교대→연산교차로,2023.8.9 20:00,242,0,264,506,0
부산시청→연산교차로,2023.8.9 20:00,417,361,191,969,0
사직운동장→연산교차로,2023.8.9 20:00,149,403,15,567,0
신리→연산교차로,2023.8.9 20:00,280,167,11,458,0
안락→연산교차로,2023.8.9 20:00,331,0,99,430,0
연산터널→연산교차로,2023.8.9 20:00,186,223,26,435,0
교대→연산교차로,2023.8.9 21:00,241,0,229,470,0
부산시청→연산교차로,2023.8.9 21:00,353,303,159,815,0
사직운동장→연산교차로,2023.8.9 21:00,155,365,6,526,0
신리→연산교차로,2023.8.9 21:00,247,153,7,407,0
안락→연산교차로,2023.8.9 21:00,297,0,98,395,0
연산터널→연산교차로,2023.8.9 21:00,184,202,27,413,0
교대→연산교차로,2023.8.9 22:00,180,0,146,326,0
부산시청→연산교차로,2023.8.9 22:00,304,239,130,673,0
사직운동장→연산교차로,2023.8.9 22:00,101,293,5,399,0
신리→연산교차로,2023.8.9 22:00,173,125,10,308,0
안락→연산교차로,2023.8.9 22:00,245,0,54,299,0
연산터널→연산교차로,2023.8.9 22:00,146,165,24,335,0
교대→연산교차로,2023.8.9 23:00,126,0,120,246,0
부산시청→연산교차로,2023.8.9 23:00,222,160,97,479,0
사직운동장→연산교차로,2023.8.9 23:00,81,231,7,319,0
신리→연산교차로,2023.8.9 23:00,128,72,12,212,0
안락→연산교차로,2023.8.9 23:00,195,0,52,247,0
연산터널→연산교차로,2023.8.9 23:00,105,122,31,258,0
교대→연산교차로,2023.8.10 00:00,74,0,109,183,0
부산시청→연산교차로,2023.8.10 00:00,147,105,63,315,0
사직운동장→연산교차로,2023.8.10 00:00,47,175,4,226,0
신리→연산교차로,2023.8.10 00:00,97,55,8,160,0
안락→연산교차로,2023.8.10 00:00,160,0,36,196,0
연산터널→연산교차로,2023.8.10 00:00,89,109,15,213,0
교대→연산교차로,2023.8.10 01:00,77,0,81,158,0
부산시청→연산교차로,2023.8.10 01:00,129,94,45,268,0
사직운동장→연산교차로,2023.8.10 01:00,40,124,1,165,0
신리→연산교차로,2023.8.10 01:00,70,33,4,107,0
안락→연산교차로,2023.8.10 01:00,94,0,31,125,0
연산터널→연산교차로,2023.8.10 01:00,85,94,10,189,0
교대→연산교차로,2023.8.10 02:00,44,0,56,100,0
부산시청→연산교차로,2023.8.10 02:00,105,69,35,209,0
사직운동장→연산교차로,2023.8.10 02:00,27,111,1,139,0
신리→연산교차로,2023.8.10 02:00,45,38,3,86,0
안락→연산교차로,2023.8.10 02:00,77,0,18,95,0
연산터널→연산교차로,2023.8.10 02:00,57,73,16,146,0
교대→연산교차로,2023.8.10 03:00,23,0,44,67,0
부산시청→연산교차로,2023.8.10 03:00,81,41,24,146,0
사직운동장→연산교차로,2023.8.10 03:00,18,69,5,92,0
신리→연산교차로,2023.8.10 03:00,39,20,3,62,0
안락→연산교차로,2023.8.10 03:00,71,0,23,94,0
연산터널→연산교차로,2023.8.10 03:00,38,47,11,96,0
교대→연산교차로,2023.8.10 04:00,28,0,43,71,0
부산시청→연산교차로,2023.8.10 04:00,92,51,30,173,0
사직운동장→연산교차로,2023.8.10 04:00,12,58,2,72,0
신리→연산교차로,2023.8.10 04:00,34,23,9,66,0
안락→연산교차로,2023.8.10 04:00,100,0,22,122,0
연산터널→연산교차로,2023.8.10 04:00,39,53,4,96,0
교대→연산교차로,2023.8.10 05:00,22,0,82,104,0
부산시청→연산교차로,2023.8.10 05:00,118,80,30,228,0
사직운동장→연산교차로,2023.8.10 05:00,41,116,4,161,0
신리→연산교차로,2023.8.10 05:00,93,45,3,141,0
안락→연산교차로,2023.8.10 05:00,149,0,27,176,0
연산터널→연산교차로,2023.8.10 05:00,71,80,6,157,0
교대→연산교차로,2023.8.10 06:00,136,0,234,370,0
부산시청→연산교차로,2023.8.10 06:00,248,203,84,535,0
사직운동장→연산교차로,2023.8.10 06:00,68,200,19,287,0
신리→연산교차로,2023.8.10 06:00,245,115,12,372,0
안락→연산교차로,2023.8.10 06:00,342,0,66,408,0
연산터널→연산교차로,2023.8.10 06:00,139,156,28,323,0
교대→연산교차로,2023.8.10 07:00,211,0,406,617,0
부산시청→연산교차로,2023.8.10 07:00,406,300,112,818,0
사직운동장→연산교차로,2023.8.10 07:00,138,378,41,557,0
신리→연산교차로,2023.8.10 07:00,342,232,12,586,0
안락→연산교차로,2023.8.10 07:00,474,0,106,580,0
연산터널→연산교차로,2023.8.10 07:00,223,264,42,529,0
교대→연산교차로,2023.8.10 08:00,255,0,625,880,0
부산시청→연산교차로,2023.8.10 08:00,467,382,211,1060,0
사직운동장→연산교차로,2023.8.10 08:00,162,555,53,770,0
신리→연산교차로,2023.8.10 08:00,384,268,29,681,0
안락→연산교차로,2023.8.10 08:00,484,0,138,622,0
연산터널→연산교차로,2023.8.10 08:00,254,300,39,593,0
교대→연산교차로,2023.8.10 09:00,221,0,441,662,0
부산시청→연산교차로,2023.8.10 09:00,375,301,134,810,0
사직운동장→연산교차로,2023.8.10 09:00,113,424,53,590,0
신리→연산교차로,2023.8.10 09:00,267,183,24,474,0
안락→연산교차로,2023.8.10 09:00,305,0,124,429,0
연산터널→연산교차로,2023.8.10 09:00,188,212,28,428,0
교대→연산교차로,2023.8.10 10:00,216,0,376,592,0
부산시청→연산교차로,2023.8.10 10:00,384,278,144,806,0
사직운동장→연산교차로,2023.8.10 10:00,122,416,47,585,0
신리→연산교차로,2023.8.10 10:00,272,181,26,479,0
안락→연산교차로,2023.8.10 10:00,380,0,107,487,0
연산터널→연산교차로,2023.8.10 10:00,206,197,37,440,0
교대→연산교차로,2023.8.10 11:00,203,0,376,579,0
부산시청→연산교차로,2023.8.10 11:00,399,302,172,873,0
사직운동장→연산교차로,2023.8.10 11:00,144,454,69,667,0
신리→연산교차로,2023.8.10 11:00,307,188,44,539,0
안락→연산교차로,2023.8.10 11:00,381,0,125,506,0
연산터널→연산교차로,2023.8.10 11:00,225,241,23,489,0
교대→연산교차로,2023.8.10 12:00,260,0,330,590,0
부산시청→연산교차로,2023.8.10 12:00,437,316,186,939,0
사직운동장→연산교차로,2023.8.10 12:00,140,437,75,652,0
신리→연산교차로,2023.8.10 12:00,301,206,24,531,0
안락→연산교차로,2023.8.10 12:00,448,0,119,567,0
연산터널→연산교차로,2023.8.10 12:00,255,283,38,576,0
교대→연산교차로,2023.8.10 13:00,315,0,373,688,0
부산시청→연산교차로,2023.8.10 13:00,482,374,213,1069,0
사직운동장→연산교차로,2023.8.10 13:00,190,504,80,774,0
신리→연산교차로,2023.8.10 13:00,376,239,31,646,0
안락→연산교차로,2023.8.10 13:00,450,0,113,563,0
연산터널→연산교차로,2023.8.10 13:00,241,260,35,536,0
교대→연산교차로,2023.8.10 14:00,317,0,393,710,0
부산시청→연산교차로,2023.8.10 14:00,469,395,210,1074,0
사직운동장→연산교차로,2023.8.10 14:00,170,563,94,827,0
신리→연산교차로,2023.8.10 14:00,425,247,56,728,0
안락→연산교차로,2023.8.10 14:00,438,0,122,560,0
연산터널→연산교차로,2023.8.10 14:00,246,276,48,570,0
교대→연산교차로,2023.8.10 15:00,305,0,411,716,0
부산시청→연산교차로,2023.8.10 15:00,524,419,298,1241,0
사직운동장→연산교차로,2023.8.10 15:00,193,613,91,897,0
신리→연산교차로,2023.8.10 15:00,416,296,62,774,0
안락→연산교차로,2023.8.10 15:00,430,0,115,545,0
연산터널→연산교차로,2023.8.10 15:00,226,278,49,553,0
교대→연산교차로,2023.8.10 16:00,340,0,446,786,0
부산시청→연산교차로,2023.8.10 16:00,561,451,330,1342,0
사직운동장→연산교차로,2023.8.10 16:00,212,596,68,876,0
신리→연산교차로,2023.8.10 16:00,402,264,43,709,0
안락→연산교차로,2023.8.10 16:00,422,0,128,550,0
연산터널→연산교차로,2023.8.10 16:00,266,245,38,549,0
교대→연산교차로,2023.8.10 17:00,354,0,461,815,0
부산시청→연산교차로,2023.8.10 17:00,571,506,301,1378,0
사직운동장→연산교차로,2023.8.10 17:00,242,645,48,935,0
신리→연산교차로,2023.8.10 17:00,452,239,49,740,0
안락→연산교차로,2023.8.10 17:00,431,0,111,542,0
연산터널→연산교차로,2023.8.10 17:00,231,273,42,546,0
교대→연산교차로,2023.8.10 18:00,372,0,523,895,0
부산시청→연산교차로,2023.8.10 18:00,589,552,336,1477,0
사직운동장→연산교차로,2023.8.10 18:00,222,705,54,981,0
신리→연산교차로,2023.8.10 18:00,465,237,40,742,0
안락→연산교차로,2023.8.10 18:00,460,0,115,575,0
연산터널→연산교차로,2023.8.10 18:00,233,285,49,567,0
교대→연산교차로,2023.8.10 19:00,289,0,315,604,0
부산시청→연산교차로,2023.8.10 19:00,487,371,259,1117,0
사직운동장→연산교차로,2023.8.10 19:00,158,531,59,748,0
신리→연산교차로,2023.8.10 19:00,296,205,23,524,0
안락→연산교차로,2023.8.10 19:00,369,0,80,449,0
연산터널→연산교차로,2023.8.10 19:00,199,275,47,521,0
교대→연산교차로,2023.8.10 20:00,271,0,293,564,0
부산시청→연산교차로,2023.8.10 20:00,479,332,201,1012,0
사직운동장→연산교차로,2023.8.10 20:00,141,430,82,653,0
신리→연산교차로,2023.8.10 20:00,303,180,31,514,0
안락→연산교차로,2023.8.10 20:00,374,0,87,461,0
연산터널→연산교차로,2023.8.10 20:00,195,228,46,469,0
교대→연산교차로,2023.8.10 21:00,240,0,259,499,0
부산시청→연산교차로,2023.8.10 21:00,444,278,165,887,0
사직운동장→연산교차로,2023.8.10 21:00,130,346,83,559,0
신리→연산교차로,2023.8.10 21:00,251,143,22,416,0
안락→연산교차로,2023.8.10 21:00,362,0,86,448,0
연산터널→연산교차로,2023.8.10 21:00,184,216,56,456,0
교대→연산교차로,2023.8.10 22:00,221,0,223,444,0
부산시청→연산교차로,2023.8.10 22:00,360,269,165,794,0
사직운동장→연산교차로,2023.8.10 22:00,149,308,61,518,0
신리→연산교차로,2023.8.10 22:00,228,149,25,402,0
안락→연산교차로,2023.8.10 22:00,313,0,93,406,0
연산터널→연산교차로,2023.8.10 22:00,199,202,50,451,0
교대→연산교차로,2023.8.10 23:00,159,0,218,377,0
부산시청→연산교차로,2023.8.10 23:00,317,188,127,632,0
사직운동장→연산교차로,2023.8.10 23:00,92,269,62,423,0
신리→연산교차로,2023.8.10 23:00,174,130,21,325,0
안락→연산교차로,2023.8.10 23:00,251,0,61,312,0
연산터널→연산교차로,2023.8.10 23:00,148,197,58,403,0
교대→연산교차로,2023.8.11 00:00,144,0,166,310,0
부산시청→연산교차로,2023.8.11 00:00,234,126,108,468,0
사직운동장→연산교차로,2023.8.11 00:00,66,208,53,327,0
신리→연산교차로,2023.8.11 00:00,123,89,20,232,0
안락→연산교차로,2023.8.11 00:00,184,0,55,239,0
연산터널→연산교차로,2023.8.11 00:00,139,184,48,371,0
교대→연산교차로,2023.8.11 01:00,95,0,141,236,0
부산시청→연산교차로,2023.8.11 01:00,203,115,82,400,0
사직운동장→연산교차로,2023.8.11 01:00,48,159,35,242,0
신리→연산교차로,2023.8.11 01:00,99,65,20,184,0
안락→연산교차로,2023.8.11 01:00,157,0,43,200,0
연산터널→연산교차로,2023.8.11 01:00,121,133,60,314,0
교대→연산교차로,2023.8.11 02:00,71,0,116,187,0
부산시청→연산교차로,2023.8.11 02:00,146,75,55,276,0
사직운동장→연산교차로,2023.8.11 02:00,48,174,18,240,0
신리→연산교차로,2023.8.11 02:00,81,49,23,153,0
안락→연산교차로,2023.8.11 02:00,136,0,27,163,0
연산터널→연산교차로,2023.8.11 02:00,100,135,44,279,0
교대→연산교차로,2023.8.11 03:00,54,0,104,158,0
부산시청→연산교차로,2023.8.11 03:00,156,76,45,277,0
사직운동장→연산교차로,2023.8.11 03:00,38,120,31,189,0
신리→연산교차로,2023.8.11 03:00,72,45,13,130,0
안락→연산교차로,2023.8.11 03:00,107,0,31,138,0
연산터널→연산교차로,2023.8.11 03:00,90,106,40,236,0
교대→연산교차로,2023.8.11 04:00,54,0,89,143,0
부산시청→연산교차로,2023.8.11 04:00,159,75,42,276,0
사직운동장→연산교차로,2023.8.11 04:00,27,151,21,199,0
신리→연산교차로,2023.8.11 04:00,92,42,13,147,0
안락→연산교차로,2023.8.11 04:00,178,0,37,215,0
연산터널→연산교차로,2023.8.11 04:00,91,81,35,207,0
교대→연산교차로,2023.8.11 05:00,99,0,139,238,0
부산시청→연산교차로,2023.8.11 05:00,207,130,81,418,0
사직운동장→연산교차로,2023.8.11 05:00,51,170,31,252,0
신리→연산교차로,2023.8.11 05:00,206,96,14,316,0
안락→연산교차로,2023.8.11 05:00,299,0,59,358,0
연산터널→연산교차로,2023.8.11 05:00,143,135,33,311,0
교대→연산교차로,2023.8.11 06:00,167,0,238,405,0
부산시청→연산교차로,2023.8.11 06:00,385,256,110,751,0
사직운동장→연산교차로,2023.8.11 06:00,92,290,54,436,0
신리→연산교차로,2023.8.11 06:00,340,189,22,551,0
안락→연산교차로,2023.8.11 06:00,493,0,90,583,0
연산터널→연산교차로,2023.8.11 06:00,211,233,40,484,0
교대→연산교차로,2023.8.11 07:00,244,0,353,597,0
부산시청→연산교차로,2023.8.11 07:00,501,335,171,1007,0
사직운동장→연산교차로,2023.8.11 07:00,164,513,68,745,0
신리→연산교차로,2023.8.11 07:00,453,297,35,785,0
안락→연산교차로,2023.8.11 07:00,622,0,86,708,0
연산터널→연산교차로,2023.8.11 07:00,294,331,44,669,0
교대→연산교차로,2023.8.11 08:00,305,0,529,834,0
부산시청→연산교차로,2023.8.11 08:00,545,435,315,1295,0
사직운동장→연산교차로,2023.8.11 08:00,197,649,66,912,0
신리→연산교차로,2023.8.11 08:00,523,334,32,889,0
안락→연산교차로,2023.8.11 08:00,628,0,117,745,0
연산터널→연산교차로,2023.8.11 08:00,305,373,25,703,0
교대→연산교차로,2023.8.11 09:00,300,0,522,822,0
부산시청→연산교차로,2023.8.11 09:00,529,389,292,1210,0
사직운동장→연산교차로,2023.8.11 09:00,179,606,77,862,0
신리→연산교차로,2023.8.11 09:00,476,325,46,847,0
안락→연산교차로,2023.8.11 09:00,582,0,120,702,0
연산터널→연산교차로,2023.8.11 09:00,319,345,46,710,0
교대→연산교차로,2023.8.11 10:00,312,0,522,834,0
부산시청→연산교차로,2023.8.11 10:00,573,360,287,1220,0
사직운동장→연산교차로,2023.8.11 10:00,205,585,69,859,0
신리→연산교차로,2023.8.11 10:00,483,293,53,829,0
안락→연산교차로,2023.8.11 10:00,574,0,152,726,0
연산터널→연산교차로,2023.8.11 10:00,288,356,52,696,0
교대→연산교차로,2023.8.11 11:00,310,0,474,784,0
부산시청→연산교차로,2023.8.11 11:00,590,396,271,1257,0
사직운동장→연산교차로,2023.8.11 11:00,212,568,64,844,0
신리→연산교차로,2023.8.11 11:00,487,292,59,838,0
안락→연산교차로,2023.8.11 11:00,518,0,178,696,0
연산터널→연산교차로,2023.8.11 11:00,310,315,41,666,0
교대→연산교차로,2023.8.11 12:00,305,0,454,759,0
부산시청→연산교차로,2023.8.11 12:00,570,397,238,1205,0
사직운동장→연산교차로,2023.8.11 12:00,204,595,60,859,0
신리→연산교차로,2023.8.11 12:00,469,292,66,827,0
안락→연산교차로,2023.8.11 12:00,533,0,158,691,0
연산터널→연산교차로,2023.8.11 12:00,309,316,54,679,0
교대→연산교차로,2023.8.11 13:00,327,0,468,795,0
부산시청→연산교차로,2023.8.11 13:00,642,499,303,1444,0
사직운동장→연산교차로,2023.8.11 13:00,217,638,77,932,0
신리→연산교차로,2023.8.11 13:00,492,321,51,864,0
안락→연산교차로,2023.8.11 13:00,446,0,103,549,0
연산터널→연산교차로,2023.8.11 13:00,215,284,43,542,0
교대→연산교차로,2023.8.11 14:00,370,0,562,932,0
부산시청→연산교차로,2023.8.11 14:00,661,496,309,1466,0
사직운동장→연산교차로,2023.8.11 14:00,211,686,79,976,0
신리→연산교차로,2023.8.11 14:00,454,279,58,791,0
안락→연산교차로,2023.8.11 14:00,439,0,114,553,0
연산터널→연산교차로,2023.8.11 14:00,235,283,55,573,0
교대→연산교차로,2023.8.11 15:00,359,0,490,849,0
부산시청→연산교차로,2023.8.11 15:00,628,503,325,1456,0
사직운동장→연산교차로,2023.8.11 15:00,233,698,71,1002,0
신리→연산교차로,2023.8.11 15:00,453,287,70,810,0
안락→연산교차로,2023.8.11 15:00,432,0,125,557,0
연산터널→연산교차로,2023.8.11 15:00,228,305,66,599,0
교대→연산교차로,2023.8.11 16:00,373,0,510,883,0
부산시청→연산교차로,2023.8.11 16:00,605,527,329,1461,0
사직운동장→연산교차로,2023.8.11 16:00,240,651,48,939,0
신리→연산교차로,2023.8.11 16:00,472,312,73,857,0
안락→연산교차로,2023.8.11 16:00,453,0,105,558,0
연산터널→연산교차로,2023.8.11 16:00,256,289,43,588,0
교대→연산교차로,2023.8.11 17:00,367,0,587,954,0
부산시청→연산교차로,2023.8.11 17:00,650,530,314,1494,0
사직운동장→연산교차로,2023.8.11 17:00,235,701,50,986,0
신리→연산교차로,2023.8.11 17:00,481,313,65,859,0
안락→연산교차로,2023.8.11 17:00,454,0,105,559,0
연산터널→연산교차로,2023.8.11 17:00,238,282,39,559,0
교대→연산교차로,2023.8.11 18:00,361,0,613,974,0
부산시청→연산교차로,2023.8.11 18:00,617,592,329,1538,0
사직운동장→연산교차로,2023.8.11 18:00,237,687,42,966,0
신리→연산교차로,2023.8.11 18:00,526,296,37,859,0
안락→연산교차로,2023.8.11 18:00,467,0,113,580,0
연산터널→연산교차로,2023.8.11 18:00,231,289,49,569,0
교대→연산교차로,2023.8.11 19:00,351,0,435,786,0
부산시청→연산교차로,2023.8.11 19:00,592,445,290,1327,0
사직운동장→연산교차로,2023.8.11 19:00,200,597,75,872,0
신리→연산교차로,2023.8.11 19:00,386,222,38,646,0
안락→연산교차로,2023.8.11 19:00,428,0,92,520,0
연산터널→연산교차로,2023.8.11 19:00,249,269,62,580,0
교대→연산교차로,2023.8.11 20:00,339,0,403,742,0
부산시청→연산교차로,2023.8.11 20:00,535,395,244,1174,0
사직운동장→연산교차로,2023.8.11 20:00,190,558,108,856,0
신리→연산교차로,2023.8.11 20:00,362,193,40,595,0
안락→연산교차로,2023.8.11 20:00,435,0,105,540,0
연산터널→연산교차로,2023.8.11 20:00,218,266,51,535,0
교대→연산교차로,2023.8.11 21:00,301,0,383,684,0
부산시청→연산교차로,2023.8.11 21:00,517,308,235,1060,0
사직운동장→연산교차로,2023.8.11 21:00,201,505,78,784,0
신리→연산교차로,2023.8.11 21:00,324,207,48,579,0
안락→연산교차로,2023.8.11 21:00,448,0,125,573,0
연산터널→연산교차로,2023.8.11 21:00,243,298,51,592,0
교대→연산교차로,2023.8.11 22:00,297,0,339,636,0
부산시청→연산교차로,2023.8.11 22:00,447,301,181,929,0
사직운동장→연산교차로,2023.8.11 22:00,202,483,71,756,0
신리→연산교차로,2023.8.11 22:00,319,191,35,545,0
안락→연산교차로,2023.8.11 22:00,423,0,108,531,0
연산터널→연산교차로,2023.8.11 22:00,234,251,85,570,0
교대→연산교차로,2023.8.11 23:00,209,0,250,459,0
부산시청→연산교차로,2023.8.11 23:00,369,252,141,762,0
사직운동장→연산교차로,2023.8.11 23:00,139,341,66,546,0
신리→연산교차로,2023.8.11 23:00,259,181,23,463,0
안락→연산교차로,2023.8.11 23:00,319,0,97,416,0
연산터널→연산교차로,2023.8.11 23:00,178,227,53,458,0
교대→연산교차로,2023.8.12 00:00,205,0,252,457,0
부산시청→연산교차로,2023.8.12 00:00,325,184,145,654,0
사직운동장→연산교차로,2023.8.12 00:00,88,291,58,437,0
신리→연산교차로,2023.8.12 00:00,220,132,22,374,0
안락→연산교차로,2023.8.12 00:00,246,0,75,321,0
연산터널→연산교차로,2023.8.12 00:00,173,207,50,430,0
교대→연산교차로,2023.8.12 01:00,160,0,239,399,0
부산시청→연산교차로,2023.8.12 01:00,287,176,105,568,0
사직운동장→연산교차로,2023.8.12 01:00,84,250,41,375,0
신리→연산교차로,2023.8.12 01:00,168,107,23,298,0
안락→연산교차로,2023.8.12 01:00,218,0,74,292,0
연산터널→연산교차로,2023.8.12 01:00,157,189,58,404,0
교대→연산교차로,2023.8.12 02:00,121,0,204,325,0
부산시청→연산교차로,2023.8.12 02:00,239,129,74,442,0
사직운동장→연산교차로,2023.8.12 02:00,68,224,34,326,0
신리→연산교차로,2023.8.12 02:00,125,93,10,228,0
안락→연산교차로,2023.8.12 02:00,199,0,51,250,0
연산터널→연산교차로,2023.8.12 02:00,129,181,43,353,0
교대→연산교차로,2023.8.12 03:00,75,0,163,238,0
부산시청→연산교차로,2023.8.12 03:00,206,106,62,374,0
사직운동장→연산교차로,2023.8.12 03:00,52,165,27,244,0
신리→연산교차로,2023.8.12 03:00,114,65,11,190,0
안락→연산교차로,2023.8.12 03:00,143,0,39,182,0
연산터널→연산교차로,2023.8.12 03:00,109,127,44,280,0
교대→연산교차로,2023.8.12 04:00,77,0,148,225,0
부산시청→연산교차로,2023.8.12 04:00,206,96,51,353,0
사직운동장→연산교차로,2023.8.12 04:00,49,139,19,207,0
신리→연산교차로,2023.8.12 04:00,109,63,9,181,0
안락→연산교차로,2023.8.12 04:00,181,0,49,230,0
연산터널→연산교차로,2023.8.12 04:00,103,131,26,260,0
교대→연산교차로,2023.8.12 05:00,113,0,167,280,0
부산시청→연산교차로,2023.8.12 05:00,230,170,69,469,0
사직운동장→연산교차로,2023.8.12 05:00,59,151,39,249,0
신리→연산교차로,2023.8.12 05:00,188,93,13,294,0
안락→연산교차로,2023.8.12 05:00,297,0,49,346,0
연산터널→연산교차로,2023.8.12 05:00,127,130,26,283,0
교대→연산교차로,2023.8.12 06:00,161,0,201,362,0
부산시청→연산교차로,2023.8.12 06:00,337,217,138,692,0
사직운동장→연산교차로,2023.8.12 06:00,77,247,33,357,0
신리→연산교차로,2023.8.12 06:00,295,133,30,458,0
안락→연산교차로,2023.8.12 06:00,396,0,101,497,0
연산터널→연산교차로,2023.8.12 06:00,182,202,43,427,0
교대→연산교차로,2023.8.12 07:00,171,0,206,377,0
부산시청→연산교차로,2023.8.12 07:00,382,238,191,811,0
사직운동장→연산교차로,2023.8.12 07:00,101,340,43,484,0
신리→연산교차로,2023.8.12 07:00,303,177,23,503,0
안락→연산교차로,2023.8.12 07:00,412,0,72,484,0
연산터널→연산교차로,2023.8.12 07:00,177,196,40,413,0
교대→연산교차로,2023.8.12 08:00,273,0,316,589,0
부산시청→연산교차로,2023.8.12 08:00,453,303,213,969,0
사직운동장→연산교차로,2023.8.12 08:00,172,522,76,770,0
신리→연산교차로,2023.8.12 08:00,431,266,46,743,0
안락→연산교차로,2023.8.12 08:00,508,0,104,612,0
연산터널→연산교차로,2023.8.12 08:00,295,289,65,649,0
교대→연산교차로,2023.8.12 09:00,304,0,372,676,0
부산시청→연산교차로,2023.8.12 09:00,552,374,260,1186,0
사직운동장→연산교차로,2023.8.12 09:00,211,601,85,897,0
신리→연산교차로,2023.8.12 09:00,478,293,66,837,0
안락→연산교차로,2023.8.12 09:00,542,0,160,702,0
연산터널→연산교차로,2023.8.12 09:00,298,311,50,659,0
교대→연산교차로,2023.8.12 10:00,303,0,409,712,0
부산시청→연산교차로,2023.8.12 10:00,559,352,290,1201,0
사직운동장→연산교차로,2023.8.12 10:00,184,642,46,872,0
신리→연산교차로,2023.8.12 10:00,496,268,85,849,0
안락→연산교차로,2023.8.12 10:00,561,0,167,728,0
연산터널→연산교차로,2023.8.12 10:00,291,321,57,669,0
교대→연산교차로,2023.8.12 11:00,296,0,379,675,0
부산시청→연산교차로,2023.8.12 11:00,631,370,268,1269,0
사직운동장→연산교차로,2023.8.12 11:00,199,626,50,875,0
신리→연산교차로,2023.8.12 11:00,524,287,87,898,0
안락→연산교차로,2023.8.12 11:00,559,0,180,739,0
연산터널→연산교차로,2023.8.12 11:00,305,345,61,711,0
교대→연산교차로,2023.8.12 12:00,326,0,450,776,0
부산시청→연산교차로,2023.8.12 12:00,604,384,263,1251,0
사직운동장→연산교차로,2023.8.12 12:00,212,612,47,871,0
신리→연산교차로,2023.8.12 12:00,496,247,76,819,0
안락→연산교차로,2023.8.12 12:00,546,0,161,707,0
연산터널→연산교차로,2023.8.12 12:00,293,322,54,669,0
교대→연산교차로,2023.8.12 13:00,368,0,443,811,0
부산시청→연산교차로,2023.8.12 13:00,677,467,311,1455,0
사직운동장→연산교차로,2023.8.12 13:00,207,721,38,966,0
신리→연산교차로,2023.8.12 13:00,497,309,66,872,0
안락→연산교차로,2023.8.12 13:00,445,0,98,543,0
연산터널→연산교차로,2023.8.12 13:00,251,293,52,596,0
교대→연산교차로,2023.8.12 14:00,349,0,422,771,0
부산시청→연산교차로,2023.8.12 14:00,667,465,307,1439,0
사직운동장→연산교차로,2023.8.12 14:00,221,657,47,925,0
신리→연산교차로,2023.8.12 14:00,431,303,58,792,0
안락→연산교차로,2023.8.12 14:00,476,0,98,574,0
연산터널→연산교차로,2023.8.12 14:00,250,280,41,571,0
교대→연산교차로,2023.8.12 15:00,346,0,388,734,0
부산시청→연산교차로,2023.8.12 15:00,614,443,350,1407,0
사직운동장→연산교차로,2023.8.12 15:00,203,702,55,960,0
신리→연산교차로,2023.8.12 15:00,453,279,71,803,0
안락→연산교차로,2023.8.12 15:00,445,0,114,559,0
연산터널→연산교차로,2023.8.12 15:00,275,274,39,588,0
교대→연산교차로,2023.8.12 16:00,334,0,417,751,0
부산시청→연산교차로,2023.8.12 16:00,616,497,308,1421,0
사직운동장→연산교차로,2023.8.12 16:00,229,642,61,932,0
신리→연산교차로,2023.8.12 16:00,451,311,43,805,0
안락→연산교차로,2023.8.12 16:00,459,0,109,568,0
연산터널→연산교차로,2023.8.12 16:00,219,281,43,543,0
교대→연산교차로,2023.8.12 17:00,350,0,421,771,0
부산시청→연산교차로,2023.8.12 17:00,648,473,313,1434,0
사직운동장→연산교차로,2023.8.12 17:00,224,660,59,943,0
신리→연산교차로,2023.8.12 17:00,444,304,38,786,0
안락→연산교차로,2023.8.12 17:00,467,0,91,558,0
연산터널→연산교차로,2023.8.12 17:00,251,271,52,574,0
교대→연산교차로,2023.8.12 18:00,361,0,406,767,0
부산시청→연산교차로,2023.8.12 18:00,579,415,243,1237,0
사직운동장→연산교차로,2023.8.12 18:00,259,592,55,906,0
신리→연산교차로,2023.8.12 18:00,374,235,45,654,0
안락→연산교차로,2023.8.12 18:00,450,0,117,567,0
연산터널→연산교차로,2023.8.12 18:00,255,260,50,565,0
교대→연산교차로,2023.8.12 19:00,336,0,366,702,0
부산시청→연산교차로,2023.8.12 19:00,489,360,240,1089,0
사직운동장→연산교차로,2023.8.12 19:00,204,498,90,792,0
신리→연산교차로,2023.8.12 19:00,363,194,37,594,0
안락→연산교차로,2023.8.12 19:00,414,0,105,519,0
연산터널→연산교차로,2023.8.12 19:00,226,282,51,559,0
교대→연산교차로,2023.8.12 20:00,300,0,317,617,0
부산시청→연산교차로,2023.8.12 20:00,489,314,205,1008,0
사직운동장→연산교차로,2023.8.12 20:00,179,471,87,737,0
신리→연산교차로,2023.8.12 20:00,360,218,30,608,0
안락→연산교차로,2023.8.12 20:00,421,0,134,555,0
연산터널→연산교차로,2023.8.12 20:00,226,252,47,525,0
교대→연산교차로,2023.8.12 21:00,286,0,317,603,0
부산시청→연산교차로,2023.8.12 21:00,490,327,173,990,0
사직운동장→연산교차로,2023.8.12 21:00,205,423,52,680,0
신리→연산교차로,2023.8.12 21:00,356,210,29,595,0
안락→연산교차로,2023.8.12 21:00,400,0,119,519,0
연산터널→연산교차로,2023.8.12 21:00,249,248,62,559,0
교대→연산교차로,2023.8.12 22:00,256,0,258,514,0
부산시청→연산교차로,2023.8.12 22:00,417,281,174,872,0
사직운동장→연산교차로,2023.8.12 22:00,225,471,57,753,0
신리→연산교차로,2023.8.12 22:00,287,181,19,487,0
안락→연산교차로,2023.8.12 22:00,363,0,120,483,0
연산터널→연산교차로,2023.8.12 22:00,219,236,50,505,0
교대→연산교차로,2023.8.12 23:00,214,0,222,436,0
부산시청→연산교차로,2023.8.12 23:00,359,210,136,705,0
사직운동장→연산교차로,2023.8.12 23:00,97,372,81,550,0
신리→연산교차로,2023.8.12 23:00,258,171,30,459,0
안락→연산교차로,2023.8.12 23:00,331,0,99,430,0
연산터널→연산교차로,2023.8.12 23:00,168,218,71,457,0
교대→연산교차로,2023.8.13 00:00,187,0,239,426,1
부산시청→연산교차로,2023.8.13 00:00,323,204,109,636,1
사직운동장→연산교차로,2023.8.13 00:00,77,271,60,408,1
신리→연산교차로,2023.8.13 00:00,240,146,20,406,1
안락→연산교차로,2023.8.13 00:00,228,0,84,312,1
연산터널→연산교차로,2023.8.13 00:00,146,193,53,392,1
교대→연산교차로,2023.8.13 01:00,136,0,204,340,1
부산시청→연산교차로,2023.8.13 01:00,280,161,107,548,1
사직운동장→연산교차로,2023.8.13 01:00,57,207,68,332,1
신리→연산교차로,2023.8.13 01:00,203,122,20,345,1
안락→연산교차로,2023.8.13 01:00,208,0,46,254,1
연산터널→연산교차로,2023.8.13 01:00,152,161,46,359,1
교대→연산교차로,2023.8.13 02:00,108,0,211,319,1
부산시청→연산교차로,2023.8.13 02:00,247,138,99,484,1
사직운동장→연산교차로,2023.8.13 02:00,52,197,45,294,1
신리→연산교차로,2023.8.13 02:00,148,86,14,248,1
안락→연산교차로,2023.8.13 02:00,168,0,46,214,1
연산터널→연산교차로,2023.8.13 02:00,119,162,73,354,1
교대→연산교차로,2023.8.13 03:00,96,0,201,297,1
부산시청→연산교차로,2023.8.13 03:00,184,104,71,359,1
사직운동장→연산교차로,2023.8.13 03:00,54,167,58,279,1
신리→연산교차로,2023.8.13 03:00,88,61,20,169,1
안락→연산교차로,2023.8.13 03:00,149,0,50,199,1
연산터널→연산교차로,2023.8.13 03:00,96,132,48,276,1
교대→연산교차로,2023.8.13 04:00,67,0,105,172,1
부산시청→연산교차로,2023.8.13 04:00,158,95,57,310,1
사직운동장→연산교차로,2023.8.13 04:00,37,123,33,193,1
신리→연산교차로,2023.8.13 04:00,99,52,10,161,1
안락→연산교차로,2023.8.13 04:00,117,0,55,172,1
연산터널→연산교차로,2023.8.13 04:00,80,101,25,206,1
교대→연산교차로,2023.8.13 05:00,71,0,112,183,1
부산시청→연산교차로,2023.8.13 05:00,168,101,55,324,1
사직운동장→연산교차로,2023.8.13 05:00,41,134,42,217,1
신리→연산교차로,2023.8.13 05:00,127,80,14,221,1
안락→연산교차로,2023.8.13 05:00,186,0,53,239,1
연산터널→연산교차로,2023.8.13 05:00,89,110,22,221,1
교대→연산교차로,2023.8.13 06:00,108,0,132,240,1
부산시청→연산교차로,2023.8.13 06:00,201,168,65,434,1
사직운동장→연산교차로,2023.8.13 06:00,69,181,35,285,1
신리→연산교차로,2023.8.13 06:00,168,87,8,263,1
안락→연산교차로,2023.8.13 06:00,262,0,51,313,1
연산터널→연산교차로,2023.8.13 06:00,128,130,35,293,1
교대→연산교차로,2023.8.13 07:00,121,0,130,251,1
부산시청→연산교차로,2023.8.13 07:00,242,172,83,497,1
사직운동장→연산교차로,2023.8.13 07:00,64,189,19,272,1
신리→연산교차로,2023.8.13 07:00,204,101,14,319,1
안락→연산교차로,2023.8.13 07:00,255,0,52,307,1
연산터널→연산교차로,2023.8.13 07:00,119,120,27,266,1
교대→연산교차로,2023.8.13 08:00,153,0,163,316,1
부산시청→연산교차로,2023.8.13 08:00,315,230,99,644,1
사직운동장→연산교차로,2023.8.13 08:00,113,342,40,495,1
신리→연산교차로,2023.8.13 08:00,287,127,25,439,1
안락→연산교차로,2023.8.13 08:00,321,0,53,374,1
연산터널→연산교차로,2023.8.13 08:00,169,178,22,369,1
교대→연산교차로,2023.8.13 09:00,225,0,231,456,1
부산시청→연산교차로,2023.8.13 09:00,384,276,148,808,1
사직운동장→연산교차로,2023.8.13 09:00,135,459,37,631,1
신리→연산교차로,2023.8.13 09:00,357,189,39,585,1
안락→연산교차로,2023.8.13 09:00,415,0,100,515,1
연산터널→연산교차로,2023.8.13 09:00,271,203,39,513,1
교대→연산교차로,2023.8.13 10:00,278,0,251,529,1
부산시청→연산교차로,2023.8.13 10:00,426,324,183,933,1
사직운동장→연산교차로,2023.8.13 10:00,149,498,51,698,1
신리→연산교차로,2023.8.13 10:00,426,190,39,655,1
안락→연산교차로,2023.8.13 10:00,456,0,93,549,1
연산터널→연산교차로,2023.8.13 10:00,245,230,38,513,1
교대→연산교차로,2023.8.13 11:00,269,0,292,561,1
부산시청→연산교차로,2023.8.13 11:00,480,298,190,968,1
사직운동장→연산교차로,2023.8.13 11:00,153,545,44,742,1
신리→연산교차로,2023.8.13 11:00,419,203,33,655,1
안락→연산교차로,2023.8.13 11:00,418,0,112,530,1
연산터널→연산교차로,2023.8.13 11:00,267,228,45,540,1
교대→연산교차로,2023.8.13 12:00,280,0,267,547,1
부산시청→연산교차로,2023.8.13 12:00,505,336,179,1020,1
사직운동장→연산교차로,2023.8.13 12:00,189,519,45,753,1
신리→연산교차로,2023.8.13 12:00,410,237,41,688,1
안락→연산교차로,2023.8.13 12:00,451,0,112,563,1
연산터널→연산교차로,2023.8.13 12:00,243,235,32,510,1
교대→연산교차로,2023.8.13 13:00,305,0,307,612,1
부산시청→연산교차로,2023.8.13 13:00,519,358,201,1078,1
사직운동장→연산교차로,2023.8.13 13:00,193,519,38,750,1
신리→연산교차로,2023.8.13 13:00,402,200,37,639,1
안락→연산교차로,2023.8.13 13:00,471,0,112,583,1
연산터널→연산교차로,2023.8.13 13:00,249,255,50,554,1
교대→연산교차로,2023.8.13 14:00,300,0,293,593,1
부산시청→연산교차로,2023.8.13 14:00,489,328,186,1003,1
사직운동장→연산교차로,2023.8.13 14:00,194,529,38,761,1
신리→연산교차로,2023.8.13 14:00,393,232,41,666,1
안락→연산교차로,2023.8.13 14:00,467,0,144,611,1
연산터널→연산교차로,2023.8.13 14:00,276,236,50,562,1
교대→연산교차로,2023.8.13 15:00,280,0,281,561,1
부산시청→연산교차로,2023.8.13 15:00,465,312,180,957,1
사직운동장→연산교차로,2023.8.13 15:00,179,512,37,728,1
신리→연산교차로,2023.8.13 15:00,380,281,31,692,1
안락→연산교차로,2023.8.13 15:00,493,0,176,669,1
연산터널→연산교차로,2023.8.13 15:00,246,232,49,527,1
교대→연산교차로,2023.8.13 16:00,267,0,299,566,1
부산시청→연산교차로,2023.8.13 16:00,487,336,202,1025,1
사직운동장→연산교차로,2023.8.13 16:00,178,523,49,750,1
신리→연산교차로,2023.8.13 16:00,356,264,36,656,1
안락→연산교차로,2023.8.13 16:00,530,0,161,691,1
연산터널→연산교차로,2023.8.13 16:00,267,273,46,586,1
교대→연산교차로,2023.8.13 17:00,293,0,264,557,1
부산시청→연산교차로,2023.8.13 17:00,492,348,190,1030,1
사직운동장→연산교차로,2023.8.13 17:00,190,521,53,764,1
신리→연산교차로,2023.8.13 17:00,364,221,36,621,1
안락→연산교차로,2023.8.13 17:00,518,0,144,662,1
연산터널→연산교차로,2023.8.13 17:00,246,267,51,564,1
교대→연산교차로,2023.8.13 18:00,278,0,296,574,1
부산시청→연산교차로,2023.8.13 18:00,435,291,196,922,1
사직운동장→연산교차로,2023.8.13 18:00,172,452,62,686,1
신리→연산교차로,2023.8.13 18:00,319,207,32,558,1
안락→연산교차로,2023.8.13 18:00,459,0,149,608,1
연산터널→연산교차로,2023.8.13 18:00,229,198,54,481,1
교대→연산교차로,2023.8.13 19:00,279,0,311,590,1
부산시청→연산교차로,2023.8.13 19:00,373,282,151,806,1
사직운동장→연산교차로,2023.8.13 19:00,168,403,61,632,1
신리→연산교차로,2023.8.13 19:00,298,186,21,505,1
안락→연산교차로,2023.8.13 19:00,404,0,140,544,1
연산터널→연산교차로,2023.8.13 19:00,249,234,61,544,1
교대→연산교차로,2023.8.13 20:00,289,0,247,536,1
부산시청→연산교차로,2023.8.13 20:00,377,253,142,772,1
사직운동장→연산교차로,2023.8.13 20:00,254,429,48,731,1
신리→연산교차로,2023.8.13 20:00,305,180,19,504,1
안락→연산교차로,2023.8.13 20:00,369,0,111,480,1
연산터널→연산교차로,2023.8.13 20:00,223,234,50,507,1
교대→연산교차로,2023.8.13 21:00,231,0,240,471,1
부산시청→연산교차로,2023.8.13 21:00,334,215,133,682,1
사직운동장→연산교차로,2023.8.13 21:00,149,372,58,579,1
신리→연산교차로,2023.8.13 21:00,300,162,26,488,1
안락→연산교차로,2023.8.13 21:00,353,0,91,444,1
연산터널→연산교차로,2023.8.13 21:00,187,185,48,420,1
교대→연산교차로,2023.8.13 22:00,189,0,197,386,1
부산시청→연산교차로,2023.8.13 22:00,301,221,122,644,1
사직운동장→연산교차로,2023.8.13 22:00,119,298,53,470,1
신리→연산교차로,2023.8.13 22:00,256,120,22,398,1
안락→연산교차로,2023.8.13 22:00,279,0,80,359,1
연산터널→연산교차로,2023.8.13 22:00,161,170,53,384,1
교대→연산교차로,2023.8.13 23:00,165,0,165,330,1
부산시청→연산교차로,2023.8.13 23:00,256,154,92,502,1
사직운동장→연산교차로,2023.8.13 23:00,76,252,60,388,1
신리→연산교차로,2023.8.13 23:00,208,101,25,334,1
안락→연산교차로,2023.8.13 23:00,206,0,63,269,1
연산터널→연산교차로,2023.8.13 23:00,124,149,69,342,1
교대→연산교차로,2023.8.14 00:00,106,0,160,266,0
부산시청→연산교차로,2023.8.14 00:00,233,138,83,454,0
사직운동장→연산교차로,2023.8.14 00:00,57,184,46,287,0
신리→연산교차로,2023.8.14 00:00,160,106,23,289,0
안락→연산교차로,2023.8.14 00:00,166,0,45,211,0
연산터널→연산교차로,2023.8.14 00:00,119,135,66,320,0
교대→연산교차로,2023.8.14 01:00,84,0,120,204,0
부산시청→연산교차로,2023.8.14 01:00,162,94,69,325,0
사직운동장→연산교차로,2023.8.14 01:00,43,164,34,241,0
신리→연산교차로,2023.8.14 01:00,106,53,12,171,0
안락→연산교차로,2023.8.14 01:00,131,0,30,161,0
연산터널→연산교차로,2023.8.14 01:00,86,120,42,248,0
교대→연산교차로,2023.8.14 02:00,54,0,104,158,0
부산시청→연산교차로,2023.8.14 02:00,139,70,49,258,0
사직운동장→연산교차로,2023.8.14 02:00,23,112,30,165,0
신리→연산교차로,2023.8.14 02:00,76,52,9,137,0
안락→연산교차로,2023.8.14 02:00,103,0,29,132,0
연산터널→연산교차로,2023.8.14 02:00,57,103,39,199,0
교대→연산교차로,2023.8.14 03:00,60,0,107,167,0
부산시청→연산교차로,2023.8.14 03:00,119,60,42,221,0
사직운동장→연산교차로,2023.8.14 03:00,25,113,20,158,0
신리→연산교차로,2023.8.14 03:00,70,30,5,105,0
안락→연산교차로,2023.8.14 03:00,89,0,28,117,0
연산터널→연산교차로,2023.8.14 03:00,71,87,34,192,0
교대→연산교차로,2023.8.14 04:00,44,0,71,115,0
부산시청→연산교차로,2023.8.14 04:00,151,57,39,247,0
사직운동장→연산교차로,2023.8.14 04:00,21,110,21,152,0
신리→연산교차로,2023.8.14 04:00,91,41,5,137,0
안락→연산교차로,2023.8.14 04:00,150,0,35,185,0
연산터널→연산교차로,2023.8.14 04:00,53,89,20,162,0
교대→연산교차로,2023.8.14 05:00,92,0,111,203,0
부산시청→연산교차로,2023.8.14 05:00,224,150,62,436,0
사직운동장→연산교차로,2023.8.14 05:00,53,157,23,233,0
신리→연산교차로,2023.8.14 05:00,194,99,9,302,0
안락→연산교차로,2023.8.14 05:00,302,0,47,349,0
연산터널→연산교차로,2023.8.14 05:00,124,129,18,271,0
교대→연산교차로,2023.8.14 06:00,171,0,191,362,0
부산시청→연산교차로,2023.8.14 06:00,376,248,116,740,0
사직운동장→연산교차로,2023.8.14 06:00,98,281,27,406,0
신리→연산교차로,2023.8.14 06:00,340,184,23,547,0
안락→연산교차로,2023.8.14 06:00,514,0,88,602,0
연산터널→연산교차로,2023.8.14 06:00,218,232,30,480,0
교대→연산교차로,2023.8.14 07:00,220,0,317,537,0
부산시청→연산교차로,2023.8.14 07:00,522,315,178,1015,0
사직운동장→연산교차로,2023.8.14 07:00,170,447,51,668,0
신리→연산교차로,2023.8.14 07:00,392,265,33,690,0
안락→연산교차로,2023.8.14 07:00,568,0,92,660,0
연산터널→연산교차로,2023.8.14 07:00,276,329,41,646,0
교대→연산교차로,2023.8.14 08:00,288,0,460,748,0
부산시청→연산교차로,2023.8.14 08:00,533,401,304,1238,0
사직운동장→연산교차로,2023.8.14 08:00,194,586,62,842,0
신리→연산교차로,2023.8.14 08:00,477,335,37,849,0
안락→연산교차로,2023.8.14 08:00,606,0,91,697,0
연산터널→연산교차로,2023.8.14 08:00,312,384,43,739,0
교대→연산교차로,2023.8.14 09:00,277,0,458,735,0
부산시청→연산교차로,2023.8.14 09:00,532,372,279,1183,0
사직운동장→연산교차로,2023.8.14 09:00,183,579,79,841,0
신리→연산교차로,2023.8.14 09:00,484,324,43,851,0
안락→연산교차로,2023.8.14 09:00,554,0,118,672,0
연산터널→연산교차로,2023.8.14 09:00,319,335,47,701,0
교대→연산교차로,2023.8.14 10:00,288,0,417,705,0
부산시청→연산교차로,2023.8.14 10:00,544,383,301,1228,0
사직운동장→연산교차로,2023.8.14 10:00,232,575,51,858,0
신리→연산교차로,2023.8.14 10:00,453,289,56,798,0
안락→연산교차로,2023.8.14 10:00,528,0,148,676,0
연산터널→연산교차로,2023.8.14 10:00,299,322,51,672,0
교대→연산교차로,2023.8.14 11:00,293,0,442,735,0
부산시청→연산교차로,2023.8.14 11:00,584,396,286,1266,0
사직운동장→연산교차로,2023.8.14 11:00,212,585,56,853,0
신리→연산교차로,2023.8.14 11:00,489,267,60,816,0
안락→연산교차로,2023.8.14 11:00,544,0,161,705,0
연산터널→연산교차로,2023.8.14 11:00,286,318,50,654,0
교대→연산교차로,2023.8.14 12:00,295,0,413,708,0
부산시청→연산교차로,2023.8.14 12:00,615,385,238,1238,0
사직운동장→연산교차로,2023.8.14 12:00,200,619,52,871,0
신리→연산교차로,2023.8.14 12:00,431,270,69,770,0
안락→연산교차로,2023.8.14 12:00,472,0,160,632,0
연산터널→연산교차로,2023.8.14 12:00,261,296,49,606,0
교대→연산교차로,2023.8.14 13:00,353,0,447,800,0
부산시청→연산교차로,2023.8.14 13:00,592,472,282,1346,0
사직운동장→연산교차로,2023.8.14 13:00,219,652,58,929,0
신리→연산교차로,2023.8.14 13:00,466,292,53,811,0
안락→연산교차로,2023.8.14 13:00,451,0,132,583,0
연산터널→연산교차로,2023.8.14 13:00,224,289,46,559,0
교대→연산교차로,2023.8.14 14:00,359,0,496,855,0
부산시청→연산교차로,2023.8.14 14:00,601,496,331,1428,0
사직운동장→연산교차로,2023.8.14 14:00,235,638,65,938,0
신리→연산교차로,2023.8.14 14:00,456,291,63,810,0
안락→연산교차로,2023.8.14 14:00,436,0,122,558,0
연산터널→연산교차로,2023.8.14 14:00,227,300,52,579,0
교대→연산교차로,2023.8.14 15:00,337,0,451,788,0
부산시청→연산교차로,2023.8.14 15:00,647,455,293,1395,0
사직운동장→연산교차로,2023.8.14 15:00,232,650,75,957,0
신리→연산교차로,2023.8.14 15:00,444,307,56,807,0
안락→연산교차로,2023.8.14 15:00,442,0,111,553,0
연산터널→연산교차로,2023.8.14 15:00,252,285,31,568,0
교대→연산교차로,2023.8.14 16:00,356,0,486,842,0
부산시청→연산교차로,2023.8.14 16:00,648,525,336,1509,0
사직운동장→연산교차로,2023.8.14 16:00,235,704,52,991,0
신리→연산교차로,2023.8.14 16:00,476,274,56,806,0
안락→연산교차로,2023.8.14 16:00,447,0,91,538,0
연산터널→연산교차로,2023.8.14 16:00,246,293,41,580,0
교대→연산교차로,2023.8.14 17:00,373,0,476,849,0
부산시청→연산교차로,2023.8.14 17:00,611,517,309,1437,0
사직운동장→연산교차로,2023.8.14 17:00,250,694,37,981,0
신리→연산교차로,2023.8.14 17:00,507,303,64,874,0
안락→연산교차로,2023.8.14 17:00,460,0,93,553,0
연산터널→연산교차로,2023.8.14 17:00,266,257,43,566,0
교대→연산교차로,2023.8.14 18:00,382,0,518,900,0
부산시청→연산교차로,2023.8.14 18:00,610,523,298,1431,0
사직운동장→연산교차로,2023.8.14 18:00,232,722,47,1001,0
신리→연산교차로,2023.8.14 18:00,509,259,62,830,0
안락→연산교차로,2023.8.14 18:00,440,0,95,535,0
연산터널→연산교차로,2023.8.14 18:00,217,267,43,527,0
교대→연산교차로,2023.8.14 19:00,339,0,406,745,0
부산시청→연산교차로,2023.8.14 19:00,568,400,245,1213,0
사직운동장→연산교차로,2023.8.14 19:00,199,550,69,818,0
신리→연산교차로,2023.8.14 19:00,342,191,28,561,0
안락→연산교차로,2023.8.14 19:00,435,0,102,537,0
연산터널→연산교차로,2023.8.14 19:00,204,262,44,510,0
교대→연산교차로,2023.8.14 20:00,307,0,362,669,0
부산시청→연산교차로,2023.8.14 20:00,474,335,223,1032,0
사직운동장→연산교차로,2023.8.14 20:00,198,487,66,751,0
신리→연산교차로,2023.8.14 20:00,335,184,44,563,0
안락→연산교차로,2023.8.14 20:00,423,0,97,520,0
연산터널→연산교차로,2023.8.14 20:00,218,272,60,550,0
교대→연산교차로,2023.8.14 21:00,275,0,320,595,0
부산시청→연산교차로,2023.8.14 21:00,451,308,215,974,0
사직운동장→연산교차로,2023.8.14 21:00,173,436,81,690,0
신리→연산교차로,2023.8.14 21:00,293,197,34,524,0
안락→연산교차로,2023.8.14 21:00,391,0,97,488,0
연산터널→연산교차로,2023.8.14 21:00,222,248,64,534,0
교대→연산교차로,2023.8.14 22:00,226,0,264,490,0
부산시청→연산교차로,2023.8.14 22:00,415,282,148,845,0
사직운동장→연산교차로,2023.8.14 22:00,146,365,86,597,0
신리→연산교차로,2023.8.14 22:00,275,180,24,479,0
안락→연산교차로,2023.8.14 22:00,337,0,109,446,0
연산터널→연산교차로,2023.8.14 22:00,216,205,57,478,0
교대→연산교차로,2023.8.14 23:00,210,0,205,415,0
부산시청→연산교차로,2023.8.14 23:00,324,213,168,705,0
사직운동장→연산교차로,2023.8.14 23:00,99,293,85,477,0
신리→연산교차로,2023.8.14 23:00,270,143,16,429,0
안락→연산교차로,2023.8.14 23:00,260,0,82,342,0
연산터널→연산교차로,2023.8.14 23:00,176,194,57,427,0
교대→연산교차로,2023.8.15 00:00,158,0,186,344,1
부산시청→연산교차로,2023.8.15 00:00,280,179,110,569,1
사직운동장→연산교차로,2023.8.15 00:00,90,248,66,404,1
신리→연산교차로,2023.8.15 00:00,218,112,25,355,1
안락→연산교차로,2023.8.15 00:00,219,0,69,288,1
연산터널→연산교차로,2023.8.15 00:00,165,179,38,382,1
교대→연산교차로,2023.8.15 01:00,124,0,202,326,1
부산시청→연산교차로,2023.8.15 01:00,233,157,96,486,1
사직운동장→연산교차로,2023.8.15 01:00,72,170,45,287,1
신리→연산교차로,2023.8.15 01:00,152,89,11,252,1
안락→연산교차로,2023.8.15 01:00,184,0,44,228,1
연산터널→연산교차로,2023.8.15 01:00,116,183,57,356,1
교대→연산교차로,2023.8.15 02:00,112,0,166,278,1
부산시청→연산교차로,2023.8.15 02:00,191,116,79,386,1
사직운동장→연산교차로,2023.8.15 02:00,51,165,48,264,1
신리→연산교차로,2023.8.15 02:00,128,68,12,208,1
안락→연산교차로,2023.8.15 02:00,157,0,48,205,1
연산터널→연산교차로,2023.8.15 02:00,107,131,32,270,1
교대→연산교차로,2023.8.15 03:00,69,0,156,225,1
부산시청→연산교차로,2023.8.15 03:00,199,101,56,356,1
사직운동장→연산교차로,2023.8.15 03:00,36,141,42,219,1
신리→연산교차로,2023.8.15 03:00,81,63,9,153,1
안락→연산교차로,2023.8.15 03:00,142,0,40,182,1
연산터널→연산교차로,2023.8.15 03:00,81,128,51,260,1
교대→연산교차로,2023.8.15 04:00,83,0,120,203,1
부산시청→연산교차로,2023.8.15 04:00,186,98,57,341,1
사직운동장→연산교차로,2023.8.15 04:00,46,117,21,184,1
신리→연산교차로,2023.8.15 04:00,94,46,7,147,1
안락→연산교차로,2023.8.15 04:00,175,0,43,218,1
연산터널→연산교차로,2023.8.15 04:00,83,107,19,209,1
교대→연산교차로,2023.8.15 05:00,91,0,129,220,1
부산시청→연산교차로,2023.8.15 05:00,232,161,74,467,1
사직운동장→연산교차로,2023.8.15 05:00,43,180,47,270,1
신리→연산교차로,2023.8.15 05:00,188,84,7,279,1
안락→연산교차로,2023.8.15 05:00,272,0,47,319,1
연산터널→연산교차로,2023.8.15 05:00,123,138,39,300,1
교대→연산교차로,2023.8.15 06:00,144,0,168,312,1
부산시청→연산교차로,2023.8.15 06:00,340,206,102,648,1
사직운동장→연산교차로,2023.8.15 06:00,91,218,62,371,1
신리→연산교차로,2023.8.15 06:00,255,155,17,427,1
안락→연산교차로,2023.8.15 06:00,359,0,82,441,1
연산터널→연산교차로,2023.8.15 06:00,183,177,40,400,1
교대→연산교차로,2023.8.15 07:00,132,0,165,297,1
부산시청→연산교차로,2023.8.15 07:00,364,191,124,679,1
사직운동장→연산교차로,2023.8.15 07:00,82,280,55,417,1
신리→연산교차로,2023.8.15 07:00,276,115,20,411,1
안락→연산교차로,2023.8.15 07:00,354,0,86,440,1
연산터널→연산교차로,2023.8.15 07:00,179,177,40,396,1
교대→연산교차로,2023.8.15 08:00,161,0,197,358,1
부산시청→연산교차로,2023.8.15 08:00,346,246,164,756,1
사직운동장→연산교차로,2023.8.15 08:00,106,339,42,487,1
신리→연산교차로,2023.8.15 08:00,312,180,42,534,1
안락→연산교차로,2023.8.15 08:00,393,0,101,494,1
연산터널→연산교차로,2023.8.15 08:00,179,185,39,403,1
교대→연산교차로,2023.8.15 09:00,199,0,236,435,1
부산시청→연산교차로,2023.8.15 09:00,421,259,202,882,1
사직운동장→연산교차로,2023.8.15 09:00,138,460,50,648,1
신리→연산교차로,2023.8.15 09:00,370,225,46,641,1
안락→연산교차로,2023.8.15 09:00,417,0,79,496,1
연산터널→연산교차로,2023.8.15 09:00,215,237,30,482,1
교대→연산교차로,2023.8.15 10:00,257,0,294,551,1
부산시청→연산교차로,2023.8.15 10:00,489,327,225,1041,1
사직운동장→연산교차로,2023.8.15 10:00,182,535,47,764,1
신리→연산교차로,2023.8.15 10:00,408,200,42,650,1
안락→연산교차로,2023.8.15 10:00,449,0,121,570,1
연산터널→연산교차로,2023.8.15 10:00,221,274,36,531,1
교대→연산교차로,2023.8.15 11:00,252,0,282,534,1
부산시청→연산교차로,2023.8.15 11:00,514,353,231,1098,1
사직운동장→연산교차로,2023.8.15 11:00,181,545,36,762,1
신리→연산교차로,2023.8.15 11:00,432,250,37,719,1
안락→연산교차로,2023.8.15 11:00,493,0,128,621,1
연산터널→연산교차로,2023.8.15 11:00,278,295,43,616,1
교대→연산교차로,2023.8.15 12:00,277,0,287,564,1
부산시청→연산교차로,2023.8.15 12:00,524,364,231,1119,1
사직운동장→연산교차로,2023.8.15 12:00,181,539,41,761,1
신리→연산교차로,2023.8.15 12:00,420,232,57,709,1
안락→연산교차로,2023.8.15 12:00,430,0,135,565,1
연산터널→연산교차로,2023.8.15 12:00,249,286,63,598,1
교대→연산교차로,2023.8.15 13:00,278,0,303,581,1
부산시청→연산교차로,2023.8.15 13:00,546,341,228,1115,1
사직운동장→연산교차로,2023.8.15 13:00,201,556,42,799,1
신리→연산교차로,2023.8.15 13:00,369,221,43,633,1
안락→연산교차로,2023.8.15 13:00,464,0,161,625,1
연산터널→연산교차로,2023.8.15 13:00,231,278,55,564,1
교대→연산교차로,2023.8.15 14:00,277,0,274,551,1
부산시청→연산교차로,2023.8.15 14:00,630,370,253,1253,1
사직운동장→연산교차로,2023.8.15 14:00,198,551,48,797,1
신리→연산교차로,2023.8.15 14:00,395,247,58,700,1
안락→연산교차로,2023.8.15 14:00,523,0,130,653,1
연산터널→연산교차로,2023.8.15 14:00,260,241,47,548,1
교대→연산교차로,2023.8.15 15:00,271,0,321,592,1
부산시청→연산교차로,2023.8.15 15:00,587,382,256,1225,1
사직운동장→연산교차로,2023.8.15 15:00,184,590,57,831,1
신리→연산교차로,2023.8.15 15:00,405,253,52,710,1
안락→연산교차로,2023.8.15 15:00,506,0,149,655,1
연산터널→연산교차로,2023.8.15 15:00,243,280,45,568,1
교대→연산교차로,2023.8.15 16:00,284,0,316,600,1
부산시청→연산교차로,2023.8.15 16:00,549,363,245,1157,1
사직운동장→연산교차로,2023.8.15 16:00,192,573,58,823,1
신리→연산교차로,2023.8.15 16:00,383,299,42,724,1
안락→연산교차로,2023.8.15 16:00,528,0,153,681,1
연산터널→연산교차로,2023.8.15 16:00,257,293,47,597,1
교대→연산교차로,2023.8.15 17:00,301,0,325,626,1
부산시청→연산교차로,2023.8.15 17:00,568,361,239,1168,1
사직운동장→연산교차로,2023.8.15 17:00,240,579,48,867,1
신리→연산교차로,2023.8.15 17:00,415,256,47,718,1
안락→연산교차로,2023.8.15 17:00,525,0,147,672,1
연산터널→연산교차로,2023.8.15 17:00,251,252,52,555,1
교대→연산교차로,2023.8.15 18:00,312,0,378,690,1
부산시청→연산교차로,2023.8.15 18:00,504,304,235,1043,1
사직운동장→연산교차로,2023.8.15 18:00,193,485,65,743,1
신리→연산교차로,2023.8.15 18:00,377,239,41,657,1
안락→연산교차로,2023.8.15 18:00,498,0,125,623,1
연산터널→연산교차로,2023.8.15 18:00,225,230,75,530,1
교대→연산교차로,2023.8.15 19:00,273,0,301,574,1
부산시청→연산교차로,2023.8.15 19:00,448,302,194,944,1
사직운동장→연산교차로,2023.8.15 19:00,162,452,76,690,1
신리→연산교차로,2023.8.15 19:00,297,186,26,509,1
안락→연산교차로,2023.8.15 19:00,461,0,128,589,1
연산터널→연산교차로,2023.8.15 19:00,224,253,54,531,1
교대→연산교차로,2023.8.15 20:00,277,0,278,555,1
부산시청→연산교차로,2023.8.15 20:00,418,277,184,879,1
사직운동장→연산교차로,2023.8.15 20:00,180,418,64,662,1
신리→연산교차로,2023.8.15 20:00,271,171,31,473,1
안락→연산교차로,2023.8.15 20:00,436,0,135,571,1
연산터널→연산교차로,2023.8.15 20:00,187,241,42,470,1
교대→연산교차로,2023.8.15 21:00,232,0,216,448,1
부산시청→연산교차로,2023.8.15 21:00,396,251,192,839,1
사직운동장→연산교차로,2023.8.15 21:00,168,435,54,657,1
신리→연산교차로,2023.8.15 21:00,291,181,32,504,1
안락→연산교차로,2023.8.15 21:00,349,0,105,454,1
연산터널→연산교차로,2023.8.15 21:00,217,211,44,472,1
교대→연산교차로,2023.8.15 22:00,219,0,205,424,1
부산시청→연산교차로,2023.8.15 22:00,342,181,122,645,1
사직운동장→연산교차로,2023.8.15 22:00,117,312,72,501,1
신리→연산교차로,2023.8.15 22:00,213,137,27,377,1
안락→연산교차로,2023.8.15 22:00,306,0,69,375,1
연산터널→연산교차로,2023.8.15 22:00,167,181,73,421,1
교대→연산교차로,2023.8.15 23:00,133,0,194,327,1
부산시청→연산교차로,2023.8.15 23:00,248,180,90,518,1
사직운동장→연산교차로,2023.8.15 23:00,83,280,51,414,1
신리→연산교차로,2023.8.15 23:00,191,104,31,326,1
안락→연산교차로,2023.8.15 23:00,210,0,61,271,1
연산터널→연산교차로,2023.8.15 23:00,140,200,81,421,1
교대→연산교차로,2023.8.16 00:00,137,0,171,308,0
부산시청→연산교차로,2023.8.16 00:00,251,127,94,472,0
사직운동장→연산교차로,2023.8.16 00:00,54,221,47,322,0
신리→연산교차로,2023.8.16 00:00,143,82,17,242,0
안락→연산교차로,2023.8.16 00:00,176,0,50,226,0
연산터널→연산교차로,2023.8.16 00:00,128,153,68,349,0
교대→연산교차로,2023.8.16 01:00,93,0,163,256,0
부산시청→연산교차로,2023.8.16 01:00,190,101,67,358,0
사직운동장→연산교차로,2023.8.16 01:00,54,155,34,243,0
신리→연산교차로,2023.8.16 01:00,88,67,13,168,0
안락→연산교차로,2023.8.16 01:00,136,0,37,173,0
연산터널→연산교차로,2023.8.16 01:00,84,120,46,250,0
교대→연산교차로,2023.8.16 02:00,63,0,123,186,0
부산시청→연산교차로,2023.8.16 02:00,121,73,41,235,0
사직운동장→연산교차로,2023.8.16 02:00,37,133,43,213,0
신리→연산교차로,2023.8.16 02:00,88,42,7,137,0
안락→연산교차로,2023.8.16 02:00,118,0,25,143,0
연산터널→연산교차로,2023.8.16 02:00,72,114,37,223,0
교대→연산교차로,2023.8.16 03:00,52,0,80,132,0
부산시청→연산교차로,2023.8.16 03:00,123,59,35,217,0
사직운동장→연산교차로,2023.8.16 03:00,22,100,32,154,0
신리→연산교차로,2023.8.16 03:00,64,30,5,99,0
안락→연산교차로,2023.8.16 03:00,94,0,30,124,0
연산터널→연산교차로,2023.8.16 03:00,53,83,43,179,0
교대→연산교차로,2023.8.16 04:00,58,0,73,131,0
부산시청→연산교차로,2023.8.16 04:00,142,89,40,271,0
사직운동장→연산교차로,2023.8.16 04:00,31,121,14,166,0
신리→연산교차로,2023.8.16 04:00,80,43,4,127,0
안락→연산교차로,2023.8.16 04:00,179,0,30,209,0
연산터널→연산교차로,2023.8.16 04:00,82,77,26,185,0
교대→연산교차로,2023.8.16 05:00,84,0,113,197,0
부산시청→연산교차로,2023.8.16 05:00,208,151,76,435,0
사직운동장→연산교차로,2023.8.16 05:00,39,169,31,239,0
신리→연산교차로,2023.8.16 05:00,206,95,13,314,0
안락→연산교차로,2023.8.16 05:00,293,0,55,348,0
연산터널→연산교차로,2023.8.16 05:00,135,144,25,304,0
교대→연산교차로,2023.8.16 06:00,187,0,227,414,0
부산시청→연산교차로,2023.8.16 06:00,380,269,105,754,0
사직운동장→연산교차로,2023.8.16 06:00,111,285,57,453,0
신리→연산교차로,2023.8.16 06:00,326,187,30,543,0
안락→연산교차로,2023.8.16 06:00,490,0,109,599,0
연산터널→연산교차로,2023.8.16 06:00,235,211,50,496,0
교대→연산교차로,2023.8.16 07:00,267,0,397,664,0
부산시청→연산교차로,2023.8.16 07:00,514,361,222,1097,0
사직운동장→연산교차로,2023.8.16 07:00,179,519,54,752,0
신리→연산교차로,2023.8.16 07:00,459,286,31,776,0
안락→연산교차로,2023.8.16 07:00,619,0,78,697,0
연산터널→연산교차로,2023.8.16 07:00,306,368,39,713,0
교대→연산교차로,2023.8.16 08:00,297,0,501,798,0
부산시청→연산교차로,2023.8.16 08:00,564,414,348,1326,0
사직운동장→연산교차로,2023.8.16 08:00,198,668,51,917,0
신리→연산교차로,2023.8.16 08:00,498,362,38,898,0
안락→연산교차로,2023.8.16 08:00,620,0,108,728,0
연산터널→연산교차로,2023.8.16 08:00,324,382,40,746,0
교대→연산교차로,2023.8.16 09:00,313,0,511,824,0
부산시청→연산교차로,2023.8.16 09:00,518,372,309,1199,0
사직운동장→연산교차로,2023.8.16 09:00,183,570,89,842,0
신리→연산교차로,2023.8.16 09:00,442,341,42,825,0
안락→연산교차로,2023.8.16 09:00,586,0,121,707,0
연산터널→연산교차로,2023.8.16 09:00,298,345,43,686,0
교대→연산교차로,2023.8.16 10:00,294,0,483,777,0
부산시청→연산교차로,2023.8.16 10:00,541,385,281,1207,0
사직운동장→연산교차로,2023.8.16 10:00,187,606,55,848,0
신리→연산교차로,2023.8.16 10:00,510,301,46,857,0
안락→연산교차로,2023.8.16 10:00,560,0,158,718,0
연산터널→연산교차로,2023.8.16 10:00,304,341,51,696,0
교대→연산교차로,2023.8.16 11:00,306,0,482,788,0
부산시청→연산교차로,2023.8.16 11:00,593,371,310,1274,0
사직운동장→연산교차로,2023.8.16 11:00,206,589,56,851,0
신리→연산교차로,2023.8.16 11:00,451,272,58,781,0
안락→연산교차로,2023.8.16 11:00,513,0,145,658,0
연산터널→연산교차로,2023.8.16 11:00,290,334,47,671,0
교대→연산교차로,2023.8.16 12:00,303,0,464,767,0
부산시청→연산교차로,2023.8.16 12:00,574,377,275,1226,0
사직운동장→연산교차로,2023.8.16 12:00,175,580,66,821,0
신리→연산교차로,2023.8.16 12:00,398,265,50,713,0
안락→연산교차로,2023.8.16 12:00,517,0,165,682,0
연산터널→연산교차로,2023.8.16 12:00,275,309,49,633,0
교대→연산교차로,2023.8.16 13:00,334,0,434,768,0
부산시청→연산교차로,2023.8.16 13:00,587,427,274,1288,0
사직운동장→연산교차로,2023.8.16 13:00,210,596,75,881,0
신리→연산교차로,2023.8.16 13:00,434,289,61,784,0
안락→연산교차로,2023.8.16 13:00,429,0,138,567,0
연산터널→연산교차로,2023.8.16 13:00,234,268,58,560,0
교대→연산교차로,2023.8.16 14:00,339,0,483,822,0
부산시청→연산교차로,2023.8.16 14:00,571,462,266,1299,0
사직운동장→연산교차로,2023.8.16 14:00,248,637,71,956,0
신리→연산교차로,2023.8.16 14:00,447,299,82,828,0
안락→연산교차로,2023.8.16 14:00,461,0,115,576,0
연산터널→연산교차로,2023.8.16 14:00,250,285,47,582,0
교대→연산교차로,2023.8.16 15:00,341,0,466,807,0
부산시청→연산교차로,2023.8.16 15:00,603,471,311,1385,0
사직운동장→연산교차로,2023.8.16 15:00,223,651,60,934,0
신리→연산교차로,2023.8.16 15:00,447,277,68,792,0
안락→연산교차로,2023.8.16 15:00,426,0,129,555,0
연산터널→연산교차로,2023.8.16 15:00,235,279,44,558,0
교대→연산교차로,2023.8.16 16:00,344,0,490,834,0
부산시청→연산교차로,2023.8.16 16:00,596,501,305,1402,0
사직운동장→연산교차로,2023.8.16 16:00,235,638,59,932,0
신리→연산교차로,2023.8.16 16:00,533,280,63,876,0
안락→연산교차로,2023.8.16 16:00,437,0,111,548,0
연산터널→연산교차로,2023.8.16 16:00,260,281,39,580,0
교대→연산교차로,2023.8.16 17:00,376,0,532,908,0
부산시청→연산교차로,2023.8.16 17:00,631,575,298,1504,0
사직운동장→연산교차로,2023.8.16 17:00,220,717,41,978,0
신리→연산교차로,2023.8.16 17:00,492,311,53,856,0
안락→연산교차로,2023.8.16 17:00,447,0,109,556,0
연산터널→연산교차로,2023.8.16 17:00,225,280,44,549,0
교대→연산교차로,2023.8.16 18:00,385,0,562,947,0
부산시청→연산교차로,2023.8.16 18:00,604,577,329,1510,0
사직운동장→연산교차로,2023.8.16 18:00,237,693,38,968,0
신리→연산교차로,2023.8.16 18:00,470,267,47,784,0
안락→연산교차로,2023.8.16 18:00,466,0,96,562,0
연산터널→연산교차로,2023.8.16 18:00,228,277,51,556,0
교대→연산교차로,2023.8.16 19:00,339,0,416,755,0
부산시청→연산교차로,2023.8.16 19:00,505,366,240,1111,0
사직운동장→연산교차로,2023.8.16 19:00,194,570,77,841,0
신리→연산교차로,2023.8.16 19:00,325,193,41,559,0
안락→연산교차로,2023.8.16 19:00,416,0,89,505,0
연산터널→연산교차로,2023.8.16 19:00,210,253,49,512,0
교대→연산교차로,2023.8.16 20:00,282,0,311,593,0
부산시청→연산교차로,2023.8.16 20:00,486,314,223,1023,0
사직운동장→연산교차로,2023.8.16 20:00,152,487,83,722,0
신리→연산교차로,2023.8.16 20:00,321,189,35,545,0
안락→연산교차로,2023.8.16 20:00,376,0,95,471,0
연산터널→연산교차로,2023.8.16 20:00,199,268,54,521,0
교대→연산교차로,2023.8.16 21:00,273,0,287,560,0
부산시청→연산교차로,2023.8.16 21:00,453,319,201,973,0
사직운동장→연산교차로,2023.8.16 21:00,173,476,74,723,0
신리→연산교차로,2023.8.16 21:00,319,185,26,530,0
안락→연산교차로,2023.8.16 21:00,419,0,93,512,0
연산터널→연산교차로,2023.8.16 21:00,210,248,59,517,0
교대→연산교차로,2023.8.16 22:00,228,0,228,456,0
부산시청→연산교차로,2023.8.16 22:00,385,267,143,795,0
사직운동장→연산교차로,2023.8.16 22:00,208,395,70,673,0
신리→연산교차로,2023.8.16 22:00,242,157,28,427,0
안락→연산교차로,2023.8.16 22:00,287,0,89,376,0
연산터널→연산교차로,2023.8.16 22:00,206,207,58,471,0
교대→연산교차로,2023.8.16 23:00,184,0,186,370,0
부산시청→연산교차로,2023.8.16 23:00,269,171,137,577,0
사직운동장→연산교차로,2023.8.16 23:00,118,297,75,490,0
신리→연산교차로,2023.8.16 23:00,189,103,23,315,0
안락→연산교차로,2023.8.16 23:00,224,0,59,283,0
연산터널→연산교차로,2023.8.16 23:00,159,187,68,414,0
교대→연산교차로,2023.8.17 00:00,136,0,192,328,0
부산시청→연산교차로,2023.8.17 00:00,252,156,103,511,0
사직운동장→연산교차로,2023.8.17 00:00,81,238,72,391,0
신리→연산교차로,2023.8.17 00:00,154,95,13,262,0
안락→연산교차로,2023.8.17 00:00,232,0,55,287,0
연산터널→연산교차로,2023.8.17 00:00,148,170,59,377,0
교대→연산교차로,2023.8.17 01:00,99,0,163,262,0
부산시청→연산교차로,2023.8.17 01:00,198,102,90,390,0
사직운동장→연산교차로,2023.8.17 01:00,68,173,41,282,0
신리→연산교차로,2023.8.17 01:00,106,73,10,189,0
안락→연산교차로,2023.8.17 01:00,147,0,34,181,0
연산터널→연산교차로,2023.8.17 01:00,114,128,66,308,0
교대→연산교차로,2023.8.17 02:00,78,0,123,201,0
부산시청→연산교차로,2023.8.17 02:00,160,83,58,301,0
사직운동장→연산교차로,2023.8.17 02:00,37,137,35,209,0
신리→연산교차로,2023.8.17 02:00,75,54,14,143,0
안락→연산교차로,2023.8.17 02:00,126,0,29,155,0
연산터널→연산교차로,2023.8.17 02:00,98,121,35,254,0
교대→연산교차로,2023.8.17 03:00,58,0,97,155,0
부산시청→연산교차로,2023.8.17 03:00,137,70,50,257,0
사직운동장→연산교차로,2023.8.17 03:00,32,145,28,205,0
신리→연산교차로,2023.8.17 03:00,64,42,10,116,0
안락→연산교차로,2023.8.17 03:00,110,0,28,138,0
연산터널→연산교차로,2023.8.17 03:00,75,106,35,216,0
교대→연산교차로,2023.8.17 04:00,53,0,94,147,0
부산시청→연산교차로,2023.8.17 04:00,162,84,40,286,0
사직운동장→연산교차로,2023.8.17 04:00,26,105,20,151,0
신리→연산교차로,2023.8.17 04:00,104,49,7,160,0
안락→연산교차로,2023.8.17 04:00,169,0,33,202,0
연산터널→연산교차로,2023.8.17 04:00,74,107,17,198,0
교대→연산교차로,2023.8.17 05:00,93,0,126,219,0
부산시청→연산교차로,2023.8.17 05:00,244,159,75,478,0
사직운동장→연산교차로,2023.8.17 05:00,57,184,32,273,0
신리→연산교차로,2023.8.17 05:00,206,78,11,295,0
안락→연산교차로,2023.8.17 05:00,309,0,49,358,0
연산터널→연산교차로,2023.8.17 05:00,145,126,27,298,0
교대→연산교차로,2023.8.17 06:00,172,0,210,382,0
부산시청→연산교차로,2023.8.17 06:00,373,253,108,734,0
사직운동장→연산교차로,2023.8.17 06:00,100,309,49,458,0
신리→연산교차로,2023.8.17 06:00,322,209,18,549,0
안락→연산교차로,2023.8.17 06:00,499,0,84,583,0
연산터널→연산교차로,2023.8.17 06:00,247,216,33,496,0
교대→연산교차로,2023.8.17 07:00,234,0,414,648,0
부산시청→연산교차로,2023.8.17 07:00,568,328,218,1114,0
사직운동장→연산교차로,2023.8.17 07:00,173,511,59,743,0
신리→연산교차로,2023.8.17 07:00,443,282,28,753,0
안락→연산교차로,2023.8.17 07:00,649,0,97,746,0
연산터널→연산교차로,2023.8.17 07:00,280,379,34,693,0
교대→연산교차로,2023.8.17 08:00,293,0,535,828,0
부산시청→연산교차로,2023.8.17 08:00,568,422,346,1336,0
사직운동장→연산교차로,2023.8.17 08:00,218,615,49,882,0
신리→연산교차로,2023.8.17 08:00,501,363,36,900,0
안락→연산교차로,2023.8.17 08:00,592,0,107,699,0
연산터널→연산교차로,2023.8.17 08:00,309,364,38,711,0
교대→연산교차로,2023.8.17 09:00,281,0,425,706,0
부산시청→연산교차로,2023.8.17 09:00,523,372,286,1181,0
사직운동장→연산교차로,2023.8.17 09:00,175,555,77,807,0
신리→연산교차로,2023.8.17 09:00,424,346,49,819,0
안락→연산교차로,2023.8.17 09:00,585,0,126,711,0
연산터널→연산교차로,2023.8.17 09:00,282,348,39,669,0
교대→연산교차로,2023.8.17 10:00,274,0,459,733,0
부산시청→연산교차로,2023.8.17 10:00,543,344,301,1188,0
사직운동장→연산교차로,2023.8.17 10:00,226,599,54,879,0
신리→연산교차로,2023.8.17 10:00,455,286,55,796,0
안락→연산교차로,2023.8.17 10:00,535,0,152,687,0
연산터널→연산교차로,2023.8.17 10:00,316,304,48,668,0
교대→연산교차로,2023.8.17 11:00,294,0,436,730,0
부산시청→연산교차로,2023.8.17 11:00,557,342,280,1179,0
사직운동장→연산교차로,2023.8.17 11:00,186,573,71,830,0
신리→연산교차로,2023.8.17 11:00,427,269,66,762,0
안락→연산교차로,2023.8.17 11:00,494,0,159,653,0
연산터널→연산교차로,2023.8.17 11:00,245,292,47,584,0
교대→연산교차로,2023.8.17 12:00,307,0,373,680,0
부산시청→연산교차로,2023.8.17 12:00,515,338,230,1083,0
사직운동장→연산교차로,2023.8.17 12:00,189,578,82,849,0
신리→연산교차로,2023.8.17 12:00,379,245,55,679,0
안락→연산교차로,2023.8.17 12:00,472,0,168,640,0
연산터널→연산교차로,2023.8.17 12:00,303,280,55,638,0
교대→연산교차로,2023.8.17 13:00,328,0,428,756,0
부산시청→연산교차로,2023.8.17 13:00,557,411,273,1241,0
사직운동장→연산교차로,2023.8.17 13:00,204,573,78,855,0
신리→연산교차로,2023.8.17 13:00,444,299,45,788,0
안락→연산교차로,2023.8.17 13:00,433,0,113,546,0
연산터널→연산교차로,2023.8.17 13:00,260,276,44,580,0
교대→연산교차로,2023.8.17 14:00,348,0,481,829,0
부산시청→연산교차로,2023.8.17 14:00,541,420,287,1248,0
사직운동장→연산교차로,2023.8.17 14:00,221,609,79,909,0
신리→연산교차로,2023.8.17 14:00,421,261,62,744,0
안락→연산교차로,2023.8.17 14:00,428,0,107,535,0
연산터널→연산교차로,2023.8.17 14:00,247,271,42,560,0
교대→연산교차로,2023.8.17 15:00,330,0,475,805,0
부산시청→연산교차로,2023.8.17 15:00,574,478,316,1368,0
사직운동장→연산교차로,2023.8.17 15:00,194,616,77,887,0
신리→연산교차로,2023.8.17 15:00,445,274,52,771,0
안락→연산교차로,2023.8.17 15:00,432,0,106,538,0
연산터널→연산교차로,2023.8.17 15:00,239,279,36,554,0
교대→연산교차로,2023.8.17 16:00,367,0,485,852,0
부산시청→연산교차로,2023.8.17 16:00,593,527,321,1441,0
사직운동장→연산교차로,2023.8.17 16:00,241,642,60,943,0
신리→연산교차로,2023.8.17 16:00,498,296,58,852,0
안락→연산교차로,2023.8.17 16:00,462,0,110,572,0
연산터널→연산교차로,2023.8.17 16:00,250,283,40,573,0
교대→연산교차로,2023.8.17 17:00,373,0,506,879,0
부산시청→연산교차로,2023.8.17 17:00,624,544,318,1486,0
사직운동장→연산교차로,2023.8.17 17:00,238,694,33,965,0
신리→연산교차로,2023.8.17 17:00,477,317,50,844,0
안락→연산교차로,2023.8.17 17:00,445,0,110,555,0
연산터널→연산교차로,2023.8.17 17:00,236,282,31,549,0
교대→연산교차로,2023.8.17 18:00,380,0,577,957,0
부산시청→연산교차로,2023.8.17 18:00,578,595,328,1501,0
사직운동장→연산교차로,2023.8.17 18:00,231,706,41,978,0
신리→연산교차로,2023.8.17 18:00,497,277,43,817,0
안락→연산교차로,2023.8.17 18:00,460,0,122,582,0
연산터널→연산교차로,2023.8.17 18:00,209,286,50,545,0
교대→연산교차로,2023.8.17 19:00,317,0,410,727,0
부산시청→연산교차로,2023.8.17 19:00,511,388,271,1170,0
사직운동장→연산교차로,2023.8.17 19:00,195,591,81,867,0
신리→연산교차로,2023.8.17 19:00,342,201,41,584,0
안락→연산교차로,2023.8.17 19:00,427,0,102,529,0
연산터널→연산교차로,2023.8.17 19:00,213,244,53,510,0
교대→연산교차로,2023.8.17 20:00,297,0,365,662,0
부산시청→연산교차로,2023.8.17 20:00,477,361,242,1080,0
사직운동장→연산교차로,2023.8.17 20:00,155,518,83,756,0
신리→연산교차로,2023.8.17 20:00,335,204,32,571,0
안락→연산교차로,2023.8.17 20:00,406,0,107,513,0
연산터널→연산교차로,2023.8.17 20:00,203,260,57,520,0
교대→연산교차로,2023.8.17 21:00,287,0,268,555,0
부산시청→연산교차로,2023.8.17 21:00,472,288,229,989,0
사직운동장→연산교차로,2023.8.17 21:00,164,448,73,685,0
신리→연산교차로,2023.8.17 21:00,289,183,27,499,0
안락→연산교차로,2023.8.17 21:00,379,0,108,487,0
연산터널→연산교차로,2023.8.17 21:00,211,284,62,557,0
교대→연산교차로,2023.8.17 22:00,244,0,230,474,0
부산시청→연산교차로,2023.8.17 22:00,421,241,164,826,0
사직운동장→연산교차로,2023.8.17 22:00,162,373,89,624,0
신리→연산교차로,2023.8.17 22:00,260,169,21,450,0
안락→연산교차로,2023.8.17 22:00,332,0,123,455,0
연산터널→연산교차로,2023.8.17 22:00,199,236,58,493,0
교대→연산교차로,2023.8.17 23:00,189,0,198,387,0
부산시청→연산교차로,2023.8.17 23:00,333,189,154,676,0
사직운동장→연산교차로,2023.8.17 23:00,140,336,81,557,0
신리→연산교차로,2023.8.17 23:00,205,126,20,351,0
안락→연산교차로,2023.8.17 23:00,263,0,69,332,0
연산터널→연산교차로,2023.8.17 23:00,156,202,51,409,0
교대→연산교차로,2023.8.18 00:00,172,0,191,363,0
부산시청→연산교차로,2023.8.18 00:00,260,143,104,507,0
사직운동장→연산교차로,2023.8.18 00:00,75,229,70,374,0
신리→연산교차로,2023.8.18 00:00,181,83,22,286,0
안락→연산교차로,2023.8.18 00:00,215,0,67,282,0
연산터널→연산교차로,2023.8.18 00:00,127,168,69,364,0
교대→연산교차로,2023.8.18 01:00,112,0,167,279,0
부산시청→연산교차로,2023.8.18 01:00,191,120,68,379,0
사직운동장→연산교차로,2023.8.18 01:00,61,194,51,306,0
신리→연산교차로,2023.8.18 01:00,113,65,11,189,0
안락→연산교차로,2023.8.18 01:00,166,0,40,206,0
연산터널→연산교차로,2023.8.18 01:00,131,140,69,340,0
교대→연산교차로,2023.8.18 02:00,75,0,127,202,0
부산시청→연산교차로,2023.8.18 02:00,181,97,70,348,0
사직운동장→연산교차로,2023.8.18 02:00,48,152,45,245,0
신리→연산교차로,2023.8.18 02:00,90,47,10,147,0
안락→연산교차로,2023.8.18 02:00,136,0,44,180,0
연산터널→연산교차로,2023.8.18 02:00,107,107,40,254,0
교대→연산교차로,2023.8.18 03:00,73,0,132,205,0
부산시청→연산교차로,2023.8.18 03:00,126,86,72,284,0
사직운동장→연산교차로,2023.8.18 03:00,28,141,32,201,0
신리→연산교차로,2023.8.18 03:00,82,53,9,144,0
안락→연산교차로,2023.8.18 03:00,128,0,23,151,0
연산터널→연산교차로,2023.8.18 03:00,87,105,41,233,0
교대→연산교차로,2023.8.18 04:00,61,0,88,149,0
부산시청→연산교차로,2023.8.18 04:00,160,81,48,289,0
사직운동장→연산교차로,2023.8.18 04:00,25,113,25,163,0
신리→연산교차로,2023.8.18 04:00,89,56,9,154,0
안락→연산교차로,2023.8.18 04:00,167,0,34,201,0
연산터널→연산교차로,2023.8.18 04:00,71,89,27,187,0
교대→연산교차로,2023.8.18 05:00,90,0,125,215,0
부산시청→연산교차로,2023.8.18 05:00,232,144,70,446,0
사직운동장→연산교차로,2023.8.18 05:00,51,185,15,251,0
신리→연산교차로,2023.8.18 05:00,200,87,12,299,0
안락→연산교차로,2023.8.18 05:00,276,0,52,328,0
연산터널→연산교차로,2023.8.18 05:00,137,137,23,297,0
교대→연산교차로,2023.8.18 06:00,180,0,212,392,0
부산시청→연산교차로,2023.8.18 06:00,352,250,124,726,0
사직운동장→연산교차로,2023.8.18 06:00,93,283,40,416,0
신리→연산교차로,2023.8.18 06:00,360,178,32,570,0
안락→연산교차로,2023.8.18 06:00,494,0,88,582,0
연산터널→연산교차로,2023.8.18 06:00,205,220,31,456,0
교대→연산교차로,2023.8.18 07:00,236,0,370,606,0
부산시청→연산교차로,2023.8.18 07:00,530,328,218,1076,0
사직운동장→연산교차로,2023.8.18 07:00,188,476,68,732,0
신리→연산교차로,2023.8.18 07:00,439,258,22,719,0
안락→연산교차로,2023.8.18 07:00,596,0,78,674,0
연산터널→연산교차로,2023.8.18 07:00,290,365,41,696,0
교대→연산교차로,2023.8.18 08:00,300,0,497,797,0
부산시청→연산교차로,2023.8.18 08:00,549,409,291,1249,0
사직운동장→연산교차로,2023.8.18 08:00,192,640,49,881,0
신리→연산교차로,2023.8.18 08:00,486,313,24,823,0
안락→연산교차로,2023.8.18 08:00,599,0,118,717,0
연산터널→연산교차로,2023.8.18 08:00,301,386,34,721,0
교대→연산교차로,2023.8.18 09:00,284,0,496,780,0
부산시청→연산교차로,2023.8.18 09:00,532,359,294,1185,0
사직운동장→연산교차로,2023.8.18 09:00,172,581,90,843,0
신리→연산교차로,2023.8.18 09:00,437,346,42,825,0
안락→연산교차로,2023.8.18 09:00,583,0,96,679,0
연산터널→연산교차로,2023.8.18 09:00,308,329,42,679,0
교대→연산교차로,2023.8.18 10:00,311,0,505,816,0
부산시청→연산교차로,2023.8.18 10:00,543,361,285,1189,0
사직운동장→연산교차로,2023.8.18 10:00,179,583,94,856,0
신리→연산교차로,2023.8.18 10:00,438,280,44,762,0
안락→연산교차로,2023.8.18 10:00,555,0,122,677,0
연산터널→연산교차로,2023.8.18 10:00,307,331,53,691,0
교대→연산교차로,2023.8.18 11:00,311,0,470,781,0
부산시청→연산교차로,2023.8.18 11:00,545,388,276,1209,0
사직운동장→연산교차로,2023.8.18 11:00,202,586,62,850,0
신리→연산교차로,2023.8.18 11:00,483,274,69,826,0
안락→연산교차로,2023.8.18 11:00,523,0,167,690,0
연산터널→연산교차로,2023.8.18 11:00,267,300,63,630,0
교대→연산교차로,2023.8.18 12:00,294,0,430,724,0
부산시청→연산교차로,2023.8.18 12:00,540,360,255,1155,0
사직운동장→연산교차로,2023.8.18 12:00,212,541,66,819,0
신리→연산교차로,2023.8.18 12:00,434,275,50,759,0
안락→연산교차로,2023.8.18 12:00,457,0,163,620,0
연산터널→연산교차로,2023.8.18 12:00,284,296,49,629,0
교대→연산교차로,2023.8.18 13:00,326,0,451,777,0
부산시청→연산교차로,2023.8.18 13:00,524,425,283,1232,0
사직운동장→연산교차로,2023.8.18 13:00,205,586,83,874,0
신리→연산교차로,2023.8.18 13:00,424,298,49,771,0
안락→연산교차로,2023.8.18 13:00,442,0,128,570,0
연산터널→연산교차로,2023.8.18 13:00,247,272,31,550,0
교대→연산교차로,2023.8.18 14:00,356,0,520,876,0
부산시청→연산교차로,2023.8.18 14:00,540,439,292,1271,0
사직운동장→연산교차로,2023.8.18 14:00,227,616,78,921,0
신리→연산교차로,2023.8.18 14:00,449,285,69,803,0
안락→연산교차로,2023.8.18 14:00,431,0,105,536,0
연산터널→연산교차로,2023.8.18 14:00,247,261,45,553,0
교대→연산교차로,2023.8.18 15:00,361,0,454,815,0
부산시청→연산교차로,2023.8.18 15:00,598,462,321,1381,0
사직운동장→연산교차로,2023.8.18 15:00,206,607,71,884,0
신리→연산교차로,2023.8.18 15:00,475,282,55,812,0
안락→연산교차로,2023.8.18 15:00,425,0,141,566,0
연산터널→연산교차로,2023.8.18 15:00,262,265,37,564,0
교대→연산교차로,2023.8.18 16:00,358,0,492,850,0
부산시청→연산교차로,2023.8.18 16:00,613,497,299,1409,0
사직운동장→연산교차로,2023.8.18 16:00,232,697,56,985,0
신리→연산교차로,2023.8.18 16:00,511,296,43,850,0
안락→연산교차로,2023.8.18 16:00,439,0,110,549,0
연산터널→연산교차로,2023.8.18 16:00,240,285,51,576,0
교대→연산교차로,2023.8.18 17:00,366,0,558,924,0
부산시청→연산교차로,2023.8.18 17:00,609,545,350,1504,0
사직운동장→연산교차로,2023.8.18 17:00,231,679,50,960,0
신리→연산교차로,2023.8.18 17:00,547,292,54,893,0
안락→연산교차로,2023.8.18 17:00,442,0,103,545,0
연산터널→연산교차로,2023.8.18 17:00,239,263,62,564,0
교대→연산교차로,2023.8.18 18:00,364,0,568,932,0
부산시청→연산교차로,2023.8.18 18:00,616,550,351,1517,0
사직운동장→연산교차로,2023.8.18 18:00,242,697,44,983,0
신리→연산교차로,2023.8.18 18:00,551,270,46,867,0
안락→연산교차로,2023.8.18 18:00,460,0,96,556,0
연산터널→연산교차로,2023.8.18 18:00,227,285,57,569,0
교대→연산교차로,2023.8.18 19:00,346,0,436,782,0
부산시청→연산교차로,2023.8.18 19:00,553,379,272,1204,0
사직운동장→연산교차로,2023.8.18 19:00,216,597,74,887,0
신리→연산교차로,2023.8.18 19:00,361,226,36,623,0
안락→연산교차로,2023.8.18 19:00,420,0,121,541,0
연산터널→연산교차로,2023.8.18 19:00,206,268,65,539,0
교대→연산교차로,2023.8.18 20:00,307,0,392,699,0
부산시청→연산교차로,2023.8.18 20:00,494,360,212,1066,0
사직운동장→연산교차로,2023.8.18 20:00,169,534,79,782,0
신리→연산교차로,2023.8.18 20:00,357,211,45,613,0
안락→연산교차로,2023.8.18 20:00,398,0,109,507,0
연산터널→연산교차로,2023.8.18 20:00,225,255,60,540,0
교대→연산교차로,2023.8.18 21:00,302,0,353,655,0
부산시청→연산교차로,2023.8.18 21:00,471,300,227,998,0
사직운동장→연산교차로,2023.8.18 21:00,175,467,92,734,0
신리→연산교차로,2023.8.18 21:00,318,227,39,584,0
안락→연산교차로,2023.8.18 21:00,391,0,119,510,0
연산터널→연산교차로,2023.8.18 21:00,241,263,61,565,0
교대→연산교차로,2023.8.18 22:00,288,0,323,611,0
부산시청→연산교차로,2023.8.18 22:00,483,284,176,943,0
사직운동장→연산교차로,2023.8.18 22:00,170,449,114,733,0
신리→연산교차로,2023.8.18 22:00,305,173,26,504,0
안락→연산교차로,2023.8.18 22:00,403,0,131,534,0
연산터널→연산교차로,2023.8.18 22:00,231,266,83,580,0
교대→연산교차로,2023.8.18 23:00,211,0,255,466,0
부산시청→연산교차로,2023.8.18 23:00,363,209,150,722,0
사직운동장→연산교차로,2023.8.18 23:00,137,377,63,577,0
신리→연산교차로,2023.8.18 23:00,274,128,18,420,0
안락→연산교차로,2023.8.18 23:00,306,0,83,389,0
연산터널→연산교차로,2023.8.18 23:00,179,204,59,442,0
교대→연산교차로,2023.8.19 00:00,185,0,258,443,0
부산시청→연산교차로,2023.8.19 00:00,328,195,129,652,0
사직운동장→연산교차로,2023.8.19 00:00,96,272,54,422,0
신리→연산교차로,2023.8.19 00:00,223,135,24,382,0
안락→연산교차로,2023.8.19 00:00,276,0,79,355,0
연산터널→연산교차로,2023.8.19 00:00,177,192,46,415,0
교대→연산교차로,2023.8.19 01:00,156,0,254,410,0
부산시청→연산교차로,2023.8.19 01:00,263,148,106,517,0
사직운동장→연산교차로,2023.8.19 01:00,75,220,49,344,0
신리→연산교차로,2023.8.19 01:00,158,110,20,288,0
안락→연산교차로,2023.8.19 01:00,211,0,43,254,0
연산터널→연산교차로,2023.8.19 01:00,148,191,60,399,0
교대→연산교차로,2023.8.19 02:00,123,0,158,281,0
부산시청→연산교차로,2023.8.19 02:00,227,116,79,422,0
사직운동장→연산교차로,2023.8.19 02:00,72,196,10,278,0
신리→연산교차로,2023.8.19 02:00,140,78,11,229,0
안락→연산교차로,2023.8.19 02:00,178,0,40,218,0
연산터널→연산교차로,2023.8.19 02:00,117,159,22,298,0
교대→연산교차로,2023.8.19 03:00,82,0,121,203,0
부산시청→연산교차로,2023.8.19 03:00,212,113,52,377,0
사직운동장→연산교차로,2023.8.19 03:00,40,184,5,229,0
신리→연산교차로,2023.8.19 03:00,88,74,10,172,0
안락→연산교차로,2023.8.19 03:00,162,0,40,202,0
연산터널→연산교차로,2023.8.19 03:00,97,128,11,236,0
교대→연산교차로,2023.8.19 04:00,77,0,117,194,0
부산시청→연산교차로,2023.8.19 04:00,174,87,50,311,0
사직운동장→연산교차로,2023.8.19 04:00,36,121,16,173,0
신리→연산교차로,2023.8.19 04:00,93,46,4,143,0
안락→연산교차로,2023.8.19 04:00,169,0,35,204,0
연산터널→연산교차로,2023.8.19 04:00,77,99,12,188,0
교대→연산교차로,2023.8.19 05:00,98,0,128,226,0
부산시청→연산교차로,2023.8.19 05:00,236,157,85,478,0
사직운동장→연산교차로,2023.8.19 05:00,50,167,22,239,0
신리→연산교차로,2023.8.19 05:00,153,79,9,241,0
안락→연산교차로,2023.8.19 05:00,273,0,32,305,0
연산터널→연산교차로,2023.8.19 05:00,140,143,23,306,0
교대→연산교차로,2023.8.19 06:00,145,0,161,306,0
부산시청→연산교차로,2023.8.19 06:00,333,197,95,625,0
사직운동장→연산교차로,2023.8.19 06:00,72,221,39,332,0
신리→연산교차로,2023.8.19 06:00,264,151,18,433,0
안락→연산교차로,2023.8.19 06:00,355,0,95,450,0
연산터널→연산교차로,2023.8.19 06:00,148,167,37,352,0
교대→연산교차로,2023.8.19 07:00,203,0,183,386,0
부산시청→연산교차로,2023.8.19 07:00,360,221,151,732,0
사직운동장→연산교차로,2023.8.19 07:00,106,351,41,498,0
신리→연산교차로,2023.8.19 07:00,266,151,37,454,0
안락→연산교차로,2023.8.19 07:00,401,0,88,489,0
연산터널→연산교차로,2023.8.19 07:00,187,217,39,443,0
교대→연산교차로,2023.8.19 08:00,252,0,328,580,0
부산시청→연산교차로,2023.8.19 08:00,469,321,206,996,0
사직운동장→연산교차로,2023.8.19 08:00,177,497,48,722,0
신리→연산교차로,2023.8.19 08:00,403,251,48,702,0
안락→연산교차로,2023.8.19 08:00,528,0,119,647,0
연산터널→연산교차로,2023.8.19 08:00,270,321,46,637,0
교대→연산교차로,2023.8.19 09:00,284,0,360,644,0
부산시청→연산교차로,2023.8.19 09:00,521,350,262,1133,0
사직운동장→연산교차로,2023.8.19 09:00,165,603,69,837,0
신리→연산교차로,2023.8.19 09:00,449,282,72,803,0
안락→연산교차로,2023.8.19 09:00,536,0,149,685,0
연산터널→연산교차로,2023.8.19 09:00,282,326,60,668,0
교대→연산교차로,2023.8.19 10:00,294,0,441,735,0
부산시청→연산교차로,2023.8.19 10:00,559,384,318,1261,0
사직운동장→연산교차로,2023.8.19 10:00,208,614,62,884,0
신리→연산교차로,2023.8.19 10:00,515,268,65,848,0
안락→연산교차로,2023.8.19 10:00,571,0,147,718,0
연산터널→연산교차로,2023.8.19 10:00,300,344,65,709,0
교대→연산교차로,2023.8.19 11:00,288,0,445,733,0
부산시청→연산교차로,2023.8.19 11:00,577,374,307,1258,0
사직운동장→연산교차로,2023.8.19 11:00,183,582,54,819,0
신리→연산교차로,2023.8.19 11:00,502,280,71,853,0
안락→연산교차로,2023.8.19 11:00,563,0,154,717,0
연산터널→연산교차로,2023.8.19 11:00,284,345,73,702,0
교대→연산교차로,2023.8.19 12:00,304,0,429,733,0
부산시청→연산교차로,2023.8.19 12:00,559,350,305,1214,0
사직운동장→연산교차로,2023.8.19 12:00,206,605,47,858,0
신리→연산교차로,2023.8.19 12:00,515,302,46,863,0
안락→연산교차로,2023.8.19 12:00,529,0,142,671,0
연산터널→연산교차로,2023.8.19 12:00,274,325,56,655,0
교대→연산교차로,2023.8.19 13:00,334,0,485,819,0
부산시청→연산교차로,2023.8.19 13:00,600,496,294,1390,0
사직운동장→연산교차로,2023.8.19 13:00,196,630,38,864,0
신리→연산교차로,2023.8.19 13:00,456,280,86,822,0
안락→연산교차로,2023.8.19 13:00,429,0,120,549,0
연산터널→연산교차로,2023.8.19 13:00,253,276,47,576,0
교대→연산교차로,2023.8.19 14:00,346,0,463,809,0
부산시청→연산교차로,2023.8.19 14:00,596,467,311,1374,0
사직운동장→연산교차로,2023.8.19 14:00,198,679,40,917,0
신리→연산교차로,2023.8.19 14:00,403,283,67,753,0
안락→연산교차로,2023.8.19 14:00,441,0,113,554,0
연산터널→연산교차로,2023.8.19 14:00,242,285,49,576,0
교대→연산교차로,2023.8.19 15:00,342,0,373,715,0
부산시청→연산교차로,2023.8.19 15:00,605,484,305,1394,0
사직운동장→연산교차로,2023.8.19 15:00,197,652,44,893,0
신리→연산교차로,2023.8.19 15:00,435,261,67,763,0
안락→연산교차로,2023.8.19 15:00,429,0,118,547,0
연산터널→연산교차로,2023.8.19 15:00,243,253,51,547,0
교대→연산교차로,2023.8.19 16:00,342,0,413,755,0
부산시청→연산교차로,2023.8.19 16:00,601,473,302,1376,0
사직운동장→연산교차로,2023.8.19 16:00,214,668,59,941,0
신리→연산교차로,2023.8.19 16:00,438,250,51,739,0
안락→연산교차로,2023.8.19 16:00,434,0,113,547,0
연산터널→연산교차로,2023.8.19 16:00,234,268,48,550,0
교대→연산교차로,2023.8.19 17:00,318,0,360,678,0
부산시청→연산교차로,2023.8.19 17:00,584,439,258,1281,0
사직운동장→연산교차로,2023.8.19 17:00,230,606,47,883,0
신리→연산교차로,2023.8.19 17:00,397,265,54,716,0
안락→연산교차로,2023.8.19 17:00,438,0,120,558,0
연산터널→연산교차로,2023.8.19 17:00,226,276,51,553,0
교대→연산교차로,2023.8.19 18:00,306,0,358,664,0
부산시청→연산교차로,2023.8.19 18:00,529,422,233,1184,0
사직운동장→연산교차로,2023.8.19 18:00,178,563,70,811,0
신리→연산교차로,2023.8.19 18:00,388,210,33,631,0
안락→연산교차로,2023.8.19 18:00,419,0,120,539,0
연산터널→연산교차로,2023.8.19 18:00,230,257,55,542,0
교대→연산교차로,2023.8.19 19:00,281,0,290,571,0
부산시청→연산교차로,2023.8.19 19:00,449,367,208,1024,0
사직운동장→연산교차로,2023.8.19 19:00,160,470,30,660,0
신리→연산교차로,2023.8.19 19:00,340,235,17,592,0
안락→연산교차로,2023.8.19 19:00,390,0,126,516,0
연산터널→연산교차로,2023.8.19 19:00,207,251,31,489,0
교대→연산교차로,2023.8.19 20:00,257,0,274,531,0
부산시청→연산교차로,2023.8.19 20:00,446,347,190,983,0
사직운동장→연산교차로,2023.8.19 20:00,164,468,7,639,0
신리→연산교차로,2023.8.19 20:00,248,154,6,408,0
안락→연산교차로,2023.8.19 20:00,381,0,97,478,0
연산터널→연산교차로,2023.8.19 20:00,211,234,23,468,0
교대→연산교차로,2023.8.19 21:00,266,0,317,583,0
부산시청→연산교차로,2023.8.19 21:00,441,331,184,956,0
사직운동장→연산교차로,2023.8.19 21:00,129,415,10,554,0
신리→연산교차로,2023.8.19 21:00,337,193,9,539,0
안락→연산교차로,2023.8.19 21:00,356,0,92,448,0
연산터널→연산교차로,2023.8.19 21:00,229,257,44,530,0
교대→연산교차로,2023.8.19 22:00,254,0,220,474,0
부산시청→연산교차로,2023.8.19 22:00,351,252,160,763,0
사직운동장→연산교차로,2023.8.19 22:00,136,343,22,501,0
신리→연산교차로,2023.8.19 22:00,234,147,21,402,0
안락→연산교차로,2023.8.19 22:00,335,0,91,426,0
연산터널→연산교차로,2023.8.19 22:00,214,225,33,472,0
교대→연산교차로,2023.8.19 23:00,199,0,215,414,0
부산시청→연산교차로,2023.8.19 23:00,341,185,91,617,0
사직운동장→연산교차로,2023.8.19 23:00,97,302,15,414,0
신리→연산교차로,2023.8.19 23:00,228,117,10,355,0
안락→연산교차로,2023.8.19 23:00,301,0,64,365,0
연산터널→연산교차로,2023.8.19 23:00,157,216,44,417,0
교대→연산교차로,2023.8.20 00:00,165,0,229,394,1
부산시청→연산교차로,2023.8.20 00:00,295,173,104,572,1
사직운동장→연산교차로,2023.8.20 00:00,64,250,12,326,1
신리→연산교차로,2023.8.20 00:00,181,99,15,295,1
안락→연산교차로,2023.8.20 00:00,234,0,62,296,1
연산터널→연산교차로,2023.8.20 00:00,127,186,32,345,1
교대→연산교차로,2023.8.20 01:00,125,0,194,319,1
부산시청→연산교차로,2023.8.20 01:00,212,133,91,436,1
사직운동장→연산교차로,2023.8.20 01:00,63,174,10,247,1
신리→연산교차로,2023.8.20 01:00,153,92,17,262,1
안락→연산교차로,2023.8.20 01:00,192,0,44,236,1
연산터널→연산교차로,2023.8.20 01:00,115,175,29,319,1
교대→연산교차로,2023.8.20 02:00,124,0,195,319,1
부산시청→연산교차로,2023.8.20 02:00,211,111,80,402,1
사직운동장→연산교차로,2023.8.20 02:00,42,171,4,217,1
신리→연산교차로,2023.8.20 02:00,120,65,6,191,1
안락→연산교차로,2023.8.20 02:00,157,0,36,193,1
연산터널→연산교차로,2023.8.20 02:00,103,129,15,247,1
교대→연산교차로,2023.8.20 03:00,85,0,153,238,1
부산시청→연산교차로,2023.8.20 03:00,181,85,67,333,1
사직운동장→연산교차로,2023.8.20 03:00,37,116,8,161,1
신리→연산교차로,2023.8.20 03:00,100,60,7,167,1
안락→연산교차로,2023.8.20 03:00,129,0,41,170,1
연산터널→연산교차로,2023.8.20 03:00,107,100,18,225,1
교대→연산교차로,2023.8.20 04:00,72,0,109,181,1
부산시청→연산교차로,2023.8.20 04:00,133,83,63,279,1
사직운동장→연산교차로,2023.8.20 04:00,31,126,9,166,1
신리→연산교차로,2023.8.20 04:00,91,48,8,147,1
안락→연산교차로,2023.8.20 04:00,132,0,31,163,1
연산터널→연산교차로,2023.8.20 04:00,93,109,18,220,1
교대→연산교차로,2023.8.20 05:00,62,0,102,164,1
부산시청→연산교차로,2023.8.20 05:00,135,90,43,268,1
사직운동장→연산교차로,2023.8.20 05:00,43,131,23,197,1
신리→연산교차로,2023.8.20 05:00,97,51,5,153,1
안락→연산교차로,2023.8.20 05:00,154,0,39,193,1
연산터널→연산교차로,2023.8.20 05:00,87,87,29,203,1
교대→연산교차로,2023.8.20 06:00,94,0,102,196,1
부산시청→연산교차로,2023.8.20 06:00,212,142,66,420,1
사직운동장→연산교차로,2023.8.20 06:00,46,173,33,252,1
신리→연산교차로,2023.8.20 06:00,149,72,9,230,1
안락→연산교차로,2023.8.20 06:00,251,0,43,294,1
연산터널→연산교차로,2023.8.20 06:00,122,110,21,253,1
교대→연산교차로,2023.8.20 07:00,138,0,133,271,1
부산시청→연산교차로,2023.8.20 07:00,249,164,77,490,1
사직운동장→연산교차로,2023.8.20 07:00,64,211,35,310,1
신리→연산교차로,2023.8.20 07:00,196,95,17,308,1
안락→연산교차로,2023.8.20 07:00,237,0,51,288,1
연산터널→연산교차로,2023.8.20 07:00,136,113,32,281,1
교대→연산교차로,2023.8.20 08:00,172,0,157,329,1
부산시청→연산교차로,2023.8.20 08:00,285,191,115,591,1
사직운동장→연산교차로,2023.8.20 08:00,120,336,45,501,1
신리→연산교차로,2023.8.20 08:00,249,119,20,388,1
안락→연산교차로,2023.8.20 08:00,312,0,72,384,1
연산터널→연산교차로,2023.8.20 08:00,172,145,24,341,1
교대→연산교차로,2023.8.20 09:00,213,0,228,441,1
부산시청→연산교차로,2023.8.20 09:00,370,276,160,806,1
사직운동장→연산교차로,2023.8.20 09:00,134,429,42,605,1
신리→연산교차로,2023.8.20 09:00,356,197,26,579,1
안락→연산교차로,2023.8.20 09:00,423,0,97,520,1
연산터널→연산교차로,2023.8.20 09:00,260,210,31,501,1
교대→연산교차로,2023.8.20 10:00,290,0,310,600,1
부산시청→연산교차로,2023.8.20 10:00,457,295,160,912,1
사직운동장→연산교차로,2023.8.20 10:00,168,500,46,714,1
신리→연산교차로,2023.8.20 10:00,396,205,21,622,1
안락→연산교차로,2023.8.20 10:00,430,0,88,518,1
연산터널→연산교차로,2023.8.20 10:00,227,249,34,510,1
교대→연산교차로,2023.8.20 11:00,254,0,367,621,1
부산시청→연산교차로,2023.8.20 11:00,502,337,199,1038,1
사직운동장→연산교차로,2023.8.20 11:00,175,526,54,755,1
신리→연산교차로,2023.8.20 11:00,383,185,48,616,1
안락→연산교차로,2023.8.20 11:00,502,0,134,636,1
연산터널→연산교차로,2023.8.20 11:00,281,266,56,603,1
교대→연산교차로,2023.8.20 12:00,300,0,310,610,1
부산시청→연산교차로,2023.8.20 12:00,518,354,197,1069,1
사직운동장→연산교차로,2023.8.20 12:00,203,541,47,791,1
신리→연산교차로,2023.8.20 12:00,388,227,39,654,1
안락→연산교차로,2023.8.20 12:00,499,0,167,666,1
연산터널→연산교차로,2023.8.20 12:00,266,259,55,580,1
교대→연산교차로,2023.8.20 13:00,305,0,305,610,1
부산시청→연산교차로,2023.8.20 13:00,588,372,217,1177,1
사직운동장→연산교차로,2023.8.20 13:00,187,553,45,785,1
신리→연산교차로,2023.8.20 13:00,377,209,31,617,1
안락→연산교차로,2023.8.20 13:00,476,0,106,582,1
연산터널→연산교차로,2023.8.20 13:00,233,265,48,546,1
교대→연산교차로,2023.8.20 14:00,328,0,304,632,1
부산시청→연산교차로,2023.8.20 14:00,578,364,233,1175,1
사직운동장→연산교차로,2023.8.20 14:00,212,564,36,812,1
신리→연산교차로,2023.8.20 14:00,346,172,47,565,1
안락→연산교차로,2023.8.20 14:00,534,0,155,689,1
연산터널→연산교차로,2023.8.20 14:00,277,273,52,602,1
교대→연산교차로,2023.8.20 15:00,301,0,296,597,1
부산시청→연산교차로,2023.8.20 15:00,580,366,214,1160,1
사직운동장→연산교차로,2023.8.20 15:00,172,551,58,781,1
신리→연산교차로,2023.8.20 15:00,350,205,39,594,1
안락→연산교차로,2023.8.20 15:00,522,0,152,674,1
연산터널→연산교차로,2023.8.20 15:00,266,287,49,602,1
교대→연산교차로,2023.8.20 16:00,300,0,292,592,1
부산시청→연산교차로,2023.8.20 16:00,499,347,223,1069,1
사직운동장→연산교차로,2023.8.20 16:00,210,534,47,791,1
신리→연산교차로,2023.8.20 16:00,391,211,34,636,1
안락→연산교차로,2023.8.20 16:00,545,0,139,684,1
연산터널→연산교차로,2023.8.20 16:00,261,277,46,584,1
교대→연산교차로,2023.8.20 17:00,300,0,321,621,1
부산시청→연산교차로,2023.8.20 17:00,478,316,215,1009,1
사직운동장→연산교차로,2023.8.20 17:00,169,530,60,759,1
신리→연산교차로,2023.8.20 17:00,363,226,35,624,1
안락→연산교차로,2023.8.20 17:00,542,0,141,683,1
연산터널→연산교차로,2023.8.20 17:00,239,258,62,559,1
교대→연산교차로,2023.8.20 18:00,293,0,295,588,1
부산시청→연산교차로,2023.8.20 18:00,480,284,204,968,1
사직운동장→연산교차로,2023.8.20 18:00,170,462,73,705,1
신리→연산교차로,2023.8.20 18:00,336,197,32,565,1
안락→연산교차로,2023.8.20 18:00,461,0,124,585,1
연산터널→연산교차로,2023.8.20 18:00,253,236,69,558,1
교대→연산교차로,2023.8.20 19:00,282,0,262,544,1
부산시청→연산교차로,2023.8.20 19:00,430,278,196,904,1
사직운동장→연산교차로,2023.8.20 19:00,179,457,61,697,1
신리→연산교차로,2023.8.20 19:00,338,181,29,548,1
안락→연산교차로,2023.8.20 19:00,382,0,125,507,1
연산터널→연산교차로,2023.8.20 19:00,214,251,49,514,1
교대→연산교차로,2023.8.20 20:00,273,0,227,500,1
부산시청→연산교차로,2023.8.20 20:00,377,259,164,800,1
사직운동장→연산교차로,2023.8.20 20:00,151,386,54,591,1
신리→연산교차로,2023.8.20 20:00,320,182,34,536,1
안락→연산교차로,2023.8.20 20:00,391,0,93,484,1
연산터널→연산교차로,2023.8.20 20:00,218,247,38,503,1
교대→연산교차로,2023.8.20 21:00,250,0,221,471,1
부산시청→연산교차로,2023.8.20 21:00,396,236,145,777,1
사직운동장→연산교차로,2023.8.20 21:00,130,367,57,554,1
신리→연산교차로,2023.8.20 21:00,280,169,22,471,1
안락→연산교차로,2023.8.20 21:00,394,0,95,489,1
연산터널→연산교차로,2023.8.20 21:00,208,221,45,474,1
교대→연산교차로,2023.8.20 22:00,198,0,234,432,1
부산시청→연산교차로,2023.8.20 22:00,321,188,140,649,1
사직운동장→연산교차로,2023.8.20 22:00,103,281,47,431,1
신리→연산교차로,2023.8.20 22:00,240,107,28,375,1
안락→연산교차로,2023.8.20 22:00,286,0,72,358,1
연산터널→연산교차로,2023.8.20 22:00,147,194,64,405,1
교대→연산교차로,2023.8.20 23:00,140,0,189,329,1
부산시청→연산교차로,2023.8.20 23:00,272,144,117,533,1
사직운동장→연산교차로,2023.8.20 23:00,79,265,62,406,1
신리→연산교차로,2023.8.20 23:00,189,114,19,322,1
안락→연산교차로,2023.8.20 23:00,203,0,66,269,1
연산터널→연산교차로,2023.8.20 23:00,147,180,61,388,1
교대→연산교차로,2023.8.21 00:00,108,0,178,286,0
부산시청→연산교차로,2023.8.21 00:00,193,134,86,413,0
사직운동장→연산교차로,2023.8.21 00:00,53,196,42,291,0
신리→연산교차로,2023.8.21 00:00,147,67,25,239,0
안락→연산교차로,2023.8.21 00:00,153,0,49,202,0
연산터널→연산교차로,2023.8.21 00:00,123,142,60,325,0
교대→연산교차로,2023.8.21 01:00,66,0,128,194,0
부산시청→연산교차로,2023.8.21 01:00,154,92,65,311,0
사직운동장→연산교차로,2023.8.21 01:00,55,134,24,213,0
신리→연산교차로,2023.8.21 01:00,85,59,7,151,0
안락→연산교차로,2023.8.21 01:00,117,0,29,146,0
연산터널→연산교차로,2023.8.21 01:00,89,113,42,244,0
교대→연산교차로,2023.8.21 02:00,57,0,101,158,0
부산시청→연산교차로,2023.8.21 02:00,129,57,51,237,0
사직운동장→연산교차로,2023.8.21 02:00,23,126,25,174,0
신리→연산교차로,2023.8.21 02:00,64,44,8,116,0
안락→연산교차로,2023.8.21 02:00,110,0,22,132,0
연산터널→연산교차로,2023.8.21 02:00,74,94,34,202,0
교대→연산교차로,2023.8.21 03:00,60,0,81,141,0
부산시청→연산교차로,2023.8.21 03:00,120,66,36,222,0
사직운동장→연산교차로,2023.8.21 03:00,29,89,13,131,0
신리→연산교차로,2023.8.21 03:00,67,33,18,118,0
안락→연산교차로,2023.8.21 03:00,101,0,31,132,0
연산터널→연산교차로,2023.8.21 03:00,63,84,31,178,0
교대→연산교차로,2023.8.21 04:00,56,0,76,132,0
부산시청→연산교차로,2023.8.21 04:00,137,70,33,240,0
사직운동장→연산교차로,2023.8.21 04:00,27,108,14,149,0
신리→연산교차로,2023.8.21 04:00,86,48,5,139,0
안락→연산교차로,2023.8.21 04:00,157,0,32,189,0
연산터널→연산교차로,2023.8.21 04:00,72,68,20,160,0
교대→연산교차로,2023.8.21 05:00,83,0,121,204,0
부산시청→연산교차로,2023.8.21 05:00,251,153,64,468,0
사직운동장→연산교차로,2023.8.21 05:00,52,164,19,235,0
신리→연산교차로,2023.8.21 05:00,222,99,7,328,0
안락→연산교차로,2023.8.21 05:00,312,0,48,360,0
연산터널→연산교차로,2023.8.21 05:00,127,148,18,293,0
교대→연산교차로,2023.8.21 06:00,190,0,268,458,0
부산시청→연산교차로,2023.8.21 06:00,419,287,147,853,0
사직운동장→연산교차로,2023.8.21 06:00,89,323,47,459,0
신리→연산교차로,2023.8.21 06:00,379,245,28,652,0
안락→연산교차로,2023.8.21 06:00,551,0,112,663,0
연산터널→연산교차로,2023.8.21 06:00,255,275,43,573,0
교대→연산교차로,2023.8.21 07:00,271,0,444,715,0
부산시청→연산교차로,2023.8.21 07:00,576,368,217,1161,0
사직운동장→연산교차로,2023.8.21 07:00,196,533,69,798,0
신리→연산교차로,2023.8.21 07:00,471,354,25,850,0
안락→연산교차로,2023.8.21 07:00,634,0,68,702,0
연산터널→연산교차로,2023.8.21 07:00,322,371,28,721,0
교대→연산교차로,2023.8.21 08:00,324,0,471,795,0
부산시청→연산교차로,2023.8.21 08:00,573,412,312,1297,0
사직운동장→연산교차로,2023.8.21 08:00,207,645,53,905,0
신리→연산교차로,2023.8.21 08:00,520,345,30,895,0
안락→연산교차로,2023.8.21 08:00,583,0,85,668,0
연산터널→연산교차로,2023.8.21 08:00,335,360,26,721,0
교대→연산교차로,2023.8.21 09:00,282,0,470,752,0
부산시청→연산교차로,2023.8.21 09:00,494,344,298,1136,0
사직운동장→연산교차로,2023.8.21 09:00,175,548,74,797,0
신리→연산교차로,2023.8.21 09:00,445,339,44,828,0
안락→연산교차로,2023.8.21 09:00,580,0,119,699,0
연산터널→연산교차로,2023.8.21 09:00,302,367,41,710,0
교대→연산교차로,2023.8.21 10:00,312,0,448,760,0
부산시청→연산교차로,2023.8.21 10:00,522,380,269,1171,0
사직운동장→연산교차로,2023.8.21 10:00,207,570,52,829,0
신리→연산교차로,2023.8.21 10:00,453,296,70,819,0
안락→연산교차로,2023.8.21 10:00,527,0,149,676,0
연산터널→연산교차로,2023.8.21 10:00,286,310,58,654,0
교대→연산교차로,2023.8.21 11:00,309,0,440,749,0
부산시청→연산교차로,2023.8.21 11:00,562,377,280,1219,0
사직운동장→연산교차로,2023.8.21 11:00,194,557,63,814,0
신리→연산교차로,2023.8.21 11:00,436,296,51,783,0
안락→연산교차로,2023.8.21 11:00,524,0,174,698,0
연산터널→연산교차로,2023.8.21 11:00,300,309,56,665,0
교대→연산교차로,2023.8.21 12:00,286,0,397,683,0
부산시청→연산교차로,2023.8.21 12:00,563,361,219,1143,0
사직운동장→연산교차로,2023.8.21 12:00,183,549,63,795,0
신리→연산교차로,2023.8.21 12:00,430,241,60,731,0
안락→연산교차로,2023.8.21 12:00,480,0,143,623,0
연산터널→연산교차로,2023.8.21 12:00,265,293,47,605,0
교대→연산교차로,2023.8.21 13:00,339,0,429,768,0
부산시청→연산교차로,2023.8.21 13:00,605,424,307,1336,0
사직운동장→연산교차로,2023.8.21 13:00,200,599,72,871,0
신리→연산교차로,2023.8.21 13:00,414,248,56,718,0
안락→연산교차로,2023.8.21 13:00,407,0,112,519,0
연산터널→연산교차로,2023.8.21 13:00,234,259,51,544,0
교대→연산교차로,2023.8.21 14:00,358,0,496,854,0
부산시청→연산교차로,2023.8.21 14:00,641,452,295,1388,0
사직운동장→연산교차로,2023.8.21 14:00,224,633,90,947,0
신리→연산교차로,2023.8.21 14:00,442,267,61,770,0
안락→연산교차로,2023.8.21 14:00,420,0,109,529,0
연산터널→연산교차로,2023.8.21 14:00,240,278,49,567,0
교대→연산교차로,2023.8.21 15:00,361,0,445,806,0
부산시청→연산교차로,2023.8.21 15:00,614,453,303,1370,0
사직운동장→연산교차로,2023.8.21 15:00,230,645,70,945,0
신리→연산교차로,2023.8.21 15:00,453,273,57,783,0
안락→연산교차로,2023.8.21 15:00,441,0,107,548,0
연산터널→연산교차로,2023.8.21 15:00,234,292,48,574,0
교대→연산교차로,2023.8.21 16:00,368,0,468,836,0
부산시청→연산교차로,2023.8.21 16:00,616,496,285,1397,0
사직운동장→연산교차로,2023.8.21 16:00,220,664,93,977,0
신리→연산교차로,2023.8.21 16:00,494,306,54,854,0
안락→연산교차로,2023.8.21 16:00,432,0,119,551,0
연산터널→연산교차로,2023.8.21 16:00,237,267,47,551,0
교대→연산교차로,2023.8.21 17:00,378,0,549,927,0
부산시청→연산교차로,2023.8.21 17:00,614,537,315,1466,0
사직운동장→연산교차로,2023.8.21 17:00,239,677,46,962,0
신리→연산교차로,2023.8.21 17:00,534,294,51,879,0
안락→연산교차로,2023.8.21 17:00,449,0,83,532,0
연산터널→연산교차로,2023.8.21 17:00,201,279,62,542,0
교대→연산교차로,2023.8.21 18:00,394,0,545,939,0
부산시청→연산교차로,2023.8.21 18:00,620,548,310,1478,0
사직운동장→연산교차로,2023.8.21 18:00,231,703,43,977,0
신리→연산교차로,2023.8.21 18:00,492,253,53,798,0
안락→연산교차로,2023.8.21 18:00,438,0,98,536,0
연산터널→연산교차로,2023.8.21 18:00,215,288,46,549,0
교대→연산교차로,2023.8.21 19:00,332,0,407,739,0
부산시청→연산교차로,2023.8.21 19:00,551,413,278,1242,0
사직운동장→연산교차로,2023.8.21 19:00,184,570,68,822,0
신리→연산교차로,2023.8.21 19:00,399,212,45,656,0
안락→연산교차로,2023.8.21 19:00,422,0,86,508,0
연산터널→연산교차로,2023.8.21 19:00,219,251,51,521,0
교대→연산교차로,2023.8.21 20:00,275,0,288,563,0
부산시청→연산교차로,2023.8.21 20:00,446,295,207,948,0
사직운동장→연산교차로,2023.8.21 20:00,160,481,78,719,0
신리→연산교차로,2023.8.21 20:00,336,189,32,557,0
안락→연산교차로,2023.8.21 20:00,397,0,97,494,0
연산터널→연산교차로,2023.8.21 20:00,194,260,56,510,0
교대→연산교차로,2023.8.21 21:00,274,0,300,574,0
부산시청→연산교차로,2023.8.21 21:00,456,308,211,975,0
사직운동장→연산교차로,2023.8.21 21:00,139,434,80,653,0
신리→연산교차로,2023.8.21 21:00,261,178,19,458,0
안락→연산교차로,2023.8.21 21:00,383,0,122,505,0
연산터널→연산교차로,2023.8.21 21:00,207,272,64,543,0
교대→연산교차로,2023.8.21 22:00,221,0,238,459,0
부산시청→연산교차로,2023.8.21 22:00,383,245,164,792,0
사직운동장→연산교차로,2023.8.21 22:00,133,366,72,571,0
신리→연산교차로,2023.8.21 22:00,221,154,25,400,0
안락→연산교차로,2023.8.21 22:00,347,0,95,442,0
연산터널→연산교차로,2023.8.21 22:00,174,223,72,469,0
교대→연산교차로,2023.8.21 23:00,164,0,228,392,0
부산시청→연산교차로,2023.8.21 23:00,296,175,119,590,0
사직운동장→연산교차로,2023.8.21 23:00,94,282,85,461,0
신리→연산교차로,2023.8.21 23:00,193,117,25,335,0
안락→연산교차로,2023.8.21 23:00,254,0,73,327,0
연산터널→연산교차로,2023.8.21 23:00,164,188,68,420,0
교대→연산교차로,2023.8.22 00:00,137,0,189,326,0
부산시청→연산교차로,2023.8.22 00:00,227,151,108,486,0
사직운동장→연산교차로,2023.8.22 00:00,66,239,62,367,0
신리→연산교차로,2023.8.22 00:00,134,97,13,244,0
안락→연산교차로,2023.8.22 00:00,192,0,50,242,0
연산터널→연산교차로,2023.8.22 00:00,130,168,47,345,0
교대→연산교차로,2023.8.22 01:00,88,0,174,262,0
부산시청→연산교차로,2023.8.22 01:00,177,96,73,346,0
사직운동장→연산교차로,2023.8.22 01:00,46,154,30,230,0
신리→연산교차로,2023.8.22 01:00,117,54,16,187,0
안락→연산교차로,2023.8.22 01:00,133,0,35,168,0
연산터널→연산교차로,2023.8.22 01:00,99,132,45,276,0
교대→연산교차로,2023.8.22 02:00,63,0,88,151,0
부산시청→연산교차로,2023.8.22 02:00,138,81,59,278,0
사직운동장→연산교차로,2023.8.22 02:00,39,129,37,205,0
신리→연산교차로,2023.8.22 02:00,69,52,11,132,0
안락→연산교차로,2023.8.22 02:00,110,0,26,136,0
연산터널→연산교차로,2023.8.22 02:00,85,107,32,224,0
교대→연산교차로,2023.8.22 03:00,59,0,100,159,0
부산시청→연산교차로,2023.8.22 03:00,118,65,52,235,0
사직운동장→연산교차로,2023.8.22 03:00,30,131,18,179,0
신리→연산교차로,2023.8.22 03:00,76,39,13,128,0
안락→연산교차로,2023.8.22 03:00,112,0,31,143,0
연산터널→연산교차로,2023.8.22 03:00,65,107,34,206,0
교대→연산교차로,2023.8.22 04:00,55,0,97,152,0
부산시청→연산교차로,2023.8.22 04:00,146,78,52,276,0
사직운동장→연산교차로,2023.8.22 04:00,34,122,17,173,0
신리→연산교차로,2023.8.22 04:00,108,54,14,176,0
안락→연산교차로,2023.8.22 04:00,163,0,35,198,0
연산터널→연산교차로,2023.8.22 04:00,77,101,32,210,0
교대→연산교차로,2023.8.22 05:00,105,0,128,233,0
부산시청→연산교차로,2023.8.22 05:00,243,171,83,497,0
사직운동장→연산교차로,2023.8.22 05:00,57,191,40,288,0
신리→연산교차로,2023.8.22 05:00,214,96,4,314,0
안락→연산교차로,2023.8.22 05:00,306,0,65,371,0
연산터널→연산교차로,2023.8.22 05:00,124,149,35,308,0
교대→연산교차로,2023.8.22 06:00,187,0,230,417,0
부산시청→연산교차로,2023.8.22 06:00,382,227,121,730,0
사직운동장→연산교차로,2023.8.22 06:00,88,291,55,434,0
신리→연산교차로,2023.8.22 06:00,365,186,28,579,0
안락→연산교차로,2023.8.22 06:00,471,0,105,576,0
연산터널→연산교차로,2023.8.22 06:00,239,242,36,517,0
교대→연산교차로,2023.8.22 07:00,261,0,389,650,0
부산시청→연산교차로,2023.8.22 07:00,530,368,193,1091,0
사직운동장→연산교차로,2023.8.22 07:00,176,485,68,729,0
신리→연산교차로,2023.8.22 07:00,480,305,33,818,0
안락→연산교차로,2023.8.22 07:00,613,0,76,689,0
연산터널→연산교차로,2023.8.22 07:00,292,382,46,720,0
교대→연산교차로,2023.8.22 08:00,315,0,517,832,0
부산시청→연산교차로,2023.8.22 08:00,584,417,344,1345,0
사직운동장→연산교차로,2023.8.22 08:00,188,621,62,871,0
신리→연산교차로,2023.8.22 08:00,505,353,29,887,0
안락→연산교차로,2023.8.22 08:00,588,0,93,681,0
연산터널→연산교차로,2023.8.22 08:00,313,387,41,741,0
교대→연산교차로,2023.8.22 09:00,299,0,483,782,0
부산시청→연산교차로,2023.8.22 09:00,495,370,322,1187,0
사직운동장→연산교차로,2023.8.22 09:00,196,602,72,870,0
신리→연산교차로,2023.8.22 09:00,452,326,54,832,0
안락→연산교차로,2023.8.22 09:00,557,0,90,647,0
연산터널→연산교차로,2023.8.22 09:00,305,372,31,708,0
교대→연산교차로,2023.8.22 10:00,297,0,471,768,0
부산시청→연산교차로,2023.8.22 10:00,560,382,275,1217,0
사직운동장→연산교차로,2023.8.22 10:00,198,595,52,845,0
신리→연산교차로,2023.8.22 10:00,478,287,54,819,0
안락→연산교차로,2023.8.22 10:00,519,0,125,644,0
연산터널→연산교차로,2023.8.22 10:00,289,336,56,681,0
교대→연산교차로,2023.8.22 11:00,289,0,442,731,0
부산시청→연산교차로,2023.8.22 11:00,556,377,266,1199,0
사직운동장→연산교차로,2023.8.22 11:00,202,571,68,841,0
신리→연산교차로,2023.8.22 11:00,453,277,55,785,0
안락→연산교차로,2023.8.22 11:00,508,0,166,674,0
연산터널→연산교차로,2023.8.22 11:00,298,309,49,656,0
교대→연산교차로,2023.8.22 12:00,280,0,407,687,0
부산시청→연산교차로,2023.8.22 12:00,517,339,243,1099,0
사직운동장→연산교차로,2023.8.22 12:00,183,563,90,836,0
신리→연산교차로,2023.8.22 12:00,461,246,54,761,0
안락→연산교차로,2023.8.22 12:00,467,0,173,640,0
연산터널→연산교차로,2023.8.22 12:00,233,284,59,576,0
교대→연산교차로,2023.8.22 13:00,345,0,434,779,0
부산시청→연산교차로,2023.8.22 13:00,571,422,271,1264,0
사직운동장→연산교차로,2023.8.22 13:00,215,600,77,892,0
신리→연산교차로,2023.8.22 13:00,394,284,62,740,0
안락→연산교차로,2023.8.22 13:00,426,0,110,536,0
연산터널→연산교차로,2023.8.22 13:00,244,257,40,541,0
교대→연산교차로,2023.8.22 14:00,337,0,491,828,0
부산시청→연산교차로,2023.8.22 14:00,616,441,277,1334,0
사직운동장→연산교차로,2023.8.22 14:00,218,623,82,923,0
신리→연산교차로,2023.8.22 14:00,474,281,70,825,0
안락→연산교차로,2023.8.22 14:00,426,0,117,543,0
연산터널→연산교차로,2023.8.22 14:00,235,273,49,557,0
교대→연산교차로,2023.8.22 15:00,349,0,536,885,0
부산시청→연산교차로,2023.8.22 15:00,606,479,300,1385,0
사직운동장→연산교차로,2023.8.22 15:00,215,644,82,941,0
신리→연산교차로,2023.8.22 15:00,422,297,58,777,0
안락→연산교차로,2023.8.22 15:00,420,0,92,512,0
연산터널→연산교차로,2023.8.22 15:00,250,259,52,561,0
교대→연산교차로,2023.8.22 16:00,357,0,476,833,0
부산시청→연산교차로,2023.8.22 16:00,578,519,340,1437,0
사직운동장→연산교차로,2023.8.22 16:00,246,658,71,975,0
신리→연산교차로,2023.8.22 16:00,483,288,61,832,0
안락→연산교차로,2023.8.22 16:00,437,0,96,533,0
연산터널→연산교차로,2023.8.22 16:00,253,268,39,560,0
교대→연산교차로,2023.8.22 17:00,374,0,523,897,0
부산시청→연산교차로,2023.8.22 17:00,616,536,345,1497,0
사직운동장→연산교차로,2023.8.22 17:00,225,713,41,979,0
신리→연산교차로,2023.8.22 17:00,513,305,46,864,0
안락→연산교차로,2023.8.22 17:00,463,0,87,550,0
연산터널→연산교차로,2023.8.22 17:00,233,271,53,557,0
교대→연산교차로,2023.8.22 18:00,370,0,537,907,0
부산시청→연산교차로,2023.8.22 18:00,588,551,353,1492,0
사직운동장→연산교차로,2023.8.22 18:00,235,689,56,980,0
신리→연산교차로,2023.8.22 18:00,497,267,58,822,0
안락→연산교차로,2023.8.22 18:00,450,0,85,535,0
연산터널→연산교차로,2023.8.22 18:00,226,281,47,554,0
교대→연산교차로,2023.8.22 19:00,334,0,379,713,0
부산시청→연산교차로,2023.8.22 19:00,493,417,283,1193,0
사직운동장→연산교차로,2023.8.22 19:00,208,598,75,881,0
신리→연산교차로,2023.8.22 19:00,370,189,44,603,0
안락→연산교차로,2023.8.22 19:00,413,0,105,518,0
연산터널→연산교차로,2023.8.22 19:00,196,297,56,549,0
교대→연산교차로,2023.8.22 20:00,321,0,326,647,0
부산시청→연산교차로,2023.8.22 20:00,484,349,261,1094,0
사직운동장→연산교차로,2023.8.22 20:00,178,496,78,752,0
신리→연산교차로,2023.8.22 20:00,338,203,44,585,0
안락→연산교차로,2023.8.22 20:00,397,0,105,502,0
연산터널→연산교차로,2023.8.22 20:00,198,250,63,511,0
교대→연산교차로,2023.8.22 21:00,258,0,300,558,0
부산시청→연산교차로,2023.8.22 21:00,458,307,236,1001,0
사직운동장→연산교차로,2023.8.22 21:00,143,456,89,688,0
신리→연산교차로,2023.8.22 21:00,304,192,32,528,0
안락→연산교차로,2023.8.22 21:00,424,0,96,520,0
연산터널→연산교차로,2023.8.22 21:00,234,285,73,592,0
교대→연산교차로,2023.8.22 22:00,223,0,247,470,0
부산시청→연산교차로,2023.8.22 22:00,409,281,169,859,0
사직운동장→연산교차로,2023.8.22 22:00,138,389,95,622,0
신리→연산교차로,2023.8.22 22:00,217,168,34,419,0
안락→연산교차로,2023.8.22 22:00,340,0,96,436,0
연산터널→연산교차로,2023.8.22 22:00,200,251,79,530,0
교대→연산교차로,2023.8.22 23:00,192,0,214,406,0
부산시청→연산교차로,2023.8.22 23:00,300,211,134,645,0
사직운동장→연산교차로,2023.8.22 23:00,111,300,81,492,0
신리→연산교차로,2023.8.22 23:00,227,123,27,377,0
안락→연산교차로,2023.8.22 23:00,245,0,72,317,0
연산터널→연산교차로,2023.8.22 23:00,141,200,69,410,0
교대→연산교차로,2023.8.23 00:00,127,0,193,320,0
부산시청→연산교차로,2023.8.23 00:00,256,153,114,523,0
사직운동장→연산교차로,2023.8.23 00:00,72,264,70,406,0
신리→연산교차로,2023.8.23 00:00,153,89,36,278,0
안락→연산교차로,2023.8.23 00:00,180,0,59,239,0
연산터널→연산교차로,2023.8.23 00:00,146,207,66,419,0
교대→연산교차로,2023.8.23 01:00,95,0,179,274,0
부산시청→연산교차로,2023.8.23 01:00,209,116,83,408,0
사직운동장→연산교차로,2023.8.23 01:00,64,199,48,311,0
신리→연산교차로,2023.8.23 01:00,115,73,18,206,0
안락→연산교차로,2023.8.23 01:00,131,0,48,179,0
연산터널→연산교차로,2023.8.23 01:00,114,155,78,347,0
교대→연산교차로,2023.8.23 02:00,76,0,125,201,0
부산시청→연산교차로,2023.8.23 02:00,146,79,57,282,0
사직운동장→연산교차로,2023.8.23 02:00,30,191,22,243,0
신리→연산교차로,2023.8.23 02:00,80,51,16,147,0
안락→연산교차로,2023.8.23 02:00,120,0,33,153,0
연산터널→연산교차로,2023.8.23 02:00,89,109,38,236,0
교대→연산교차로,2023.8.23 03:00,56,0,92,148,0
부산시청→연산교차로,2023.8.23 03:00,141,66,42,249,0
사직운동장→연산교차로,2023.8.23 03:00,36,174,23,233,0
신리→연산교차로,2023.8.23 03:00,91,39,11,141,0
안락→연산교차로,2023.8.23 03:00,97,0,27,124,0
연산터널→연산교차로,2023.8.23 03:00,68,102,40,210,0
교대→연산교차로,2023.8.23 04:00,60,0,87,147,0
부산시청→연산교차로,2023.8.23 04:00,154,70,47,271,0
사직운동장→연산교차로,2023.8.23 04:00,25,106,22,153,0
신리→연산교차로,2023.8.23 04:00,100,46,8,154,0
안락→연산교차로,2023.8.23 04:00,141,0,37,178,0
연산터널→연산교차로,2023.8.23 04:00,87,101,36,224,0
교대→연산교차로,2023.8.23 05:00,100,0,122,222,0
부산시청→연산교차로,2023.8.23 05:00,236,164,59,459,0
사직운동장→연산교차로,2023.8.23 05:00,51,182,36,269,0
신리→연산교차로,2023.8.23 05:00,200,93,12,305,0
안락→연산교차로,2023.8.23 05:00,317,0,70,387,0
연산터널→연산교차로,2023.8.23 05:00,125,130,30,285,0
교대→연산교차로,2023.8.23 06:00,177,0,252,429,0
부산시청→연산교차로,2023.8.23 06:00,364,261,127,752,0
사직운동장→연산교차로,2023.8.23 06:00,105,294,55,454,0
신리→연산교차로,2023.8.23 06:00,352,211,25,588,0
안락→연산교차로,2023.8.23 06:00,478,0,111,589,0
연산터널→연산교차로,2023.8.23 06:00,249,226,37,512,0
교대→연산교차로,2023.8.23 07:00,246,0,385,631,0
부산시청→연산교차로,2023.8.23 07:00,512,372,194,1078,0
사직운동장→연산교차로,2023.8.23 07:00,192,508,56,756,0
신리→연산교차로,2023.8.23 07:00,466,306,19,791,0
안락→연산교차로,2023.8.23 07:00,606,0,80,686,0
연산터널→연산교차로,2023.8.23 07:00,317,378,35,730,0
교대→연산교차로,2023.8.23 08:00,307,0,513,820,0
부산시청→연산교차로,2023.8.23 08:00,533,425,322,1280,0
사직운동장→연산교차로,2023.8.23 08:00,207,635,78,920,0
신리→연산교차로,2023.8.23 08:00,500,342,38,880,0
안락→연산교차로,2023.8.23 08:00,584,0,79,663,0
연산터널→연산교차로,2023.8.23 08:00,340,375,32,747,0
교대→연산교차로,2023.8.23 09:00,285,0,519,804,0
부산시청→연산교차로,2023.8.23 09:00,489,377,303,1169,0
사직운동장→연산교차로,2023.8.23 09:00,189,596,88,873,0
신리→연산교차로,2023.8.23 09:00,482,327,45,854,0
안락→연산교차로,2023.8.23 09:00,538,0,92,630,0
연산터널→연산교차로,2023.8.23 09:00,316,365,32,713,0
교대→연산교차로,2023.8.23 10:00,306,0,432,738,0
부산시청→연산교차로,2023.8.23 10:00,548,373,304,1225,0
사직운동장→연산교차로,2023.8.23 10:00,203,575,55,833,0
신리→연산교차로,2023.8.23 10:00,460,282,73,815,0
안락→연산교차로,2023.8.23 10:00,532,0,140,672,0
연산터널→연산교차로,2023.8.23 10:00,311,313,42,666,0
교대→연산교차로,2023.8.23 11:00,308,0,445,753,0
부산시청→연산교차로,2023.8.23 11:00,571,371,268,1210,0
사직운동장→연산교차로,2023.8.23 11:00,209,589,52,850,0
신리→연산교차로,2023.8.23 11:00,427,270,63,760,0
안락→연산교차로,2023.8.23 11:00,516,0,138,654,0
연산터널→연산교차로,2023.8.23 11:00,283,319,48,650,0
교대→연산교차로,2023.8.23 12:00,306,0,394,700,0
부산시청→연산교차로,2023.8.23 12:00,561,380,262,1203,0
사직운동장→연산교차로,2023.8.23 12:00,214,561,66,841,0
신리→연산교차로,2023.8.23 12:00,400,280,49,729,0
안락→연산교차로,2023.8.23 12:00,458,0,149,607,0
연산터널→연산교차로,2023.8.23 12:00,276,274,53,603,0
교대→연산교차로,2023.8.23 13:00,329,0,417,746,0
부산시청→연산교차로,2023.8.23 13:00,579,408,265,1252,0
사직운동장→연산교차로,2023.8.23 13:00,214,578,66,858,0
신리→연산교차로,2023.8.23 13:00,431,284,53,768,0
안락→연산교차로,2023.8.23 13:00,414,0,123,537,0
연산터널→연산교차로,2023.8.23 13:00,223,287,45,555,0
교대→연산교차로,2023.8.23 14:00,271,0,411,682,0
부산시청→연산교차로,2023.8.23 14:00,510,386,196,1092,0
사직운동장→연산교차로,2023.8.23 14:00,174,514,52,740,0
신리→연산교차로,2023.8.23 14:00,346,208,57,611,0
안락→연산교차로,2023.8.23 14:00,318,0,98,416,0
연산터널→연산교차로,2023.8.23 14:00,204,217,25,446,0
교대→연산교차로,2023.8.23 15:00,383,0,501,884,0
부산시청→연산교차로,2023.8.23 15:00,594,483,281,1358,0
사직운동장→연산교차로,2023.8.23 15:00,218,683,64,965,0
신리→연산교차로,2023.8.23 15:00,485,286,39,810,0
안락→연산교차로,2023.8.23 15:00,435,0,92,527,0
연산터널→연산교차로,2023.8.23 15:00,242,269,40,551,0
교대→연산교차로,2023.8.23 16:00,361,0,534,895,0
부산시청→연산교차로,2023.8.23 16:00,636,505,294,1435,0
사직운동장→연산교차로,2023.8.23 16:00,231,676,85,992,0
신리→연산교차로,2023.8.23 16:00,515,261,53,829,0
안락→연산교차로,2023.8.23 16:00,432,0,97,529,0
연산터널→연산교차로,2023.8.23 16:00,213,287,43,543,0
교대→연산교차로,2023.8.23 17:00,396,0,527,923,0
부산시청→연산교차로,2023.8.23 17:00,616,526,319,1461,0
사직운동장→연산교차로,2023.8.23 17:00,228,715,46,989,0
신리→연산교차로,2023.8.23 17:00,524,285,43,852,0
안락→연산교차로,2023.8.23 17:00,427,0,91,518,0
연산터널→연산교차로,2023.8.23 17:00,244,287,35,566,0
교대→연산교차로,2023.8.23 18:00,370,0,551,921,0
부산시청→연산교차로,2023.8.23 18:00,596,556,343,1495,0
사직운동장→연산교차로,2023.8.23 18:00,239,691,51,981,0
신리→연산교차로,2023.8.23 18:00,519,279,49,847,0
안락→연산교차로,2023.8.23 18:00,447,0,67,514,0
연산터널→연산교차로,2023.8.23 18:00,214,279,65,558,0
교대→연산교차로,2023.8.23 19:00,337,0,424,761,0
부산시청→연산교차로,2023.8.23 19:00,481,412,283,1176,0
사직운동장→연산교차로,2023.8.23 19:00,189,619,71,879,0
신리→연산교차로,2023.8.23 19:00,393,190,42,625,0
안락→연산교차로,2023.8.23 19:00,435,0,81,516,0
연산터널→연산교차로,2023.8.23 19:00,229,266,31,526,0
교대→연산교차로,2023.8.23 20:00,336,0,338,674,0
부산시청→연산교차로,2023.8.23 20:00,466,342,245,1053,0
사직운동장→연산교차로,2023.8.23 20:00,200,527,83,810,0
신리→연산교차로,2023.8.23 20:00,332,197,27,556,0
안락→연산교차로,2023.8.23 20:00,402,0,83,485,0
연산터널→연산교차로,2023.8.23 20:00,227,254,58,539,0
교대→연산교차로,2023.8.23 21:00,281,0,340,621,0
부산시청→연산교차로,2023.8.23 21:00,441,352,226,1019,0
사직운동장→연산교차로,2023.8.23 21:00,183,446,87,716,0
신리→연산교차로,2023.8.23 21:00,314,201,34,549,0
안락→연산교차로,2023.8.23 21:00,385,0,113,498,0
연산터널→연산교차로,2023.8.23 21:00,229,266,67,562,0
교대→연산교차로,2023.8.23 22:00,243,0,252,495,0
부산시청→연산교차로,2023.8.23 22:00,398,246,170,814,0
사직운동장→연산교차로,2023.8.23 22:00,139,402,62,603,0
신리→연산교차로,2023.8.23 22:00,276,154,28,458,0
안락→연산교차로,2023.8.23 22:00,297,0,92,389,0
연산터널→연산교차로,2023.8.23 22:00,212,241,64,517,0
교대→연산교차로,2023.8.23 23:00,186,0,207,393,0
부산시청→연산교차로,2023.8.23 23:00,312,203,134,649,0
사직운동장→연산교차로,2023.8.23 23:00,97,289,37,423,0
신리→연산교차로,2023.8.23 23:00,217,134,19,370,0
안락→연산교차로,2023.8.23 23:00,295,0,64,359,0
연산터널→연산교차로,2023.8.23 23:00,150,191,33,374,0
교대→연산교차로,2023.8.24 00:00,155,0,209,364,0
부산시청→연산교차로,2023.8.24 00:00,260,146,99,505,0
사직운동장→연산교차로,2023.8.24 00:00,75,253,59,387,0
신리→연산교차로,2023.8.24 00:00,174,106,21,301,0
안락→연산교차로,2023.8.24 00:00,234,0,67,301,0
연산터널→연산교차로,2023.8.24 00:00,131,181,47,359,0
교대→연산교차로,2023.8.24 01:00,90,0,178,268,0
부산시청→연산교차로,2023.8.24 01:00,207,124,72,403,0
사직운동장→연산교차로,2023.8.24 01:00,40,169,35,244,0
신리→연산교차로,2023.8.24 01:00,107,66,13,186,0
안락→연산교차로,2023.8.24 01:00,180,0,40,220,0
연산터널→연산교차로,2023.8.24 01:00,113,136,44,293,0
교대→연산교차로,2023.8.24 02:00,74,0,114,188,0
부산시청→연산교차로,2023.8.24 02:00,143,66,49,258,0
사직운동장→연산교차로,2023.8.24 02:00,43,134,37,214,0
신리→연산교차로,2023.8.24 02:00,86,67,13,166,0
안락→연산교차로,2023.8.24 02:00,138,0,26,164,0
연산터널→연산교차로,2023.8.24 02:00,76,105,31,212,0
교대→연산교차로,2023.8.24 03:00,50,0,77,127,0
부산시청→연산교차로,2023.8.24 03:00,135,87,49,271,0
사직운동장→연산교차로,2023.8.24 03:00,36,122,0,158,0
신리→연산교차로,2023.8.24 03:00,67,48,11,126,0
안락→연산교차로,2023.8.24 03:00,96,0,22,118,0
연산터널→연산교차로,2023.8.24 03:00,74,82,12,168,0
교대→연산교차로,2023.8.24 04:00,50,0,77,127,0
부산시청→연산교차로,2023.8.24 04:00,132,91,44,267,0
사직운동장→연산교차로,2023.8.24 04:00,32,90,2,124,0
신리→연산교차로,2023.8.24 04:00,96,47,3,146,0
안락→연산교차로,2023.8.24 04:00,161,0,22,183,0
연산터널→연산교차로,2023.8.24 04:00,65,88,6,159,0
교대→연산교차로,2023.8.24 05:00,71,0,95,166,0
부산시청→연산교차로,2023.8.24 05:00,170,128,57,355,0
사직운동장→연산교차로,2023.8.24 05:00,52,163,7,222,0
신리→연산교차로,2023.8.24 05:00,164,71,3,238,0
안락→연산교차로,2023.8.24 05:00,235,0,46,281,0
연산터널→연산교차로,2023.8.24 05:00,130,125,6,261,0
교대→연산교차로,2023.8.24 06:00,153,0,214,367,0
부산시청→연산교차로,2023.8.24 06:00,365,257,108,730,0
사직운동장→연산교차로,2023.8.24 06:00,93,246,29,368,0
신리→연산교차로,2023.8.24 06:00,292,186,16,494,0
안락→연산교차로,2023.8.24 06:00,418,0,87,505,0
연산터널→연산교차로,2023.8.24 06:00,214,188,27,429,0
교대→연산교차로,2023.8.24 07:00,248,0,352,600,0
부산시청→연산교차로,2023.8.24 07:00,480,372,188,1040,0
사직운동장→연산교차로,2023.8.24 07:00,178,484,64,726,0
신리→연산교차로,2023.8.24 07:00,442,283,23,748,0
안락→연산교차로,2023.8.24 07:00,568,0,75,643,0
연산터널→연산교차로,2023.8.24 07:00,288,367,39,694,0
교대→연산교차로,2023.8.24 08:00,306,0,520,826,0
부산시청→연산교차로,2023.8.24 08:00,544,416,316,1276,0
사직운동장→연산교차로,2023.8.24 08:00,184,644,46,874,0
신리→연산교차로,2023.8.24 08:00,516,333,22,871,0
안락→연산교차로,2023.8.24 08:00,562,0,95,657,0
연산터널→연산교차로,2023.8.24 08:00,325,373,24,722,0
교대→연산교차로,2023.8.24 09:00,288,0,475,763,0
부산시청→연산교차로,2023.8.24 09:00,505,398,277,1180,0
사직운동장→연산교차로,2023.8.24 09:00,175,590,83,848,0
신리→연산교차로,2023.8.24 09:00,409,320,38,767,0
안락→연산교차로,2023.8.24 09:00,545,0,100,645,0
연산터널→연산교차로,2023.8.24 09:00,293,349,36,678,0
교대→연산교차로,2023.8.24 10:00,292,0,451,743,0
부산시청→연산교차로,2023.8.24 10:00,531,376,257,1164,0
사직운동장→연산교차로,2023.8.24 10:00,198,616,60,874,0
신리→연산교차로,2023.8.24 10:00,458,295,55,808,0
안락→연산교차로,2023.8.24 10:00,507,0,105,612,0
연산터널→연산교차로,2023.8.24 10:00,298,324,33,655,0
교대→연산교차로,2023.8.24 11:00,296,0,459,755,0
부산시청→연산교차로,2023.8.24 11:00,545,376,275,1196,0
사직운동장→연산교차로,2023.8.24 11:00,211,560,92,863,0
신리→연산교차로,2023.8.24 11:00,446,266,55,767,0
안락→연산교차로,2023.8.24 11:00,467,0,141,608,0
연산터널→연산교차로,2023.8.24 11:00,253,298,46,597,0
교대→연산교차로,2023.8.24 12:00,290,0,375,665,0
부산시청→연산교차로,2023.8.24 12:00,532,370,254,1156,0
사직운동장→연산교차로,2023.8.24 12:00,161,558,77,796,0
신리→연산교차로,2023.8.24 12:00,376,244,43,663,0
안락→연산교차로,2023.8.24 12:00,441,0,122,563,0
연산터널→연산교차로,2023.8.24 12:00,265,281,42,588,0
교대→연산교차로,2023.8.24 13:00,350,0,418,768,0
부산시청→연산교차로,2023.8.24 13:00,531,428,236,1195,0
사직운동장→연산교차로,2023.8.24 13:00,225,585,80,890,0
신리→연산교차로,2023.8.24 13:00,386,281,64,731,0
안락→연산교차로,2023.8.24 13:00,442,0,115,557,0
연산터널→연산교차로,2023.8.24 13:00,241,265,35,541,0
교대→연산교차로,2023.8.24 14:00,328,0,455,783,0
부산시청→연산교차로,2023.8.24 14:00,565,428,261,1254,0
사직운동장→연산교차로,2023.8.24 14:00,205,579,84,868,0
신리→연산교차로,2023.8.24 14:00,432,284,55,771,0
안락→연산교차로,2023.8.24 14:00,413,0,105,518,0
연산터널→연산교차로,2023.8.24 14:00,229,267,46,542,0
교대→연산교차로,2023.8.24 15:00,343,0,444,787,0
부산시청→연산교차로,2023.8.24 15:00,551,470,307,1328,0
사직운동장→연산교차로,2023.8.24 15:00,226,599,55,880,0
신리→연산교차로,2023.8.24 15:00,416,279,51,746,0
안락→연산교차로,2023.8.24 15:00,408,0,113,521,0
연산터널→연산교차로,2023.8.24 15:00,250,244,39,533,0
교대→연산교차로,2023.8.24 16:00,369,0,516,885,0
부산시청→연산교차로,2023.8.24 16:00,576,527,298,1401,0
사직운동장→연산교차로,2023.8.24 16:00,209,713,45,967,0
신리→연산교차로,2023.8.24 16:00,463,269,59,791,0
안락→연산교차로,2023.8.24 16:00,429,0,88,517,0
연산터널→연산교차로,2023.8.24 16:00,247,283,39,569,0
교대→연산교차로,2023.8.24 17:00,360,0,529,889,0
부산시청→연산교차로,2023.8.24 17:00,579,524,322,1425,0
사직운동장→연산교차로,2023.8.24 17:00,248,672,30,950,0
신리→연산교차로,2023.8.24 17:00,473,287,48,808,0
안락→연산교차로,2023.8.24 17:00,417,0,91,508,0
연산터널→연산교차로,2023.8.24 17:00,229,271,40,540,0
교대→연산교차로,2023.8.24 18:00,364,0,529,893,0
부산시청→연산교차로,2023.8.24 18:00,585,555,315,1455,0
사직운동장→연산교차로,2023.8.24 18:00,232,676,38,946,0
신리→연산교차로,2023.8.24 18:00,489,244,37,770,0
안락→연산교차로,2023.8.24 18:00,436,0,110,546,0
연산터널→연산교차로,2023.8.24 18:00,241,276,40,557,0
교대→연산교차로,2023.8.24 19:00,318,0,375,693,0
부산시청→연산교차로,2023.8.24 19:00,551,449,278,1278,0
사직운동장→연산교차로,2023.8.24 19:00,197,560,74,831,0
신리→연산교차로,2023.8.24 19:00,362,237,30,629,0
안락→연산교차로,2023.8.24 19:00,395,0,102,497,0
연산터널→연산교차로,2023.8.24 19:00,211,251,36,498,0
교대→연산교차로,2023.8.24 20:00,304,0,309,613,0
부산시청→연산교차로,2023.8.24 20:00,447,353,224,1024,0
사직운동장→연산교차로,2023.8.24 20:00,178,519,64,761,0
신리→연산교차로,2023.8.24 20:00,286,220,27,533,0
안락→연산교차로,2023.8.24 20:00,384,0,89,473,0
연산터널→연산교차로,2023.8.24 20:00,198,232,39,469,0
교대→연산교차로,2023.8.24 21:00,272,0,282,554,0
부산시청→연산교차로,2023.8.24 21:00,433,293,200,926,0
사직운동장→연산교차로,2023.8.24 21:00,176,440,48,664,0
신리→연산교차로,2023.8.24 21:00,299,171,22,492,0
안락→연산교차로,2023.8.24 21:00,350,0,87,437,0
연산터널→연산교차로,2023.8.24 21:00,230,255,49,534,0
교대→연산교차로,2023.8.24 22:00,220,0,244,464,0
부산시청→연산교차로,2023.8.24 22:00,376,259,142,777,0
사직운동장→연산교차로,2023.8.24 22:00,128,329,71,528,0
신리→연산교차로,2023.8.24 22:00,255,134,26,415,0
안락→연산교차로,2023.8.24 22:00,294,0,84,378,0
연산터널→연산교차로,2023.8.24 22:00,188,217,46,451,0
교대→연산교차로,2023.8.24 23:00,157,0,177,334,0
부산시청→연산교차로,2023.8.24 23:00,306,205,112,623,0
사직운동장→연산교차로,2023.8.24 23:00,104,301,13,418,0
신리→연산교차로,2023.8.24 23:00,194,113,13,320,0
안락→연산교차로,2023.8.24 23:00,238,0,63,301,0
연산터널→연산교차로,2023.8.24 23:00,147,187,30,364,0
교대→연산교차로,2023.8.25 00:00,126,0,174,300,0
부산시청→연산교차로,2023.8.25 00:00,240,155,88,483,0
사직운동장→연산교차로,2023.8.25 00:00,61,215,21,297,0
신리→연산교차로,2023.8.25 00:00,142,92,10,244,0
안락→연산교차로,2023.8.25 00:00,186,0,52,238,0
연산터널→연산교차로,2023.8.25 00:00,135,154,38,327,0
교대→연산교차로,2023.8.25 01:00,84,0,157,241,0
부산시청→연산교차로,2023.8.25 01:00,205,120,67,392,0
사직운동장→연산교차로,2023.8.25 01:00,55,179,33,267,0
신리→연산교차로,2023.8.25 01:00,93,55,9,157,0
안락→연산교차로,2023.8.25 01:00,157,0,42,199,0
연산터널→연산교차로,2023.8.25 01:00,108,131,39,278,0
교대→연산교차로,2023.8.25 02:00,84,0,122,206,0
부산시청→연산교차로,2023.8.25 02:00,121,80,52,253,0
사직운동장→연산교차로,2023.8.25 02:00,37,153,33,223,0
신리→연산교차로,2023.8.25 02:00,72,44,9,125,0
안락→연산교차로,2023.8.25 02:00,140,0,32,172,0
연산터널→연산교차로,2023.8.25 02:00,62,89,28,179,0
교대→연산교차로,2023.8.25 03:00,57,0,117,174,0
부산시청→연산교차로,2023.8.25 03:00,154,78,48,280,0
사직운동장→연산교차로,2023.8.25 03:00,34,116,23,173,0
신리→연산교차로,2023.8.25 03:00,61,41,16,118,0
안락→연산교차로,2023.8.25 03:00,119,0,23,142,0
연산터널→연산교차로,2023.8.25 03:00,80,98,32,210,0
교대→연산교차로,2023.8.25 04:00,60,0,69,129,0
부산시청→연산교차로,2023.8.25 04:00,144,86,43,273,0
사직운동장→연산교차로,2023.8.25 04:00,31,142,19,192,0
신리→연산교차로,2023.8.25 04:00,89,54,8,151,0
안락→연산교차로,2023.8.25 04:00,145,0,34,179,0
연산터널→연산교차로,2023.8.25 04:00,78,89,31,198,0
교대→연산교차로,2023.8.25 05:00,103,0,110,213,0
부산시청→연산교차로,2023.8.25 05:00,210,139,75,424,0
사직운동장→연산교차로,2023.8.25 05:00,46,184,37,267,0
신리→연산교차로,2023.8.25 05:00,191,101,21,313,0
안락→연산교차로,2023.8.25 05:00,291,0,56,347,0
연산터널→연산교차로,2023.8.25 05:00,118,155,37,310,0
교대→연산교차로,2023.8.25 06:00,176,0,230,406,0
부산시청→연산교차로,2023.8.25 06:00,361,244,112,717,0
사직운동장→연산교차로,2023.8.25 06:00,93,295,50,438,0
신리→연산교차로,2023.8.25 06:00,358,190,21,569,0
안락→연산교차로,2023.8.25 06:00,470,0,88,558,0
연산터널→연산교차로,2023.8.25 06:00,222,240,42,504,0
교대→연산교차로,2023.8.25 07:00,258,0,388,646,0
부산시청→연산교차로,2023.8.25 07:00,562,385,220,1167,0
사직운동장→연산교차로,2023.8.25 07:00,166,486,67,719,0
신리→연산교차로,2023.8.25 07:00,469,283,29,781,0
안락→연산교차로,2023.8.25 07:00,553,0,74,627,0
연산터널→연산교차로,2023.8.25 07:00,282,371,46,699,0
교대→연산교차로,2023.8.25 08:00,316,0,524,840,0
부산시청→연산교차로,2023.8.25 08:00,566,417,313,1296,0
사직운동장→연산교차로,2023.8.25 08:00,194,656,56,906,0
신리→연산교차로,2023.8.25 08:00,490,341,27,858,0
안락→연산교차로,2023.8.25 08:00,521,0,85,606,0
연산터널→연산교차로,2023.8.25 08:00,324,408,34,766,0
교대→연산교차로,2023.8.25 09:00,293,0,526,819,0
부산시청→연산교차로,2023.8.25 09:00,519,378,315,1212,0
사직운동장→연산교차로,2023.8.25 09:00,186,593,92,871,0
신리→연산교차로,2023.8.25 09:00,456,341,36,833,0
안락→연산교차로,2023.8.25 09:00,504,0,81,585,0
연산터널→연산교차로,2023.8.25 09:00,291,364,52,707,0
교대→연산교차로,2023.8.25 10:00,308,0,548,856,0
부산시청→연산교차로,2023.8.25 10:00,488,358,266,1112,0
사직운동장→연산교차로,2023.8.25 10:00,199,573,69,841,0
신리→연산교차로,2023.8.25 10:00,441,290,59,790,0
안락→연산교차로,2023.8.25 10:00,468,0,119,587,0
연산터널→연산교차로,2023.8.25 10:00,304,362,44,710,0
교대→연산교차로,2023.8.25 11:00,299,0,503,802,0
부산시청→연산교차로,2023.8.25 11:00,561,380,289,1230,0
사직운동장→연산교차로,2023.8.25 11:00,192,602,62,856,0
신리→연산교차로,2023.8.25 11:00,472,275,64,811,0
안락→연산교차로,2023.8.25 11:00,440,0,120,560,0
연산터널→연산교차로,2023.8.25 11:00,283,337,55,675,0
교대→연산교차로,2023.8.25 12:00,307,0,409,716,0
부산시청→연산교차로,2023.8.25 12:00,575,356,251,1182,0
사직운동장→연산교차로,2023.8.25 12:00,205,583,68,856,0
신리→연산교차로,2023.8.25 12:00,455,299,47,801,0
안락→연산교차로,2023.8.25 12:00,424,0,114,538,0
연산터널→연산교차로,2023.8.25 12:00,284,284,48,616,0
교대→연산교차로,2023.8.25 13:00,362,0,475,837,0
부산시청→연산교차로,2023.8.25 13:00,589,464,269,1322,0
사직운동장→연산교차로,2023.8.25 13:00,212,611,70,893,0
신리→연산교차로,2023.8.25 13:00,455,287,53,795,0
안락→연산교차로,2023.8.25 13:00,431,0,98,529,0
연산터널→연산교차로,2023.8.25 13:00,262,269,39,570,0
교대→연산교차로,2023.8.25 14:00,363,0,499,862,0
부산시청→연산교차로,2023.8.25 14:00,617,469,290,1376,0
사직운동장→연산교차로,2023.8.25 14:00,225,641,85,951,0
신리→연산교차로,2023.8.25 14:00,451,299,40,790,0
안락→연산교차로,2023.8.25 14:00,422,0,92,514,0
연산터널→연산교차로,2023.8.25 14:00,233,288,46,567,0
교대→연산교차로,2023.8.25 15:00,361,0,505,866,0
부산시청→연산교차로,2023.8.25 15:00,562,493,307,1362,0
사직운동장→연산교차로,2023.8.25 15:00,202,644,81,927,0
신리→연산교차로,2023.8.25 15:00,511,297,61,869,0
안락→연산교차로,2023.8.25 15:00,438,0,99,537,0
연산터널→연산교차로,2023.8.25 15:00,240,284,40,564,0
교대→연산교차로,2023.8.25 16:00,379,0,523,902,0
부산시청→연산교차로,2023.8.25 16:00,568,510,307,1385,0
사직운동장→연산교차로,2023.8.25 16:00,216,661,49,926,0
신리→연산교차로,2023.8.25 16:00,495,298,63,856,0
안락→연산교차로,2023.8.25 16:00,456,0,100,556,0
연산터널→연산교차로,2023.8.25 16:00,196,286,40,522,0
교대→연산교차로,2023.8.25 17:00,380,0,540,920,0
부산시청→연산교차로,2023.8.25 17:00,604,583,323,1510,0
사직운동장→연산교차로,2023.8.25 17:00,239,710,52,1001,0
신리→연산교차로,2023.8.25 17:00,526,311,61,898,0
안락→연산교차로,2023.8.25 17:00,454,0,115,569,0
연산터널→연산교차로,2023.8.25 17:00,226,292,35,553,0
교대→연산교차로,2023.8.25 18:00,376,0,568,944,0
부산시청→연산교차로,2023.8.25 18:00,610,587,327,1524,0
사직운동장→연산교차로,2023.8.25 18:00,216,704,44,964,0
신리→연산교차로,2023.8.25 18:00,541,280,44,865,0
안락→연산교차로,2023.8.25 18:00,456,0,124,580,0
연산터널→연산교차로,2023.8.25 18:00,242,269,44,555,0
교대→연산교차로,2023.8.25 19:00,348,0,455,803,0
부산시청→연산교차로,2023.8.25 19:00,565,458,317,1340,0
사직운동장→연산교차로,2023.8.25 19:00,221,652,71,944,0
신리→연산교차로,2023.8.25 19:00,411,225,39,675,0
안락→연산교차로,2023.8.25 19:00,428,0,97,525,0
연산터널→연산교차로,2023.8.25 19:00,221,264,47,532,0
교대→연산교차로,2023.8.25 20:00,342,0,436,778,0
부산시청→연산교차로,2023.8.25 20:00,473,365,243,1081,0
사직운동장→연산교차로,2023.8.25 20:00,218,564,89,871,0
신리→연산교차로,2023.8.25 20:00,334,211,46,591,0
안락→연산교차로,2023.8.25 20:00,413,0,118,531,0
연산터널→연산교차로,2023.8.25 20:00,228,270,65,563,0
교대→연산교차로,2023.8.25 21:00,303,0,325,628,0
부산시청→연산교차로,2023.8.25 21:00,522,344,250,1116,0
사직운동장→연산교차로,2023.8.25 21:00,186,509,75,770,0
신리→연산교차로,2023.8.25 21:00,344,229,25,598,0
안락→연산교차로,2023.8.25 21:00,428,0,115,543,0
연산터널→연산교차로,2023.8.25 21:00,254,286,56,596,0
교대→연산교차로,2023.8.25 22:00,291,0,314,605,0
부산시청→연산교차로,2023.8.25 22:00,414,289,164,867,0
사직운동장→연산교차로,2023.8.25 22:00,200,458,58,716,0
신리→연산교차로,2023.8.25 22:00,302,213,29,544,0
안락→연산교차로,2023.8.25 22:00,379,0,111,490,0
연산터널→연산교차로,2023.8.25 22:00,227,258,61,546,0
교대→연산교차로,2023.8.25 23:00,230,0,254,484,0
부산시청→연산교차로,2023.8.25 23:00,388,232,173,793,0
사직운동장→연산교차로,2023.8.25 23:00,132,371,97,600,0
신리→연산교차로,2023.8.25 23:00,263,133,32,428,0
안락→연산교차로,2023.8.25 23:00,330,0,92,422,0
연산터널→연산교차로,2023.8.25 23:00,185,225,64,474,0
교대→연산교차로,2023.8.26 00:00,190,0,242,432,0
부산시청→연산교차로,2023.8.26 00:00,355,193,131,679,0
사직운동장→연산교차로,2023.8.26 00:00,107,353,69,529,0
신리→연산교차로,2023.8.26 00:00,245,134,30,409,0
안락→연산교차로,2023.8.26 00:00,295,0,63,358,0
연산터널→연산교차로,2023.8.26 00:00,171,227,51,449,0
교대→연산교차로,2023.8.26 01:00,166,0,250,416,0
부산시청→연산교차로,2023.8.26 01:00,269,158,95,522,0
사직운동장→연산교차로,2023.8.26 01:00,81,240,60,381,0
신리→연산교차로,2023.8.26 01:00,178,93,21,292,0
안락→연산교차로,2023.8.26 01:00,229,0,66,295,0
연산터널→연산교차로,2023.8.26 01:00,151,167,39,357,0
교대→연산교차로,2023.8.26 02:00,144,0,166,310,0
부산시청→연산교차로,2023.8.26 02:00,224,130,73,427,0
사직운동장→연산교차로,2023.8.26 02:00,63,177,44,284,0
신리→연산교차로,2023.8.26 02:00,134,88,14,236,0
안락→연산교차로,2023.8.26 02:00,136,0,38,174,0
연산터널→연산교차로,2023.8.26 02:00,103,157,38,298,0
교대→연산교차로,2023.8.26 03:00,100,0,154,254,0
부산시청→연산교차로,2023.8.26 03:00,249,100,55,404,0
사직운동장→연산교차로,2023.8.26 03:00,44,152,24,220,0
신리→연산교차로,2023.8.26 03:00,118,65,7,190,0
안락→연산교차로,2023.8.26 03:00,172,0,39,211,0
연산터널→연산교차로,2023.8.26 03:00,92,139,44,275,0
교대→연산교차로,2023.8.26 04:00,91,0,129,220,0
부산시청→연산교차로,2023.8.26 04:00,192,114,54,360,0
사직운동장→연산교차로,2023.8.26 04:00,39,155,22,216,0
신리→연산교차로,2023.8.26 04:00,107,50,5,162,0
안락→연산교차로,2023.8.26 04:00,169,0,56,225,0
연산터널→연산교차로,2023.8.26 04:00,81,114,35,230,0
교대→연산교차로,2023.8.26 05:00,99,0,136,235,0
부산시청→연산교차로,2023.8.26 05:00,206,157,80,443,0
사직운동장→연산교차로,2023.8.26 05:00,54,174,34,262,0
신리→연산교차로,2023.8.26 05:00,204,107,14,325,0
안락→연산교차로,2023.8.26 05:00,266,0,76,342,0
연산터널→연산교차로,2023.8.26 05:00,113,139,28,280,0
교대→연산교차로,2023.8.26 06:00,163,0,186,349,0
부산시청→연산교차로,2023.8.26 06:00,330,226,99,655,0
사직운동장→연산교차로,2023.8.26 06:00,88,238,37,363,0
신리→연산교차로,2023.8.26 06:00,293,152,21,466,0
안락→연산교차로,2023.8.26 06:00,408,0,82,490,0
연산터널→연산교차로,2023.8.26 06:00,204,194,37,435,0
교대→연산교차로,2023.8.26 07:00,192,0,197,389,0
부산시청→연산교차로,2023.8.26 07:00,382,220,152,754,0
사직운동장→연산교차로,2023.8.26 07:00,102,307,36,445,0
신리→연산교차로,2023.8.26 07:00,287,169,34,490,0
안락→연산교차로,2023.8.26 07:00,421,0,89,510,0
연산터널→연산교차로,2023.8.26 07:00,194,204,38,436,0
교대→연산교차로,2023.8.26 08:00,256,0,317,573,0
부산시청→연산교차로,2023.8.26 08:00,454,308,240,1002,0
사직운동장→연산교차로,2023.8.26 08:00,183,520,59,762,0
신리→연산교차로,2023.8.26 08:00,410,284,58,752,0
안락→연산교차로,2023.8.26 08:00,489,0,121,610,0
연산터널→연산교차로,2023.8.26 08:00,249,289,47,585,0
교대→연산교차로,2023.8.26 09:00,298,0,380,678,0
부산시청→연산교차로,2023.8.26 09:00,542,345,270,1157,0
사직운동장→연산교차로,2023.8.26 09:00,178,581,65,824,0
신리→연산교차로,2023.8.26 09:00,456,303,67,826,0
안락→연산교차로,2023.8.26 09:00,583,0,128,711,0
연산터널→연산교차로,2023.8.26 09:00,284,349,54,687,0
교대→연산교차로,2023.8.26 10:00,311,0,459,770,0
부산시청→연산교차로,2023.8.26 10:00,453,364,227,1044,0
사직운동장→연산교차로,2023.8.26 10:00,196,612,47,855,0
신리→연산교차로,2023.8.26 10:00,479,299,66,844,0
안락→연산교차로,2023.8.26 10:00,532,0,145,677,0
연산터널→연산교차로,2023.8.26 10:00,295,342,56,693,0
교대→연산교차로,2023.8.26 11:00,314,0,497,811,0
부산시청→연산교차로,2023.8.26 11:00,606,388,361,1355,0
사직운동장→연산교차로,2023.8.26 11:00,191,625,40,856,0
신리→연산교차로,2023.8.26 11:00,467,322,66,855,0
안락→연산교차로,2023.8.26 11:00,553,0,172,725,0
연산터널→연산교차로,2023.8.26 11:00,304,337,56,697,0
교대→연산교차로,2023.8.26 12:00,315,0,440,755,0
부산시청→연산교차로,2023.8.26 12:00,661,394,280,1335,0
사직운동장→연산교차로,2023.8.26 12:00,224,599,28,851,0
신리→연산교차로,2023.8.26 12:00,515,306,55,876,0
안락→연산교차로,2023.8.26 12:00,558,0,140,698,0
연산터널→연산교차로,2023.8.26 12:00,322,323,72,717,0
교대→연산교차로,2023.8.26 13:00,366,0,515,881,0
부산시청→연산교차로,2023.8.26 13:00,615,526,309,1450,0
사직운동장→연산교차로,2023.8.26 13:00,193,677,40,910,0
신리→연산교차로,2023.8.26 13:00,491,306,69,866,0
안락→연산교차로,2023.8.26 13:00,453,0,112,565,0
연산터널→연산교차로,2023.8.26 13:00,259,287,47,593,0
교대→연산교차로,2023.8.26 14:00,365,0,562,927,0
부산시청→연산교차로,2023.8.26 14:00,641,491,341,1473,0
사직운동장→연산교차로,2023.8.26 14:00,221,665,43,929,0
신리→연산교차로,2023.8.26 14:00,427,314,55,796,0
안락→연산교차로,2023.8.26 14:00,471,0,89,560,0
연산터널→연산교차로,2023.8.26 14:00,226,277,52,555,0
교대→연산교차로,2023.8.26 15:00,330,0,465,795,0
부산시청→연산교차로,2023.8.26 15:00,675,503,312,1490,0
사직운동장→연산교차로,2023.8.26 15:00,202,677,68,947,0
신리→연산교차로,2023.8.26 15:00,396,323,44,763,0
안락→연산교차로,2023.8.26 15:00,447,0,107,554,0
연산터널→연산교차로,2023.8.26 15:00,237,264,36,537,0
교대→연산교차로,2023.8.26 16:00,343,0,452,795,0
부산시청→연산교차로,2023.8.26 16:00,608,498,342,1448,0
사직운동장→연산교차로,2023.8.26 16:00,204,684,64,952,0
신리→연산교차로,2023.8.26 16:00,403,341,67,811,0
안락→연산교차로,2023.8.26 16:00,463,0,99,562,0
연산터널→연산교차로,2023.8.26 16:00,244,275,46,565,0
교대→연산교차로,2023.8.26 17:00,342,0,407,749,0
부산시청→연산교차로,2023.8.26 17:00,636,491,310,1437,0
사직운동장→연산교차로,2023.8.26 17:00,200,667,92,959,0
신리→연산교차로,2023.8.26 17:00,407,310,43,760,0
안락→연산교차로,2023.8.26 17:00,462,0,96,558,0
연산터널→연산교차로,2023.8.26 17:00,252,277,45,574,0
교대→연산교차로,2023.8.26 18:00,352,0,412,764,0
부산시청→연산교차로,2023.8.26 18:00,576,441,230,1247,0
사직운동장→연산교차로,2023.8.26 18:00,220,634,80,934,0
신리→연산교차로,2023.8.26 18:00,388,273,36,697,0
안락→연산교차로,2023.8.26 18:00,469,0,120,589,0
연산터널→연산교차로,2023.8.26 18:00,206,288,63,557,0
교대→연산교차로,2023.8.26 19:00,333,0,409,742,0
부산시청→연산교차로,2023.8.26 19:00,513,329,253,1095,0
사직운동장→연산교차로,2023.8.26 19:00,206,491,91,788,0
신리→연산교차로,2023.8.26 19:00,336,203,30,569,0
안락→연산교차로,2023.8.26 19:00,438,0,95,533,0
연산터널→연산교차로,2023.8.26 19:00,204,277,69,550,0
교대→연산교차로,2023.8.26 20:00,295,0,314,609,0
부산시청→연산교차로,2023.8.26 20:00,440,334,224,998,0
사직운동장→연산교차로,2023.8.26 20:00,167,476,86,729,0
신리→연산교차로,2023.8.26 20:00,373,208,35,616,0
안락→연산교차로,2023.8.26 20:00,393,0,111,504,0
연산터널→연산교차로,2023.8.26 20:00,232,272,43,547,0
교대→연산교차로,2023.8.26 21:00,287,0,300,587,0
부산시청→연산교차로,2023.8.26 21:00,443,359,193,995,0
사직운동장→연산교차로,2023.8.26 21:00,170,414,67,651,0
신리→연산교차로,2023.8.26 21:00,336,212,18,566,0
안락→연산교차로,2023.8.26 21:00,394,0,150,544,0
연산터널→연산교차로,2023.8.26 21:00,254,265,60,579,0
교대→연산교차로,2023.8.26 22:00,258,0,238,496,0
부산시청→연산교차로,2023.8.26 22:00,417,266,184,867,0
사직운동장→연산교차로,2023.8.26 22:00,224,441,59,724,0
신리→연산교차로,2023.8.26 22:00,290,228,34,552,0
안락→연산교차로,2023.8.26 22:00,358,0,111,469,0
연산터널→연산교차로,2023.8.26 22:00,236,211,43,490,0
교대→연산교차로,2023.8.26 23:00,227,0,193,420,0
부산시청→연산교차로,2023.8.26 23:00,354,205,119,678,0
사직운동장→연산교차로,2023.8.26 23:00,209,449,66,724,0
신리→연산교차로,2023.8.26 23:00,270,160,17,447,0
안락→연산교차로,2023.8.26 23:00,307,0,87,394,0
연산터널→연산교차로,2023.8.26 23:00,184,192,45,421,0
교대→연산교차로,2023.8.27 00:00,203,0,210,413,1
부산시청→연산교차로,2023.8.27 00:00,326,213,117,656,1
사직운동장→연산교차로,2023.8.27 00:00,172,358,51,581,1
신리→연산교차로,2023.8.27 00:00,244,147,17,408,1
안락→연산교차로,2023.8.27 00:00,248,0,86,334,1
연산터널→연산교차로,2023.8.27 00:00,140,158,48,346,1
교대→연산교차로,2023.8.27 01:00,164,0,182,346,1
부산시청→연산교차로,2023.8.27 01:00,254,176,111,541,1
사직운동장→연산교차로,2023.8.27 01:00,77,238,49,364,1
신리→연산교차로,2023.8.27 01:00,204,117,16,337,1
안락→연산교차로,2023.8.27 01:00,187,0,64,251,1
연산터널→연산교차로,2023.8.27 01:00,137,156,42,335,1
교대→연산교차로,2023.8.27 02:00,121,0,178,299,1
부산시청→연산교차로,2023.8.27 02:00,211,134,70,415,1
사직운동장→연산교차로,2023.8.27 02:00,59,176,40,275,1
신리→연산교차로,2023.8.27 02:00,121,77,19,217,1
안락→연산교차로,2023.8.27 02:00,178,0,48,226,1
연산터널→연산교차로,2023.8.27 02:00,113,158,39,310,1
교대→연산교차로,2023.8.27 03:00,91,0,174,265,1
부산시청→연산교차로,2023.8.27 03:00,201,100,76,377,1
사직운동장→연산교차로,2023.8.27 03:00,59,166,31,256,1
신리→연산교차로,2023.8.27 03:00,107,68,12,187,1
안락→연산교차로,2023.8.27 03:00,130,0,41,171,1
연산터널→연산교차로,2023.8.27 03:00,94,130,47,271,1
교대→연산교차로,2023.8.27 04:00,82,0,112,194,1
부산시청→연산교차로,2023.8.27 04:00,166,105,52,323,1
사직운동장→연산교차로,2023.8.27 04:00,38,112,34,184,1
신리→연산교차로,2023.8.27 04:00,102,57,7,166,1
안락→연산교차로,2023.8.27 04:00,116,0,36,152,1
연산터널→연산교차로,2023.8.27 04:00,100,114,20,234,1
교대→연산교차로,2023.8.27 05:00,75,0,98,173,1
부산시청→연산교차로,2023.8.27 05:00,166,98,39,303,1
사직운동장→연산교차로,2023.8.27 05:00,32,133,25,190,1
신리→연산교차로,2023.8.27 05:00,141,76,9,226,1
안락→연산교차로,2023.8.27 05:00,173,0,32,205,1
연산터널→연산교차로,2023.8.27 05:00,96,90,24,210,1
교대→연산교차로,2023.8.27 06:00,109,0,118,227,1
부산시청→연산교차로,2023.8.27 06:00,215,156,62,433,1
사직운동장→연산교차로,2023.8.27 06:00,56,163,30,249,1
신리→연산교차로,2023.8.27 06:00,142,98,11,251,1
안락→연산교차로,2023.8.27 06:00,249,0,55,304,1
연산터널→연산교차로,2023.8.27 06:00,122,125,32,279,1
교대→연산교차로,2023.8.27 07:00,118,0,139,257,1
부산시청→연산교차로,2023.8.27 07:00,240,177,83,500,1
사직운동장→연산교차로,2023.8.27 07:00,61,223,30,314,1
신리→연산교차로,2023.8.27 07:00,210,108,20,338,1
안락→연산교차로,2023.8.27 07:00,263,0,48,311,1
연산터널→연산교차로,2023.8.27 07:00,131,124,32,287,1
교대→연산교차로,2023.8.27 08:00,162,0,199,361,1
부산시청→연산교차로,2023.8.27 08:00,323,204,126,653,1
사직운동장→연산교차로,2023.8.27 08:00,96,311,38,445,1
신리→연산교차로,2023.8.27 08:00,273,167,26,466,1
안락→연산교차로,2023.8.27 08:00,357,0,78,435,1
연산터널→연산교차로,2023.8.27 08:00,183,155,14,352,1
교대→연산교차로,2023.8.27 09:00,216,0,230,446,1
부산시청→연산교차로,2023.8.27 09:00,363,312,160,835,1
사직운동장→연산교차로,2023.8.27 09:00,134,431,35,600,1
신리→연산교차로,2023.8.27 09:00,383,222,23,628,1
안락→연산교차로,2023.8.27 09:00,429,0,99,528,1
연산터널→연산교차로,2023.8.27 09:00,257,212,38,507,1
교대→연산교차로,2023.8.27 10:00,277,0,308,585,1
부산시청→연산교차로,2023.8.27 10:00,445,345,199,989,1
사직운동장→연산교차로,2023.8.27 10:00,173,514,43,730,1
신리→연산교차로,2023.8.27 10:00,384,211,39,634,1
안락→연산교차로,2023.8.27 10:00,495,0,99,594,1
연산터널→연산교차로,2023.8.27 10:00,240,249,45,534,1
교대→연산교차로,2023.8.27 11:00,273,0,367,640,1
부산시청→연산교차로,2023.8.27 11:00,505,351,195,1051,1
사직운동장→연산교차로,2023.8.27 11:00,181,512,46,739,1
신리→연산교차로,2023.8.27 11:00,419,235,43,697,1
안락→연산교차로,2023.8.27 11:00,455,0,122,577,1
연산터널→연산교차로,2023.8.27 11:00,247,262,56,565,1
교대→연산교차로,2023.8.27 12:00,283,0,293,576,1
부산시청→연산교차로,2023.8.27 12:00,554,357,228,1139,1
사직운동장→연산교차로,2023.8.27 12:00,204,564,49,817,1
신리→연산교차로,2023.8.27 12:00,453,236,33,722,1
안락→연산교차로,2023.8.27 12:00,513,0,134,647,1
연산터널→연산교차로,2023.8.27 12:00,280,270,53,603,1
교대→연산교차로,2023.8.27 13:00,294,0,345,639,1
부산시청→연산교차로,2023.8.27 13:00,559,389,213,1161,1
사직운동장→연산교차로,2023.8.27 13:00,202,570,38,810,1
신리→연산교차로,2023.8.27 13:00,414,297,39,750,1
안락→연산교차로,2023.8.27 13:00,521,0,120,641,1
연산터널→연산교차로,2023.8.27 13:00,272,291,54,617,1
교대→연산교차로,2023.8.27 14:00,316,0,373,689,1
부산시청→연산교차로,2023.8.27 14:00,549,364,218,1131,1
사직운동장→연산교차로,2023.8.27 14:00,201,558,60,819,1
신리→연산교차로,2023.8.27 14:00,421,280,45,746,1
안락→연산교차로,2023.8.27 14:00,513,0,171,684,1
연산터널→연산교차로,2023.8.27 14:00,257,251,61,569,1
교대→연산교차로,2023.8.27 15:00,282,0,298,580,1
부산시청→연산교차로,2023.8.27 15:00,532,366,216,1114,1
사직운동장→연산교차로,2023.8.27 15:00,182,534,73,789,1
신리→연산교차로,2023.8.27 15:00,400,350,23,773,1
안락→연산교차로,2023.8.27 15:00,533,0,179,712,1
연산터널→연산교차로,2023.8.27 15:00,299,257,42,598,1
교대→연산교차로,2023.8.27 16:00,292,0,303,595,1
부산시청→연산교차로,2023.8.27 16:00,533,379,210,1122,1
사직운동장→연산교차로,2023.8.27 16:00,202,563,67,832,1
신리→연산교차로,2023.8.27 16:00,433,299,33,765,1
안락→연산교차로,2023.8.27 16:00,556,0,104,660,1
연산터널→연산교차로,2023.8.27 16:00,276,310,54,640,1
교대→연산교차로,2023.8.27 17:00,301,0,364,665,1
부산시청→연산교차로,2023.8.27 17:00,537,336,224,1097,1
사직운동장→연산교차로,2023.8.27 17:00,198,554,70,822,1
신리→연산교차로,2023.8.27 17:00,380,292,32,704,1
안락→연산교차로,2023.8.27 17:00,553,0,147,700,1
연산터널→연산교차로,2023.8.27 17:00,274,260,52,586,1
교대→연산교차로,2023.8.27 18:00,293,0,310,603,1
부산시청→연산교차로,2023.8.27 18:00,474,286,189,949,1
사직운동장→연산교차로,2023.8.27 18:00,137,476,75,688,1
신리→연산교차로,2023.8.27 18:00,343,196,36,575,1
안락→연산교차로,2023.8.27 18:00,456,0,109,565,1
연산터널→연산교차로,2023.8.27 18:00,213,226,57,496,1
교대→연산교차로,2023.8.27 19:00,264,0,265,529,1
부산시청→연산교차로,2023.8.27 19:00,399,258,171,828,1
사직운동장→연산교차로,2023.8.27 19:00,168,397,62,627,1
신리→연산교차로,2023.8.27 19:00,332,164,35,531,1
안락→연산교차로,2023.8.27 19:00,432,0,113,545,1
연산터널→연산교차로,2023.8.27 19:00,232,229,48,509,1
교대→연산교차로,2023.8.27 20:00,273,0,236,509,1
부산시청→연산교차로,2023.8.27 20:00,368,246,157,771,1
사직운동장→연산교차로,2023.8.27 20:00,200,406,53,659,1
신리→연산교차로,2023.8.27 20:00,315,158,23,496,1
안락→연산교차로,2023.8.27 20:00,371,0,101,472,1
연산터널→연산교차로,2023.8.27 20:00,205,217,49,471,1
교대→연산교차로,2023.8.27 21:00,236,0,206,442,1
부산시청→연산교차로,2023.8.27 21:00,346,218,137,701,1
사직운동장→연산교차로,2023.8.27 21:00,138,359,58,555,1
신리→연산교차로,2023.8.27 21:00,270,184,18,472,1
안락→연산교차로,2023.8.27 21:00,323,0,100,423,1
연산터널→연산교차로,2023.8.27 21:00,167,179,39,385,1
교대→연산교차로,2023.8.27 22:00,188,0,192,380,1
부산시청→연산교차로,2023.8.27 22:00,321,201,122,644,1
사직운동장→연산교차로,2023.8.27 22:00,180,387,52,619,1
신리→연산교차로,2023.8.27 22:00,244,159,27,430,1
안락→연산교차로,2023.8.27 22:00,255,0,95,350,1
연산터널→연산교차로,2023.8.27 22:00,158,180,58,396,1
교대→연산교차로,2023.8.27 23:00,126,0,130,256,1
부산시청→연산교차로,2023.8.27 23:00,226,155,79,460,1
사직운동장→연산교차로,2023.8.27 23:00,214,382,44,640,1
신리→연산교차로,2023.8.27 23:00,197,134,11,342,1
안락→연산교차로,2023.8.27 23:00,193,0,76,269,1
연산터널→연산교차로,2023.8.27 23:00,140,145,32,317,1
교대→연산교차로,2023.8.28 00:00,115,0,110,225,0
부산시청→연산교차로,2023.8.28 00:00,191,142,68,401,0
사직운동장→연산교차로,2023.8.28 00:00,250,388,54,692,0
신리→연산교차로,2023.8.28 00:00,138,126,10,274,0
안락→연산교차로,2023.8.28 00:00,171,0,56,227,0
연산터널→연산교차로,2023.8.28 00:00,108,114,29,251,0
교대→연산교차로,2023.8.28 01:00,73,0,93,166,0
부산시청→연산교차로,2023.8.28 01:00,146,94,46,286,0
사직운동장→연산교차로,2023.8.28 01:00,96,145,19,260,0
신리→연산교차로,2023.8.28 01:00,92,80,10,182,0
안락→연산교차로,2023.8.28 01:00,114,0,32,146,0
연산터널→연산교차로,2023.8.28 01:00,81,89,29,199,0
교대→연산교차로,2023.8.28 02:00,52,0,73,125,0
부산시청→연산교차로,2023.8.28 02:00,129,64,42,235,0
사직운동장→연산교차로,2023.8.28 02:00,28,111,37,176,0
신리→연산교차로,2023.8.28 02:00,60,35,9,104,0
안락→연산교차로,2023.8.28 02:00,115,0,35,150,0
연산터널→연산교차로,2023.8.28 02:00,68,80,32,180,0
교대→연산교차로,2023.8.28 03:00,60,0,87,147,0
부산시청→연산교차로,2023.8.28 03:00,124,72,34,230,0
사직운동장→연산교차로,2023.8.28 03:00,35,96,24,155,0
신리→연산교차로,2023.8.28 03:00,69,28,7,104,0
안락→연산교차로,2023.8.28 03:00,100,0,26,126,0
연산터널→연산교차로,2023.8.28 03:00,52,85,44,181,0
교대→연산교차로,2023.8.28 04:00,51,0,62,113,0
부산시청→연산교차로,2023.8.28 04:00,147,79,37,263,0
사직운동장→연산교차로,2023.8.28 04:00,20,99,15,134,0
신리→연산교차로,2023.8.28 04:00,94,59,3,156,0
안락→연산교차로,2023.8.28 04:00,170,0,30,200,0
연산터널→연산교차로,2023.8.28 04:00,69,79,12,160,0
교대→연산교차로,2023.8.28 05:00,84,0,97,181,0
부산시청→연산교차로,2023.8.28 05:00,220,169,79,468,0
사직운동장→연산교차로,2023.8.28 05:00,57,155,27,239,0
신리→연산교차로,2023.8.28 05:00,225,116,11,352,0
안락→연산교차로,2023.8.28 05:00,312,0,44,356,0
연산터널→연산교차로,2023.8.28 05:00,118,138,16,272,0
교대→연산교차로,2023.8.28 06:00,174,0,240,414,0
부산시청→연산교차로,2023.8.28 06:00,406,264,121,791,0
사직운동장→연산교차로,2023.8.28 06:00,93,270,49,412,0
신리→연산교차로,2023.8.28 06:00,351,199,19,569,0
안락→연산교차로,2023.8.28 06:00,491,0,95,586,0
연산터널→연산교차로,2023.8.28 06:00,260,244,41,545,0
교대→연산교차로,2023.8.28 07:00,278,0,411,689,0
부산시청→연산교차로,2023.8.28 07:00,558,368,216,1142,0
사직운동장→연산교차로,2023.8.28 07:00,195,481,47,723,0
신리→연산교차로,2023.8.28 07:00,450,316,23,789,0
안락→연산교차로,2023.8.28 07:00,641,0,87,728,0
연산터널→연산교차로,2023.8.28 07:00,301,366,37,704,0
교대→연산교차로,2023.8.28 08:00,309,0,516,825,0
부산시청→연산교차로,2023.8.28 08:00,580,442,336,1358,0
사직운동장→연산교차로,2023.8.28 08:00,195,650,55,900,0
신리→연산교차로,2023.8.28 08:00,508,346,32,886,0
안락→연산교차로,2023.8.28 08:00,632,0,91,723,0
연산터널→연산교차로,2023.8.28 08:00,313,384,28,725,0
교대→연산교차로,2023.8.28 09:00,284,0,471,755,0
부산시청→연산교차로,2023.8.28 09:00,521,384,287,1192,0
사직운동장→연산교차로,2023.8.28 09:00,202,587,67,856,0
신리→연산교차로,2023.8.28 09:00,427,330,44,801,0
안락→연산교차로,2023.8.28 09:00,575,0,116,691,0
연산터널→연산교차로,2023.8.28 09:00,316,361,42,719,0
교대→연산교차로,2023.8.28 10:00,283,0,453,736,0
부산시청→연산교차로,2023.8.28 10:00,560,367,262,1189,0
사직운동장→연산교차로,2023.8.28 10:00,203,593,86,882,0
신리→연산교차로,2023.8.28 10:00,456,275,54,785,0
안락→연산교차로,2023.8.28 10:00,551,0,155,706,0
연산터널→연산교차로,2023.8.28 10:00,312,333,57,702,0
교대→연산교차로,2023.8.28 11:00,299,0,481,780,0
부산시청→연산교차로,2023.8.28 11:00,532,373,269,1174,0
사직운동장→연산교차로,2023.8.28 11:00,214,561,59,834,0
신리→연산교차로,2023.8.28 11:00,454,279,65,798,0
안락→연산교차로,2023.8.28 11:00,533,0,147,680,0
연산터널→연산교차로,2023.8.28 11:00,250,329,63,642,0
교대→연산교차로,2023.8.28 12:00,275,0,413,688,0
부산시청→연산교차로,2023.8.28 12:00,565,364,241,1170,0
사직운동장→연산교차로,2023.8.28 12:00,204,551,70,825,0
신리→연산교차로,2023.8.28 12:00,426,270,57,753,0
안락→연산교차로,2023.8.28 12:00,485,0,141,626,0
연산터널→연산교차로,2023.8.28 12:00,258,296,44,598,0
교대→연산교차로,2023.8.28 13:00,285,0,401,686,0
부산시청→연산교차로,2023.8.28 13:00,581,430,284,1295,0
사직운동장→연산교차로,2023.8.28 13:00,209,577,80,866,0
신리→연산교차로,2023.8.28 13:00,425,270,53,748,0
안락→연산교차로,2023.8.28 13:00,416,0,123,539,0
연산터널→연산교차로,2023.8.28 13:00,212,294,57,563,0
교대→연산교차로,2023.8.28 14:00,328,0,489,817,0
부산시청→연산교차로,2023.8.28 14:00,571,438,305,1314,0
사직운동장→연산교차로,2023.8.28 14:00,203,656,79,938,0
신리→연산교차로,2023.8.28 14:00,450,290,66,806,0
안락→연산교차로,2023.8.28 14:00,452,0,112,564,0
연산터널→연산교차로,2023.8.28 14:00,249,286,45,580,0
교대→연산교차로,2023.8.28 15:00,351,0,450,801,0
부산시청→연산교차로,2023.8.28 15:00,605,493,300,1398,0
사직운동장→연산교차로,2023.8.28 15:00,219,665,65,949,0
신리→연산교차로,2023.8.28 15:00,429,295,54,778,0
안락→연산교차로,2023.8.28 15:00,423,0,130,553,0
연산터널→연산교차로,2023.8.28 15:00,233,282,43,558,0
교대→연산교차로,2023.8.28 16:00,362,0,478,840,0
부산시청→연산교차로,2023.8.28 16:00,611,534,332,1477,0
사직운동장→연산교차로,2023.8.28 16:00,234,671,46,951,0
신리→연산교차로,2023.8.28 16:00,473,295,70,838,0
안락→연산교차로,2023.8.28 16:00,440,0,107,547,0
연산터널→연산교차로,2023.8.28 16:00,267,291,38,596,0
교대→연산교차로,2023.8.28 17:00,375,0,565,940,0
부산시청→연산교차로,2023.8.28 17:00,660,541,326,1527,0
사직운동장→연산교차로,2023.8.28 17:00,223,723,42,988,0
신리→연산교차로,2023.8.28 17:00,513,279,64,856,0
안락→연산교차로,2023.8.28 17:00,445,0,104,549,0
연산터널→연산교차로,2023.8.28 17:00,230,278,65,573,0
교대→연산교차로,2023.8.28 18:00,361,0,532,893,0
부산시청→연산교차로,2023.8.28 18:00,620,556,348,1524,0
사직운동장→연산교차로,2023.8.28 18:00,244,707,41,992,0
신리→연산교차로,2023.8.28 18:00,523,257,40,820,0
안락→연산교차로,2023.8.28 18:00,429,0,129,558,0
연산터널→연산교차로,2023.8.28 18:00,228,249,62,539,0
교대→연산교차로,2023.8.28 19:00,305,0,408,713,0
부산시청→연산교차로,2023.8.28 19:00,525,407,267,1199,0
사직운동장→연산교차로,2023.8.28 19:00,175,569,54,798,0
신리→연산교차로,2023.8.28 19:00,384,219,39,642,0
안락→연산교차로,2023.8.28 19:00,420,0,84,504,0
연산터널→연산교차로,2023.8.28 19:00,226,274,48,548,0
교대→연산교차로,2023.8.28 20:00,296,0,329,625,0
부산시청→연산교차로,2023.8.28 20:00,490,320,211,1021,0
사직운동장→연산교차로,2023.8.28 20:00,153,509,64,726,0
신리→연산교차로,2023.8.28 20:00,306,183,43,532,0
안락→연산교차로,2023.8.28 20:00,384,0,98,482,0
연산터널→연산교차로,2023.8.28 20:00,222,253,63,538,0
교대→연산교차로,2023.8.28 21:00,251,0,250,501,0
부산시청→연산교차로,2023.8.28 21:00,450,312,198,960,0
사직운동장→연산교차로,2023.8.28 21:00,157,405,74,636,0
신리→연산교차로,2023.8.28 21:00,279,182,21,482,0
안락→연산교차로,2023.8.28 21:00,412,0,84,496,0
연산터널→연산교차로,2023.8.28 21:00,232,244,59,535,0
교대→연산교차로,2023.8.28 22:00,241,0,216,457,0
부산시청→연산교차로,2023.8.28 22:00,387,226,138,751,0
사직운동장→연산교차로,2023.8.28 22:00,144,352,60,556,0
신리→연산교차로,2023.8.28 22:00,227,167,28,422,0
안락→연산교차로,2023.8.28 22:00,311,0,74,385,0
연산터널→연산교차로,2023.8.28 22:00,206,222,77,505,0
교대→연산교차로,2023.8.28 23:00,168,0,225,393,0
부산시청→연산교차로,2023.8.28 23:00,298,170,114,582,0
사직운동장→연산교차로,2023.8.28 23:00,81,263,52,396,0
신리→연산교차로,2023.8.28 23:00,193,118,26,337,0
안락→연산교차로,2023.8.28 23:00,260,0,64,324,0
연산터널→연산교차로,2023.8.28 23:00,144,170,64,378,0
교대→연산교차로,2023.8.29 00:00,145,0,207,352,0
부산시청→연산교차로,2023.8.29 00:00,232,152,91,475,0
사직운동장→연산교차로,2023.8.29 00:00,79,238,31,348,0
신리→연산교차로,2023.8.29 00:00,151,102,18,271,0
안락→연산교차로,2023.8.29 00:00,194,0,56,250,0
연산터널→연산교차로,2023.8.29 00:00,141,167,67,375,0
교대→연산교차로,2023.8.29 01:00,97,0,125,222,0
부산시청→연산교차로,2023.8.29 01:00,196,114,82,392,0
사직운동장→연산교차로,2023.8.29 01:00,58,177,19,254,0
신리→연산교차로,2023.8.29 01:00,106,58,20,184,0
안락→연산교차로,2023.8.29 01:00,128,0,46,174,0
연산터널→연산교차로,2023.8.29 01:00,107,147,58,312,0
교대→연산교차로,2023.8.29 02:00,76,0,113,189,0
부산시청→연산교차로,2023.8.29 02:00,151,86,53,290,0
사직운동장→연산교차로,2023.8.29 02:00,35,134,7,176,0
신리→연산교차로,2023.8.29 02:00,82,50,10,142,0
안락→연산교차로,2023.8.29 02:00,107,0,28,135,0
연산터널→연산교차로,2023.8.29 02:00,57,116,41,214,0
교대→연산교차로,2023.8.29 03:00,63,0,88,151,0
부산시청→연산교차로,2023.8.29 03:00,169,74,47,290,0
사직운동장→연산교차로,2023.8.29 03:00,35,119,7,161,0
신리→연산교차로,2023.8.29 03:00,67,40,14,121,0
안락→연산교차로,2023.8.29 03:00,107,0,37,144,0
연산터널→연산교차로,2023.8.29 03:00,75,93,38,206,0
교대→연산교차로,2023.8.29 04:00,56,0,87,143,0
부산시청→연산교차로,2023.8.29 04:00,144,66,45,255,0
사직운동장→연산교차로,2023.8.29 04:00,30,108,8,146,0
신리→연산교차로,2023.8.29 04:00,105,56,4,165,0
안락→연산교차로,2023.8.29 04:00,154,0,34,188,0
연산터널→연산교차로,2023.8.29 04:00,65,83,24,172,0
교대→연산교차로,2023.8.29 05:00,73,0,129,202,0
부산시청→연산교차로,2023.8.29 05:00,202,156,75,433,0
사직운동장→연산교차로,2023.8.29 05:00,52,162,17,231,0
신리→연산교차로,2023.8.29 05:00,214,101,17,332,0
안락→연산교차로,2023.8.29 05:00,295,0,69,364,0
연산터널→연산교차로,2023.8.29 05:00,123,132,25,280,0
교대→연산교차로,2023.8.29 06:00,170,0,235,405,0
부산시청→연산교차로,2023.8.29 06:00,368,276,113,757,0
사직운동장→연산교차로,2023.8.29 06:00,94,304,45,443,0
신리→연산교차로,2023.8.29 06:00,327,175,19,521,0
안락→연산교차로,2023.8.29 06:00,477,0,102,579,0
연산터널→연산교차로,2023.8.29 06:00,237,248,42,527,0
교대→연산교차로,2023.8.29 07:00,249,0,373,622,0
부산시청→연산교차로,2023.8.29 07:00,524,353,213,1090,0
사직운동장→연산교차로,2023.8.29 07:00,178,487,42,707,0
신리→연산교차로,2023.8.29 07:00,499,296,36,831,0
안락→연산교차로,2023.8.29 07:00,641,0,75,716,0
연산터널→연산교차로,2023.8.29 07:00,292,375,50,717,0
교대→연산교차로,2023.8.29 08:00,322,0,532,854,0
부산시청→연산교차로,2023.8.29 08:00,593,438,308,1339,0
사직운동장→연산교차로,2023.8.29 08:00,186,645,63,894,0
신리→연산교차로,2023.8.29 08:00,494,362,31,887,0
안락→연산교차로,2023.8.29 08:00,620,0,103,723,0
연산터널→연산교차로,2023.8.29 08:00,348,385,28,761,0
교대→연산교차로,2023.8.29 09:00,312,0,520,832,0
부산시청→연산교차로,2023.8.29 09:00,527,369,295,1191,0
사직운동장→연산교차로,2023.8.29 09:00,195,597,76,868,0
신리→연산교차로,2023.8.29 09:00,482,322,42,846,0
안락→연산교차로,2023.8.29 09:00,593,0,98,691,0
연산터널→연산교차로,2023.8.29 09:00,305,353,51,709,0
교대→연산교차로,2023.8.29 10:00,305,0,470,775,0
부산시청→연산교차로,2023.8.29 10:00,536,370,268,1174,0
사직운동장→연산교차로,2023.8.29 10:00,199,599,68,866,0
신리→연산교차로,2023.8.29 10:00,465,289,75,829,0
안락→연산교차로,2023.8.29 10:00,546,0,154,700,0
연산터널→연산교차로,2023.8.29 10:00,313,336,44,693,0
교대→연산교차로,2023.8.29 11:00,297,0,469,766,0
부산시청→연산교차로,2023.8.29 11:00,528,364,290,1182,0
사직운동장→연산교차로,2023.8.29 11:00,190,628,79,897,0
신리→연산교차로,2023.8.29 11:00,496,247,64,807,0
안락→연산교차로,2023.8.29 11:00,495,0,158,653,0
연산터널→연산교차로,2023.8.29 11:00,276,293,57,626,0
교대→연산교차로,2023.8.29 12:00,291,0,407,698,0
부산시청→연산교차로,2023.8.29 12:00,587,362,239,1188,0
사직운동장→연산교차로,2023.8.29 12:00,176,612,79,867,0
신리→연산교차로,2023.8.29 12:00,408,268,52,728,0
안락→연산교차로,2023.8.29 12:00,470,0,144,614,0
연산터널→연산교차로,2023.8.29 12:00,259,270,43,572,0
교대→연산교차로,2023.8.29 13:00,320,0,482,802,0
부산시청→연산교차로,2023.8.29 13:00,580,434,276,1290,0
사직운동장→연산교차로,2023.8.29 13:00,222,599,88,909,0
신리→연산교차로,2023.8.29 13:00,423,277,59,759,0
안락→연산교차로,2023.8.29 13:00,448,0,114,562,0
연산터널→연산교차로,2023.8.29 13:00,249,274,35,558,0
교대→연산교차로,2023.8.29 14:00,342,0,486,828,0
부산시청→연산교차로,2023.8.29 14:00,568,433,285,1286,0
사직운동장→연산교차로,2023.8.29 14:00,196,649,92,937,0
신리→연산교차로,2023.8.29 14:00,442,270,65,777,0
안락→연산교차로,2023.8.29 14:00,432,0,125,557,0
연산터널→연산교차로,2023.8.29 14:00,250,273,51,574,0
교대→연산교차로,2023.8.29 15:00,346,0,513,859,0
부산시청→연산교차로,2023.8.29 15:00,599,468,298,1365,0
사직운동장→연산교차로,2023.8.29 15:00,223,662,75,960,0
신리→연산교차로,2023.8.29 15:00,472,288,58,818,0
안락→연산교차로,2023.8.29 15:00,421,0,132,553,0
연산터널→연산교차로,2023.8.29 15:00,258,259,55,572,0
교대→연산교차로,2023.8.29 16:00,327,0,485,812,0
부산시청→연산교차로,2023.8.29 16:00,542,519,316,1377,0
사직운동장→연산교차로,2023.8.29 16:00,205,655,54,914,0
신리→연산교차로,2023.8.29 16:00,483,276,40,799,0
안락→연산교차로,2023.8.29 16:00,401,0,105,506,0
연산터널→연산교차로,2023.8.29 16:00,234,261,49,544,0
교대→연산교차로,2023.8.29 17:00,349,0,520,869,0
부산시청→연산교차로,2023.8.29 17:00,587,551,295,1433,0
사직운동장→연산교차로,2023.8.29 17:00,210,695,34,939,0
신리→연산교차로,2023.8.29 17:00,488,298,53,839,0
안락→연산교차로,2023.8.29 17:00,423,0,132,555,0
연산터널→연산교차로,2023.8.29 17:00,228,276,44,548,0
교대→연산교차로,2023.8.29 18:00,348,0,507,855,0
부산시청→연산교차로,2023.8.29 18:00,568,560,325,1453,0
사직운동장→연산교차로,2023.8.29 18:00,236,647,35,918,0
신리→연산교차로,2023.8.29 18:00,485,266,48,799,0
안락→연산교차로,2023.8.29 18:00,434,0,84,518,0
연산터널→연산교차로,2023.8.29 18:00,225,284,47,556,0
교대→연산교차로,2023.8.29 19:00,333,0,435,768,0
부산시청→연산교차로,2023.8.29 19:00,511,423,286,1220,0
사직운동장→연산교차로,2023.8.29 19:00,209,549,57,815,0
신리→연산교차로,2023.8.29 19:00,324,222,30,576,0
안락→연산교차로,2023.8.29 19:00,414,0,88,502,0
연산터널→연산교차로,2023.8.29 19:00,226,264,38,528,0
교대→연산교차로,2023.8.29 20:00,297,0,321,618,0
부산시청→연산교차로,2023.8.29 20:00,474,346,228,1048,0
사직운동장→연산교차로,2023.8.29 20:00,146,516,74,736,0
신리→연산교차로,2023.8.29 20:00,304,176,31,511,0
안락→연산교차로,2023.8.29 20:00,399,0,90,489,0
연산터널→연산교차로,2023.8.29 20:00,221,227,56,504,0
교대→연산교차로,2023.8.29 21:00,255,0,266,521,0
부산시청→연산교차로,2023.8.29 21:00,428,292,215,935,0
사직운동장→연산교차로,2023.8.29 21:00,156,422,47,625,0
신리→연산교차로,2023.8.29 21:00,288,165,30,483,0
안락→연산교차로,2023.8.29 21:00,390,0,87,477,0
연산터널→연산교차로,2023.8.29 21:00,233,285,51,569,0
교대→연산교차로,2023.8.29 22:00,227,0,228,455,0
부산시청→연산교차로,2023.8.29 22:00,383,268,125,776,0
사직운동장→연산교차로,2023.8.29 22:00,144,352,52,548,0
신리→연산교차로,2023.8.29 22:00,230,147,26,403,0
안락→연산교차로,2023.8.29 22:00,303,0,76,379,0
연산터널→연산교차로,2023.8.29 22:00,198,200,56,454,0
교대→연산교차로,2023.8.29 23:00,145,0,190,335,0
부산시청→연산교차로,2023.8.29 23:00,325,217,111,653,0
사직운동장→연산교차로,2023.8.29 23:00,101,272,33,406,0
신리→연산교차로,2023.8.29 23:00,189,123,27,339,0
안락→연산교차로,2023.8.29 23:00,239,0,68,307,0
연산터널→연산교차로,2023.8.29 23:00,115,168,63,346,0
교대→연산교차로,2023.8.30 00:00,121,0,162,283,0
부산시청→연산교차로,2023.8.30 00:00,213,138,84,435,0
사직운동장→연산교차로,2023.8.30 00:00,66,235,34,335,0
신리→연산교차로,2023.8.30 00:00,167,95,19,281,0
안락→연산교차로,2023.8.30 00:00,192,0,60,252,0
연산터널→연산교차로,2023.8.30 00:00,152,176,61,389,0
교대→연산교차로,2023.8.30 01:00,92,0,164,256,0
부산시청→연산교차로,2023.8.30 01:00,175,92,66,333,0
사직운동장→연산교차로,2023.8.30 01:00,43,154,14,211,0
신리→연산교차로,2023.8.30 01:00,103,68,13,184,0
안락→연산교차로,2023.8.30 01:00,153,0,42,195,0
연산터널→연산교차로,2023.8.30 01:00,118,125,60,303,0
교대→연산교차로,2023.8.30 02:00,75,0,109,184,0
부산시청→연산교차로,2023.8.30 02:00,138,75,59,272,0
사직운동장→연산교차로,2023.8.30 02:00,47,144,8,199,0
신리→연산교차로,2023.8.30 02:00,74,52,11,137,0
안락→연산교차로,2023.8.30 02:00,112,0,25,137,0
연산터널→연산교차로,2023.8.30 02:00,79,92,40,211,0
교대→연산교차로,2023.8.30 03:00,63,0,107,170,0
부산시청→연산교차로,2023.8.30 03:00,148,70,34,252,0
사직운동장→연산교차로,2023.8.30 03:00,27,121,3,151,0
신리→연산교차로,2023.8.30 03:00,67,38,8,113,0
안락→연산교차로,2023.8.30 03:00,106,0,28,134,0
연산터널→연산교차로,2023.8.30 03:00,62,108,34,204,0
교대→연산교차로,2023.8.30 04:00,46,0,60,106,0
부산시청→연산교차로,2023.8.30 04:00,145,72,40,257,0
사직운동장→연산교차로,2023.8.30 04:00,38,94,3,135,0
신리→연산교차로,2023.8.30 04:00,84,47,7,138,0
안락→연산교차로,2023.8.30 04:00,166,0,31,197,0
연산터널→연산교차로,2023.8.30 04:00,87,72,17,176,0
교대→연산교차로,2023.8.30 05:00,76,0,97,173,0
부산시청→연산교차로,2023.8.30 05:00,193,152,63,408,0
사직운동장→연산교차로,2023.8.30 05:00,50,160,16,226,0
신리→연산교차로,2023.8.30 05:00,186,97,9,292,0
안락→연산교차로,2023.8.30 05:00,293,0,50,343,0
연산터널→연산교차로,2023.8.30 05:00,120,116,19,255,0
교대→연산교차로,2023.8.30 06:00,163,0,232,395,0
부산시청→연산교차로,2023.8.30 06:00,346,254,114,714,0
사직운동장→연산교차로,2023.8.30 06:00,93,287,32,412,0
신리→연산교차로,2023.8.30 06:00,304,194,27,525,0
안락→연산교차로,2023.8.30 06:00,455,0,86,541,0
연산터널→연산교차로,2023.8.30 06:00,233,229,44,506,0
교대→연산교차로,2023.8.30 07:00,261,0,387,648,0
부산시청→연산교차로,2023.8.30 07:00,523,379,217,1119,0
사직운동장→연산교차로,2023.8.30 07:00,181,511,60,752,0
신리→연산교차로,2023.8.30 07:00,461,274,24,759,0
안락→연산교차로,2023.8.30 07:00,607,0,84,691,0
연산터널→연산교차로,2023.8.30 07:00,311,373,41,725,0
교대→연산교차로,2023.8.30 08:00,319,0,521,840,0
부산시청→연산교차로,2023.8.30 08:00,567,432,331,1330,0
사직운동장→연산교차로,2023.8.30 08:00,199,657,59,915,0
신리→연산교차로,2023.8.30 08:00,512,344,21,877,0
안락→연산교차로,2023.8.30 08:00,606,0,108,714,0
연산터널→연산교차로,2023.8.30 08:00,328,378,33,739,0
교대→연산교차로,2023.8.30 09:00,276,0,501,777,0
부산시청→연산교차로,2023.8.30 09:00,504,386,280,1170,0
사직운동장→연산교차로,2023.8.30 09:00,178,601,86,865,0
신리→연산교차로,2023.8.30 09:00,454,316,38,808,0
안락→연산교차로,2023.8.30 09:00,568,0,107,675,0
연산터널→연산교차로,2023.8.30 09:00,292,365,48,705,0
교대→연산교차로,2023.8.30 10:00,301,0,495,796,0
부산시청→연산교차로,2023.8.30 10:00,515,362,268,1145,0
사직운동장→연산교차로,2023.8.30 10:00,201,594,72,867,0
신리→연산교차로,2023.8.30 10:00,439,267,61,767,0
안락→연산교차로,2023.8.30 10:00,559,0,165,724,0
연산터널→연산교차로,2023.8.30 10:00,282,327,43,652,0
교대→연산교차로,2023.8.30 11:00,293,0,441,734,0
부산시청→연산교차로,2023.8.30 11:00,588,386,266,1240,0
사직운동장→연산교차로,2023.8.30 11:00,183,588,70,841,0
신리→연산교차로,2023.8.30 11:00,461,244,51,756,0
안락→연산교차로,2023.8.30 11:00,516,0,155,671,0
연산터널→연산교차로,2023.8.30 11:00,271,325,56,652,0
교대→연산교차로,2023.8.30 12:00,284,0,398,682,0
부산시청→연산교차로,2023.8.30 12:00,539,380,237,1156,0
사직운동장→연산교차로,2023.8.30 12:00,187,560,48,795,0
신리→연산교차로,2023.8.30 12:00,420,249,51,720,0
안락→연산교차로,2023.8.30 12:00,456,0,142,598,0
연산터널→연산교차로,2023.8.30 12:00,245,304,51,600,0
교대→연산교차로,2023.8.30 13:00,333,0,419,752,0
부산시청→연산교차로,2023.8.30 13:00,509,421,247,1177,0
사직운동장→연산교차로,2023.8.30 13:00,219,576,84,879,0
신리→연산교차로,2023.8.30 13:00,435,282,51,768,0
안락→연산교차로,2023.8.30 13:00,440,0,129,569,0
연산터널→연산교차로,2023.8.30 13:00,261,259,39,559,0
교대→연산교차로,2023.8.30 14:00,327,0,462,789,0
부산시청→연산교차로,2023.8.30 14:00,563,419,254,1236,0
사직운동장→연산교차로,2023.8.30 14:00,228,622,85,935,0
신리→연산교차로,2023.8.30 14:00,453,255,73,781,0
안락→연산교차로,2023.8.30 14:00,436,0,141,577,0
연산터널→연산교차로,2023.8.30 14:00,260,266,68,594,0
교대→연산교차로,2023.8.30 15:00,353,0,478,831,0
부산시청→연산교차로,2023.8.30 15:00,577,507,301,1385,0
사직운동장→연산교차로,2023.8.30 15:00,245,623,83,951,0
신리→연산교차로,2023.8.30 15:00,500,264,50,814,0
안락→연산교차로,2023.8.30 15:00,438,0,133,571,0
연산터널→연산교차로,2023.8.30 15:00,240,281,48,569,0
교대→연산교차로,2023.8.30 16:00,372,0,519,891,0
부산시청→연산교차로,2023.8.30 16:00,583,514,315,1412,0
사직운동장→연산교차로,2023.8.30 16:00,244,650,52,946,0
신리→연산교차로,2023.8.30 16:00,520,285,45,850,0
안락→연산교차로,2023.8.30 16:00,451,0,134,585,0
연산터널→연산교차로,2023.8.30 16:00,267,268,53,588,0
교대→연산교차로,2023.8.30 17:00,384,0,553,937,0
부산시청→연산교차로,2023.8.30 17:00,603,582,336,1521,0
사직운동장→연산교차로,2023.8.30 17:00,220,727,48,995,0
신리→연산교차로,2023.8.30 17:00,494,297,54,845,0
안락→연산교차로,2023.8.30 17:00,456,0,109,565,0
연산터널→연산교차로,2023.8.30 17:00,224,287,32,543,0
교대→연산교차로,2023.8.30 18:00,368,0,521,889,0
부산시청→연산교차로,2023.8.30 18:00,616,556,333,1505,0
사직운동장→연산교차로,2023.8.30 18:00,231,698,47,976,0
신리→연산교차로,2023.8.30 18:00,507,280,37,824,0
안락→연산교차로,2023.8.30 18:00,460,0,99,559,0
연산터널→연산교차로,2023.8.30 18:00,255,257,45,557,0
교대→연산교차로,2023.8.30 19:00,296,0,418,714,0
부산시청→연산교차로,2023.8.30 19:00,519,446,283,1248,0
사직운동장→연산교차로,2023.8.30 19:00,199,605,58,862,0
신리→연산교차로,2023.8.30 19:00,385,222,48,655,0
안락→연산교차로,2023.8.30 19:00,411,0,104,515,0
연산터널→연산교차로,2023.8.30 19:00,219,258,64,541,0
교대→연산교차로,2023.8.30 20:00,284,0,343,627,0
부산시청→연산교차로,2023.8.30 20:00,453,361,249,1063,0
사직운동장→연산교차로,2023.8.30 20:00,154,525,91,770,0
신리→연산교차로,2023.8.30 20:00,303,195,28,526,0
안락→연산교차로,2023.8.30 20:00,400,0,99,499,0
연산터널→연산교차로,2023.8.30 20:00,226,245,55,526,0
교대→연산교차로,2023.8.30 21:00,290,0,313,603,0
부산시청→연산교차로,2023.8.30 21:00,468,331,184,983,0
사직운동장→연산교차로,2023.8.30 21:00,131,442,76,649,0
신리→연산교차로,2023.8.30 21:00,308,174,24,506,0
안락→연산교차로,2023.8.30 21:00,395,0,86,481,0
연산터널→연산교차로,2023.8.30 21:00,220,257,74,551,0
교대→연산교차로,2023.8.30 22:00,244,0,218,462,0
부산시청→연산교차로,2023.8.30 22:00,404,276,182,862,0
사직운동장→연산교차로,2023.8.30 22:00,138,350,54,542,0
신리→연산교차로,2023.8.30 22:00,282,175,37,494,0
안락→연산교차로,2023.8.30 22:00,363,0,91,454,0
연산터널→연산교차로,2023.8.30 22:00,211,234,60,505,0
교대→연산교차로,2023.8.30 23:00,176,0,224,400,0
부산시청→연산교차로,2023.8.30 23:00,322,186,117,625,0
사직운동장→연산교차로,2023.8.30 23:00,121,303,48,472,0
신리→연산교차로,2023.8.30 23:00,198,126,22,346,0
안락→연산교차로,2023.8.30 23:00,262,0,81,343,0
연산터널→연산교차로,2023.8.30 23:00,150,199,63,412,0
교대→연산교차로,2023.8.31 00:00,164,0,212,376,0
부산시청→연산교차로,2023.8.31 00:00,240,161,124,525,0
사직운동장→연산교차로,2023.8.31 00:00,91,270,29,390,0
신리→연산교차로,2023.8.31 00:00,177,103,21,301,0
안락→연산교차로,2023.8.31 00:00,215,0,59,274,0
연산터널→연산교차로,2023.8.31 00:00,149,188,58,395,0
교대→연산교차로,2023.8.31 01:00,120,0,168,288,0
부산시청→연산교차로,2023.8.31 01:00,214,126,75,415,0
사직운동장→연산교차로,2023.8.31 01:00,49,208,11,268,0
신리→연산교차로,2023.8.31 01:00,104,90,12,206,0
안락→연산교차로,2023.8.31 01:00,159,0,47,206,0
연산터널→연산교차로,2023.8.31 01:00,123,151,42,316,0
교대→연산교차로,2023.8.31 02:00,76,0,136,212,0
부산시청→연산교차로,2023.8.31 02:00,170,88,46,304,0
사직운동장→연산교차로,2023.8.31 02:00,38,157,11,206,0
신리→연산교차로,2023.8.31 02:00,74,40,13,127,0
안락→연산교차로,2023.8.31 02:00,135,0,23,158,0
연산터널→연산교차로,2023.8.31 02:00,81,100,28,209,0
교대→연산교차로,2023.8.31 03:00,63,0,120,183,0
부산시청→연산교차로,2023.8.31 03:00,144,68,51,263,0
사직운동장→연산교차로,2023.8.31 03:00,33,142,6,181,0
신리→연산교차로,2023.8.31 03:00,65,33,12,110,0
안락→연산교차로,2023.8.31 03:00,130,0,31,161,0
연산터널→연산교차로,2023.8.31 03:00,67,98,31,196,0
교대→연산교차로,2023.8.31 04:00,68,0,81,149,0
부산시청→연산교차로,2023.8.31 04:00,161,69,55,285,0
사직운동장→연산교차로,2023.8.31 04:00,36,128,5,169,0
신리→연산교차로,2023.8.31 04:00,99,61,12,172,0
안락→연산교차로,2023.8.31 04:00,161,0,36,197,0
연산터널→연산교차로,2023.8.31 04:00,80,88,24,192,0
교대→연산교차로,2023.8.31 05:00,83,0,129,212,0
부산시청→연산교차로,2023.8.31 05:00,212,138,59,409,0
사직운동장→연산교차로,2023.8.31 05:00,50,153,17,220,0
신리→연산교차로,2023.8.31 05:00,180,96,9,285,0
안락→연산교차로,2023.8.31 05:00,313,0,54,367,0
연산터널→연산교차로,2023.8.31 05:00,119,138,21,278,0
교대→연산교차로,2023.8.31 06:00,167,0,215,382,0
부산시청→연산교차로,2023.8.31 06:00,374,258,118,750,0
사직운동장→연산교차로,2023.8.31 06:00,100,284,27,411,0
신리→연산교차로,2023.8.31 06:00,330,194,20,544,0
안락→연산교차로,2023.8.31 06:00,484,0,88,572,0
연산터널→연산교차로,2023.8.31 06:00,223,228,37,488,0
교대→연산교차로,2023.8.31 07:00,252,0,394,646,0
부산시청→연산교차로,2023.8.31 07:00,538,364,194,1096,0
사직운동장→연산교차로,2023.8.31 07:00,190,482,52,724,0
신리→연산교차로,2023.8.31 07:00,434,267,35,736,0
안락→연산교차로,2023.8.31 07:00,643,0,71,714,0
연산터널→연산교차로,2023.8.31 07:00,285,369,35,689,0
교대→연산교차로,2023.8.31 08:00,306,0,464,770,0
부산시청→연산교차로,2023.8.31 08:00,539,429,322,1290,0
사직운동장→연산교차로,2023.8.31 08:00,190,646,66,902,0
신리→연산교차로,2023.8.31 08:00,459,342,27,828,0
안락→연산교차로,2023.8.31 08:00,623,0,109,732,0
연산터널→연산교차로,2023.8.31 08:00,322,371,18,711,0
교대→연산교차로,2023.8.31 09:00,274,0,451,725,0
부산시청→연산교차로,2023.8.31 09:00,479,333,259,1071,0
사직운동장→연산교차로,2023.8.31 09:00,172,570,62,804,0
신리→연산교차로,2023.8.31 09:00,427,335,37,799,0
안락→연산교차로,2023.8.31 09:00,551,0,106,657,0
연산터널→연산교차로,2023.8.31 09:00,283,353,41,677,0
교대→연산교차로,2023.8.31 10:00,295,0,453,748,0
부산시청→연산교차로,2023.8.31 10:00,567,368,258,1193,0
사직운동장→연산교차로,2023.8.31 10:00,189,577,76,842,0
신리→연산교차로,2023.8.31 10:00,461,282,58,801,0
안락→연산교차로,2023.8.31 10:00,542,0,139,681,0
연산터널→연산교차로,2023.8.31 10:00,281,308,47,636,0
교대→연산교차로,2023.8.31 11:00,239,0,374,613,0
부산시청→연산교차로,2023.8.31 11:00,456,283,212,951,0
사직운동장→연산교차로,2023.8.31 11:00,171,444,56,671,0
신리→연산교차로,2023.8.31 11:00,360,203,54,617,0
안락→연산교차로,2023.8.31 11:00,414,0,151,565,0
연산터널→연산교차로,2023.8.31 11:00,226,225,48,499,0
교대→연산교차로,2023.8.31 12:00,283,0,392,675,0
부산시청→연산교차로,2023.8.31 12:00,516,348,230,1094,0
사직운동장→연산교차로,2023.8.31 12:00,190,513,71,774,0
신리→연산교차로,2023.8.31 12:00,397,240,54,691,0
안락→연산교차로,2023.8.31 12:00,467,0,152,619,0
연산터널→연산교차로,2023.8.31 12:00,260,257,43,560,0
교대→연산교차로,2023.8.31 13:00,256,0,322,578,0
부산시청→연산교차로,2023.8.31 13:00,393,335,190,918,0
사직운동장→연산교차로,2023.8.31 13:00,177,453,64,694,0
신리→연산교차로,2023.8.31 13:00,323,203,34,560,0
안락→연산교차로,2023.8.31 13:00,325,0,88,413,0
연산터널→연산교차로,2023.8.31 13:00,166,183,30,379,0
교대→연산교차로,2023.8.31 14:00,324,0,466,790,0
부산시청→연산교차로,2023.8.31 14:00,576,418,285,1279,0
사직운동장→연산교차로,2023.8.31 14:00,216,632,83,931,0
신리→연산교차로,2023.8.31 14:00,474,260,64,798,0
안락→연산교차로,2023.8.31 14:00,432,0,97,529,0
연산터널→연산교차로,2023.8.31 14:00,234,282,40,556,0
교대→연산교차로,2023.8.31 15:00,343,0,508,851,0
부산시청→연산교차로,2023.8.31 15:00,558,488,313,1359,0
사직운동장→연산교차로,2023.8.31 15:00,218,622,68,908,0
신리→연산교차로,2023.8.31 15:00,444,262,49,755,0
안락→연산교차로,2023.8.31 15:00,424,0,113,537,0
연산터널→연산교차로,2023.8.31 15:00,233,274,41,548,0
교대→연산교차로,2023.8.31 16:00,348,0,517,865,0
부산시청→연산교차로,2023.8.31 16:00,604,509,285,1398,0
사직운동장→연산교차로,2023.8.31 16:00,225,637,64,926,0
신리→연산교차로,2023.8.31 16:00,498,269,53,820,0
안락→연산교차로,2023.8.31 16:00,419,0,115,534,0
연산터널→연산교차로,2023.8.31 16:00,246,275,35,556,0
교대→연산교차로,2023.8.31 17:00,295,0,417,712,0
부산시청→연산교차로,2023.8.31 17:00,441,406,250,1097,0
사직운동장→연산교차로,2023.8.31 17:00,170,531,25,726,0
신리→연산교차로,2023.8.31 17:00,362,220,33,615,0
안락→연산교차로,2023.8.31 17:00,329,0,103,432,0
연산터널→연산교차로,2023.8.31 17:00,187,204,44,435,0
교대→연산교차로,2023.8.31 18:00,369,0,535,904,0
부산시청→연산교차로,2023.8.31 18:00,595,560,338,1493,0
사직운동장→연산교차로,2023.8.31 18:00,208,688,43,939,0
신리→연산교차로,2023.8.31 18:00,492,279,39,810,0
안락→연산교차로,2023.8.31 18:00,459,0,116,575,0
연산터널→연산교차로,2023.8.31 18:00,248,269,42,559,0
교대→연산교차로,2023.8.31 19:00,326,0,429,755,0
부산시청→연산교차로,2023.8.31 19:00,523,457,290,1270,0
사직운동장→연산교차로,2023.8.31 19:00,182,586,36,804,0
신리→연산교차로,2023.8.31 19:00,392,236,19,647,0
안락→연산교차로,2023.8.31 19:00,405,0,89,494,0
연산터널→연산교차로,2023.8.31 19:00,220,269,30,519,0
교대→연산교차로,2023.8.31 20:00,304,0,282,586,0
부산시청→연산교차로,2023.8.31 20:00,477,421,222,1120,0
사직운동장→연산교차로,2023.8.31 20:00,180,508,63,751,0
신리→연산교차로,2023.8.31 20:00,335,202,28,565,0
안락→연산교차로,2023.8.31 20:00,394,0,108,502,0
연산터널→연산교차로,2023.8.31 20:00,223,245,32,500,0
교대→연산교차로,2023.8.31 21:00,262,0,300,562,0
부산시청→연산교차로,2023.8.31 21:00,408,338,189,935,0
사직운동장→연산교차로,2023.8.31 21:00,185,471,21,677,0
신리→연산교차로,2023.8.31 21:00,281,191,26,498,0
안락→연산교차로,2023.8.31 21:00,360,0,112,472,0
연산터널→연산교차로,2023.8.31 21:00,210,250,49,509,0
교대→연산교차로,2023.8.31 22:00,224,0,194,418,0
부산시청→연산교차로,2023.8.31 22:00,401,286,175,862,0
사직운동장→연산교차로,2023.8.31 22:00,150,336,16,502,0
신리→연산교차로,2023.8.31 22:00,256,169,25,450,0
안락→연산교차로,2023.8.31 22:00,324,0,79,403,0
연산터널→연산교차로,2023.8.31 22:00,206,225,22,453,0
교대→연산교차로,2023.8.31 23:00,187,0,164,351,0
부산시청→연산교차로,2023.8.31 23:00,305,226,133,664,0
사직운동장→연산교차로,2023.8.31 23:00,111,256,15,382,0
신리→연산교차로,2023.8.31 23:00,196,130,14,340,0
안락→연산교차로,2023.8.31 23:00,270,0,63,333,0
연산터널→연산교차로,2023.8.31 23:00,156,168,18,342,0
교대→연산교차로,2023.9.1 00:00,134,0,133,267,0
부산시청→연산교차로,2023.9.1 00:00,231,150,75,456,0
사직운동장→연산교차로,2023.9.1 00:00,72,184,3,259,0
신리→연산교차로,2023.9.1 00:00,151,101,9,261,0
안락→연산교차로,2023.9.1 00:00,197,0,50,247,0
연산터널→연산교차로,2023.9.1 00:00,115,139,10,264,0
교대→연산교차로,2023.9.1 01:00,92,0,145,237,0
부산시청→연산교차로,2023.9.1 01:00,175,151,70,396,0
사직운동장→연산교차로,2023.9.1 01:00,65,152,2,219,0
신리→연산교차로,2023.9.1 01:00,117,68,4,189,0
안락→연산교차로,2023.9.1 01:00,188,0,34,222,0
연산터널→연산교차로,2023.9.1 01:00,91,132,16,239,0
교대→연산교차로,2023.9.1 02:00,80,0,115,195,0
부산시청→연산교차로,2023.9.1 02:00,162,102,49,313,0
사직운동장→연산교차로,2023.9.1 02:00,44,146,2,192,0
신리→연산교차로,2023.9.1 02:00,91,50,14,155,0
안락→연산교차로,2023.9.1 02:00,132,0,46,178,0
연산터널→연산교차로,2023.9.1 02:00,82,106,16,204,0
교대→연산교차로,2023.9.1 03:00,51,0,108,159,0
부산시청→연산교차로,2023.9.1 03:00,142,67,38,247,0
사직운동장→연산교차로,2023.9.1 03:00,29,140,0,169,0
신리→연산교차로,2023.9.1 03:00,55,36,5,96,0
안락→연산교차로,2023.9.1 03:00,122,0,29,151,0
연산터널→연산교차로,2023.9.1 03:00,52,87,12,151,0
교대→연산교차로,2023.9.1 04:00,48,0,75,123,0
부산시청→연산교차로,2023.9.1 04:00,143,81,32,256,0
사직운동장→연산교차로,2023.9.1 04:00,33,125,1,159,0
신리→연산교차로,2023.9.1 04:00,85,42,5,132,0
안락→연산교차로,2023.9.1 04:00,143,0,21,164,0
연산터널→연산교차로,2023.9.1 04:00,63,74,18,155,0
교대→연산교차로,2023.9.1 05:00,80,0,92,172,0
부산시청→연산교차로,2023.9.1 05:00,190,145,45,380,0
사직운동장→연산교차로,2023.9.1 05:00,55,147,2,204,0
신리→연산교차로,2023.9.1 05:00,167,76,7,250,0
안락→연산교차로,2023.9.1 05:00,239,0,35,274,0
연산터널→연산교차로,2023.9.1 05:00,105,109,13,227,0
교대→연산교차로,2023.9.1 06:00,179,0,214,393,0
부산시청→연산교차로,2023.9.1 06:00,345,266,132,743,0
사직운동장→연산교차로,2023.9.1 06:00,109,306,34,449,0
신리→연산교차로,2023.9.1 06:00,339,184,15,538,0
안락→연산교차로,2023.9.1 06:00,435,0,100,535,0
연산터널→연산교차로,2023.9.1 06:00,219,206,39,464,0
교대→연산교차로,2023.9.1 07:00,272,0,380,652,0
부산시청→연산교차로,2023.9.1 07:00,522,383,221,1126,0
사직운동장→연산교차로,2023.9.1 07:00,188,500,55,743,0
신리→연산교차로,2023.9.1 07:00,456,293,27,776,0
안락→연산교차로,2023.9.1 07:00,607,0,90,697,0
연산터널→연산교차로,2023.9.1 07:00,301,362,47,710,0
교대→연산교차로,2023.9.1 08:00,327,0,496,823,0
부산시청→연산교차로,2023.9.1 08:00,581,421,308,1310,0
사직운동장→연산교차로,2023.9.1 08:00,197,660,42,899,0
신리→연산교차로,2023.9.1 08:00,501,344,28,873,0
안락→연산교차로,2023.9.1 08:00,628,0,107,735,0
연산터널→연산교차로,2023.9.1 08:00,319,398,26,743,0
교대→연산교차로,2023.9.1 09:00,284,0,548,832,0
부산시청→연산교차로,2023.9.1 09:00,488,380,253,1121,0
사직운동장→연산교차로,2023.9.1 09:00,188,593,65,846,0
신리→연산교차로,2023.9.1 09:00,442,337,39,818,0
안락→연산교차로,2023.9.1 09:00,596,0,99,695,0
연산터널→연산교차로,2023.9.1 09:00,284,377,40,701,0
교대→연산교차로,2023.9.1 10:00,273,0,492,765,0
부산시청→연산교차로,2023.9.1 10:00,558,382,264,1204,0
사직운동장→연산교차로,2023.9.1 10:00,192,570,69,831,0
신리→연산교차로,2023.9.1 10:00,438,318,63,819,0
안락→연산교차로,2023.9.1 10:00,527,0,135,662,0
연산터널→연산교차로,2023.9.1 10:00,276,340,53,669,0
교대→연산교차로,2023.9.1 11:00,278,0,470,748,0
부산시청→연산교차로,2023.9.1 11:00,545,368,274,1187,0
사직운동장→연산교차로,2023.9.1 11:00,192,543,72,807,0
신리→연산교차로,2023.9.1 11:00,438,279,55,772,0
안락→연산교차로,2023.9.1 11:00,501,0,180,681,0
연산터널→연산교차로,2023.9.1 11:00,262,314,61,637,0
교대→연산교차로,2023.9.1 12:00,303,0,426,729,0
부산시청→연산교차로,2023.9.1 12:00,547,357,225,1129,0
사직운동장→연산교차로,2023.9.1 12:00,205,531,53,789,0
신리→연산교차로,2023.9.1 12:00,453,247,47,747,0
안락→연산교차로,2023.9.1 12:00,481,0,147,628,0
연산터널→연산교차로,2023.9.1 12:00,268,295,41,604,0
교대→연산교차로,2023.9.1 13:00,328,0,478,806,0
부산시청→연산교차로,2023.9.1 13:00,546,470,271,1287,0
사직운동장→연산교차로,2023.9.1 13:00,233,581,80,894,0
신리→연산교차로,2023.9.1 13:00,447,307,59,813,0
안락→연산교차로,2023.9.1 13:00,425,0,102,527,0
연산터널→연산교차로,2023.9.1 13:00,253,255,46,554,0
교대→연산교차로,2023.9.1 14:00,325,0,468,793,0
부산시청→연산교차로,2023.9.1 14:00,554,470,265,1289,0
사직운동장→연산교차로,2023.9.1 14:00,213,574,70,857,0
신리→연산교차로,2023.9.1 14:00,473,272,63,808,0
안락→연산교차로,2023.9.1 14:00,417,0,113,530,0
연산터널→연산교차로,2023.9.1 14:00,220,261,38,519,0
교대→연산교차로,2023.9.1 15:00,338,0,475,813,0
부산시청→연산교차로,2023.9.1 15:00,560,474,308,1342,0
사직운동장→연산교차로,2023.9.1 15:00,204,632,61,897,0
신리→연산교차로,2023.9.1 15:00,490,264,61,815,0
안락→연산교차로,2023.9.1 15:00,413,0,136,549,0
연산터널→연산교차로,2023.9.1 15:00,235,274,50,559,0
교대→연산교차로,2023.9.1 16:00,340,0,475,815,0
부산시청→연산교차로,2023.9.1 16:00,569,501,328,1398,0
사직운동장→연산교차로,2023.9.1 16:00,220,650,39,909,0
신리→연산교차로,2023.9.1 16:00,467,303,42,812,0
안락→연산교차로,2023.9.1 16:00,432,0,99,531,0
연산터널→연산교차로,2023.9.1 16:00,230,259,60,549,0
교대→연산교차로,2023.9.1 17:00,346,0,525,871,0
부산시청→연산교차로,2023.9.1 17:00,574,563,322,1459,0
사직운동장→연산교차로,2023.9.1 17:00,208,704,42,954,0
신리→연산교차로,2023.9.1 17:00,507,291,47,845,0
안락→연산교차로,2023.9.1 17:00,423,0,110,533,0
연산터널→연산교차로,2023.9.1 17:00,233,280,48,561,0
교대→연산교차로,2023.9.1 18:00,361,0,555,916,0
부산시청→연산교차로,2023.9.1 18:00,608,557,278,1443,0
사직운동장→연산교차로,2023.9.1 18:00,217,673,30,920,0
신리→연산교차로,2023.9.1 18:00,532,244,37,813,0
안락→연산교차로,2023.9.1 18:00,426,0,110,536,0
연산터널→연산교차로,2023.9.1 18:00,203,299,48,550,0
교대→연산교차로,2023.9.1 19:00,318,0,405,723,0
부산시청→연산교차로,2023.9.1 19:00,558,510,293,1361,0
사직운동장→연산교차로,2023.9.1 19:00,212,571,4,787,0
신리→연산교차로,2023.9.1 19:00,396,234,17,647,0
안락→연산교차로,2023.9.1 19:00,404,0,77,481,0
연산터널→연산교차로,2023.9.1 19:00,217,247,13,477,0
교대→연산교차로,2023.9.1 20:00,327,0,330,657,0
부산시청→연산교차로,2023.9.1 20:00,478,402,227,1107,0
사직운동장→연산교차로,2023.9.1 20:00,169,536,25,730,0
신리→연산교차로,2023.9.1 20:00,337,180,15,532,0
안락→연산교차로,2023.9.1 20:00,407,0,93,500,0
연산터널→연산교차로,2023.9.1 20:00,214,260,26,500,0
교대→연산교차로,2023.9.1 21:00,286,0,296,582,0
부산시청→연산교차로,2023.9.1 21:00,534,335,210,1079,0
사직운동장→연산교차로,2023.9.1 21:00,177,451,30,658,0
신리→연산교차로,2023.9.1 21:00,304,212,20,536,0
안락→연산교차로,2023.9.1 21:00,406,0,110,516,0
연산터널→연산교차로,2023.9.1 21:00,251,268,57,576,0
교대→연산교차로,2023.9.1 22:00,283,0,246,529,0
부산시청→연산교차로,2023.9.1 22:00,437,294,172,903,0
사직운동장→연산교차로,2023.9.1 22:00,143,376,55,574,0
신리→연산교차로,2023.9.1 22:00,277,192,19,488,0
안락→연산교차로,2023.9.1 22:00,379,0,105,484,0
연산터널→연산교차로,2023.9.1 22:00,246,267,51,564,0
교대→연산교차로,2023.9.1 23:00,219,0,211,430,0
부산시청→연산교차로,2023.9.1 23:00,338,208,160,706,0
사직운동장→연산교차로,2023.9.1 23:00,110,334,49,493,0
신리→연산교차로,2023.9.1 23:00,215,147,22,384,0
안락→연산교차로,2023.9.1 23:00,311,0,88,399,0
연산터널→연산교차로,2023.9.1 23:00,184,213,43,440,0
교대→연산교차로,2023.9.2 00:00,164,0,186,350,0
부산시청→연산교차로,2023.9.2 00:00,287,187,109,583,0
사직운동장→연산교차로,2023.9.2 00:00,98,259,18,375,0
신리→연산교차로,2023.9.2 00:00,218,110,16,344,0
안락→연산교차로,2023.9.2 00:00,243,0,62,305,0
연산터널→연산교차로,2023.9.2 00:00,141,158,27,326,0
교대→연산교차로,2023.9.2 01:00,135,0,158,293,0
부산시청→연산교차로,2023.9.2 01:00,249,154,63,466,0
사직운동장→연산교차로,2023.9.2 01:00,71,221,5,297,0
신리→연산교차로,2023.9.2 01:00,175,86,19,280,0
안락→연산교차로,2023.9.2 01:00,197,0,58,255,0
연산터널→연산교차로,2023.9.2 01:00,134,170,15,319,0
교대→연산교차로,2023.9.2 02:00,101,0,161,262,0
부산시청→연산교차로,2023.9.2 02:00,226,138,72,436,0
사직운동장→연산교차로,2023.9.2 02:00,54,193,12,259,0
신리→연산교차로,2023.9.2 02:00,120,73,11,204,0
안락→연산교차로,2023.9.2 02:00,190,0,50,240,0
연산터널→연산교차로,2023.9.2 02:00,114,166,23,303,0
교대→연산교차로,2023.9.2 03:00,83,0,134,217,0
부산시청→연산교차로,2023.9.2 03:00,207,101,57,365,0
사직운동장→연산교차로,2023.9.2 03:00,48,159,2,209,0
신리→연산교차로,2023.9.2 03:00,81,46,6,133,0
안락→연산교차로,2023.9.2 03:00,150,0,35,185,0
연산터널→연산교차로,2023.9.2 03:00,108,107,9,224,0
교대→연산교차로,2023.9.2 04:00,72,0,95,167,0
부산시청→연산교차로,2023.9.2 04:00,152,97,45,294,0
사직운동장→연산교차로,2023.9.2 04:00,39,145,2,186,0
신리→연산교차로,2023.9.2 04:00,92,52,6,150,0
안락→연산교차로,2023.9.2 04:00,161,0,40,201,0
연산터널→연산교차로,2023.9.2 04:00,93,102,14,209,0
교대→연산교차로,2023.9.2 05:00,95,0,133,228,0
부산시청→연산교차로,2023.9.2 05:00,196,138,70,404,0
사직운동장→연산교차로,2023.9.2 05:00,48,155,12,215,0
신리→연산교차로,2023.9.2 05:00,150,93,7,250,0
안락→연산교차로,2023.9.2 05:00,262,0,58,320,0
연산터널→연산교차로,2023.9.2 05:00,118,124,19,261,0
교대→연산교차로,2023.9.2 06:00,151,0,171,322,0
부산시청→연산교차로,2023.9.2 06:00,333,213,78,624,0
사직운동장→연산교차로,2023.9.2 06:00,74,236,41,351,0
신리→연산교차로,2023.9.2 06:00,271,136,22,429,0
안락→연산교차로,2023.9.2 06:00,355,0,78,433,0
연산터널→연산교차로,2023.9.2 06:00,165,169,33,367,0
교대→연산교차로,2023.9.2 07:00,186,0,216,402,0
부산시청→연산교차로,2023.9.2 07:00,379,220,127,726,0
사직운동장→연산교차로,2023.9.2 07:00,123,342,48,513,0
신리→연산교차로,2023.9.2 07:00,279,147,19,445,0
안락→연산교차로,2023.9.2 07:00,421,0,99,520,0
연산터널→연산교차로,2023.9.2 07:00,178,210,39,427,0
교대→연산교차로,2023.9.2 08:00,261,0,325,586,0
부산시청→연산교차로,2023.9.2 08:00,458,321,245,1024,0
사직운동장→연산교차로,2023.9.2 08:00,156,554,50,760,0
신리→연산교차로,2023.9.2 08:00,408,274,43,725,0
안락→연산교차로,2023.9.2 08:00,509,0,114,623,0
연산터널→연산교차로,2023.9.2 08:00,295,324,41,660,0
교대→연산교차로,2023.9.2 09:00,279,0,378,657,0
부산시청→연산교차로,2023.9.2 09:00,492,374,276,1142,0
사직운동장→연산교차로,2023.9.2 09:00,196,579,59,834,0
신리→연산교차로,2023.9.2 09:00,485,289,68,842,0
안락→연산교차로,2023.9.2 09:00,593,0,141,734,0
연산터널→연산교차로,2023.9.2 09:00,308,321,68,697,0
교대→연산교차로,2023.9.2 10:00,312,0,491,803,0
부산시청→연산교차로,2023.9.2 10:00,527,361,261,1149,0
사직운동장→연산교차로,2023.9.2 10:00,193,621,56,870,0
신리→연산교차로,2023.9.2 10:00,546,296,57,899,0
안락→연산교차로,2023.9.2 10:00,586,0,148,734,0
연산터널→연산교차로,2023.9.2 10:00,318,348,52,718,0
교대→연산교차로,2023.9.2 11:00,326,0,488,814,0
부산시청→연산교차로,2023.9.2 11:00,628,386,275,1289,0
사직운동장→연산교차로,2023.9.2 11:00,211,634,40,885,0
신리→연산교차로,2023.9.2 11:00,529,295,67,891,0
안락→연산교차로,2023.9.2 11:00,566,0,164,730,0
연산터널→연산교차로,2023.9.2 11:00,302,332,57,691,0
교대→연산교차로,2023.9.2 12:00,334,0,511,845,0
부산시청→연산교차로,2023.9.2 12:00,573,391,316,1280,0
사직운동장→연산교차로,2023.9.2 12:00,196,615,51,862,0
신리→연산교차로,2023.9.2 12:00,535,274,66,875,0
안락→연산교차로,2023.9.2 12:00,537,0,175,712,0
연산터널→연산교차로,2023.9.2 12:00,295,356,65,716,0
교대→연산교차로,2023.9.2 13:00,370,0,526,896,0
부산시청→연산교차로,2023.9.2 13:00,599,509,348,1456,0
사직운동장→연산교차로,2023.9.2 13:00,200,674,45,919,0
신리→연산교차로,2023.9.2 13:00,491,295,71,857,0
안락→연산교차로,2023.9.2 13:00,463,0,121,584,0
연산터널→연산교차로,2023.9.2 13:00,246,279,49,574,0
교대→연산교차로,2023.9.2 14:00,339,0,526,865,0
부산시청→연산교차로,2023.9.2 14:00,605,483,330,1418,0
사직운동장→연산교차로,2023.9.2 14:00,216,645,36,897,0
신리→연산교차로,2023.9.2 14:00,499,284,59,842,0
안락→연산교차로,2023.9.2 14:00,448,0,94,542,0
연산터널→연산교차로,2023.9.2 14:00,220,270,41,531,0
교대→연산교차로,2023.9.2 15:00,348,0,493,841,0
부산시청→연산교차로,2023.9.2 15:00,635,503,326,1464,0
사직운동장→연산교차로,2023.9.2 15:00,213,666,41,920,0
신리→연산교차로,2023.9.2 15:00,464,294,64,822,0
안락→연산교차로,2023.9.2 15:00,437,0,104,541,0
연산터널→연산교차로,2023.9.2 15:00,234,275,43,552,0
교대→연산교차로,2023.9.2 16:00,322,0,435,757,0
부산시청→연산교차로,2023.9.2 16:00,561,466,355,1382,0
사직운동장→연산교차로,2023.9.2 16:00,232,640,29,901,0
신리→연산교차로,2023.9.2 16:00,436,297,38,771,0
안락→연산교차로,2023.9.2 16:00,421,0,120,541,0
연산터널→연산교차로,2023.9.2 16:00,243,268,53,564,0
교대→연산교차로,2023.9.2 17:00,353,0,457,810,0
부산시청→연산교차로,2023.9.2 17:00,600,487,349,1436,0
사직운동장→연산교차로,2023.9.2 17:00,229,661,44,934,0
신리→연산교차로,2023.9.2 17:00,432,259,55,746,0
안락→연산교차로,2023.9.2 17:00,455,0,104,559,0
연산터널→연산교차로,2023.9.2 17:00,221,275,39,535,0
교대→연산교차로,2023.9.2 18:00,349,0,371,720,0
부산시청→연산교차로,2023.9.2 18:00,558,486,253,1297,0
사직운동장→연산교차로,2023.9.2 18:00,209,612,53,874,0
신리→연산교차로,2023.9.2 18:00,372,261,33,666,0
안락→연산교차로,2023.9.2 18:00,428,0,106,534,0
연산터널→연산교차로,2023.9.2 18:00,194,276,63,533,0
교대→연산교차로,2023.9.2 19:00,316,0,300,616,0
부산시청→연산교차로,2023.9.2 19:00,506,362,251,1119,0
사직운동장→연산교차로,2023.9.2 19:00,214,504,29,747,0
신리→연산교차로,2023.9.2 19:00,328,246,28,602,0
안락→연산교차로,2023.9.2 19:00,405,0,101,506,0
연산터널→연산교차로,2023.9.2 19:00,225,262,31,518,0
교대→연산교차로,2023.9.2 20:00,290,0,296,586,0
부산시청→연산교차로,2023.9.2 20:00,462,312,225,999,0
사직운동장→연산교차로,2023.9.2 20:00,164,497,76,737,0
신리→연산교차로,2023.9.2 20:00,364,200,21,585,0
안락→연산교차로,2023.9.2 20:00,399,0,124,523,0
연산터널→연산교차로,2023.9.2 20:00,202,262,56,520,0
교대→연산교차로,2023.9.2 21:00,286,0,313,599,0
부산시청→연산교차로,2023.9.2 21:00,465,333,175,973,0
사직운동장→연산교차로,2023.9.2 21:00,151,407,60,618,0
신리→연산교차로,2023.9.2 21:00,302,197,24,523,0
안락→연산교차로,2023.9.2 21:00,403,0,104,507,0
연산터널→연산교차로,2023.9.2 21:00,226,277,53,556,0
교대→연산교차로,2023.9.2 22:00,224,0,261,485,0
부산시청→연산교차로,2023.9.2 22:00,377,247,204,828,0
사직운동장→연산교차로,2023.9.2 22:00,138,337,55,530,0
신리→연산교차로,2023.9.2 22:00,270,168,27,465,0
안락→연산교차로,2023.9.2 22:00,344,0,84,428,0
연산터널→연산교차로,2023.9.2 22:00,205,192,75,472,0
교대→연산교차로,2023.9.2 23:00,178,0,234,412,0
부산시청→연산교차로,2023.9.2 23:00,334,224,99,657,0
사직운동장→연산교차로,2023.9.2 23:00,86,310,38,434,0
신리→연산교차로,2023.9.2 23:00,221,139,22,382,0
안락→연산교차로,2023.9.2 23:00,277,0,65,342,0
연산터널→연산교차로,2023.9.2 23:00,164,193,42,399,0
교대→연산교차로,2023.9.3 00:00,143,0,216,359,1
부산시청→연산교차로,2023.9.3 00:00,302,185,103,590,1
사직운동장→연산교차로,2023.9.3 00:00,79,252,18,349,1
신리→연산교차로,2023.9.3 00:00,196,124,11,331,1
안락→연산교차로,2023.9.3 00:00,235,0,64,299,1
연산터널→연산교차로,2023.9.3 00:00,149,167,36,352,1
교대→연산교차로,2023.9.3 01:00,121,0,208,329,1
부산시청→연산교차로,2023.9.3 01:00,237,185,107,529,1
사직운동장→연산교차로,2023.9.3 01:00,68,194,17,279,1
신리→연산교차로,2023.9.3 01:00,181,112,16,309,1
안락→연산교차로,2023.9.3 01:00,216,0,59,275,1
연산터널→연산교차로,2023.9.3 01:00,152,169,38,359,1
교대→연산교차로,2023.9.3 02:00,128,0,161,289,1
부산시청→연산교차로,2023.9.3 02:00,218,119,80,417,1
사직운동장→연산교차로,2023.9.3 02:00,63,191,7,261,1
신리→연산교차로,2023.9.3 02:00,121,85,10,216,1
안락→연산교차로,2023.9.3 02:00,174,0,33,207,1
연산터널→연산교차로,2023.9.3 02:00,118,167,56,341,1
교대→연산교차로,2023.9.3 03:00,94,0,161,255,1
부산시청→연산교차로,2023.9.3 03:00,190,97,55,342,1
사직운동장→연산교차로,2023.9.3 03:00,46,171,11,228,1
신리→연산교차로,2023.9.3 03:00,112,67,13,192,1
안락→연산교차로,2023.9.3 03:00,125,0,36,161,1
연산터널→연산교차로,2023.9.3 03:00,97,126,30,253,1
교대→연산교차로,2023.9.3 04:00,77,0,110,187,1
부산시청→연산교차로,2023.9.3 04:00,170,90,63,323,1
사직운동장→연산교차로,2023.9.3 04:00,37,104,4,145,1
신리→연산교차로,2023.9.3 04:00,90,46,11,147,1
안락→연산교차로,2023.9.3 04:00,112,0,36,148,1
연산터널→연산교차로,2023.9.3 04:00,78,97,26,201,1
교대→연산교차로,2023.9.3 05:00,66,0,107,173,1
부산시청→연산교차로,2023.9.3 05:00,169,108,48,325,1
사직운동장→연산교차로,2023.9.3 05:00,56,131,14,201,1
신리→연산교차로,2023.9.3 05:00,112,67,10,189,1
안락→연산교차로,2023.9.3 05:00,178,0,43,221,1
연산터널→연산교차로,2023.9.3 05:00,88,105,30,223,1
교대→연산교차로,2023.9.3 06:00,88,0,125,213,1
부산시청→연산교차로,2023.9.3 06:00,225,160,74,459,1
사직운동장→연산교차로,2023.9.3 06:00,52,176,45,273,1
신리→연산교차로,2023.9.3 06:00,171,81,11,263,1
안락→연산교차로,2023.9.3 06:00,242,0,52,294,1
연산터널→연산교차로,2023.9.3 06:00,136,142,30,308,1
교대→연산교차로,2023.9.3 07:00,135,0,134,269,1
부산시청→연산교차로,2023.9.3 07:00,222,174,73,469,1
사직운동장→연산교차로,2023.9.3 07:00,67,210,35,312,1
신리→연산교차로,2023.9.3 07:00,196,85,14,295,1
안락→연산교차로,2023.9.3 07:00,265,0,45,310,1
연산터널→연산교차로,2023.9.3 07:00,121,147,26,294,1
교대→연산교차로,2023.9.3 08:00,173,0,179,352,1
부산시청→연산교차로,2023.9.3 08:00,285,226,113,624,1
사직운동장→연산교차로,2023.9.3 08:00,118,306,46,470,1
신리→연산교차로,2023.9.3 08:00,274,153,28,455,1
안락→연산교차로,2023.9.3 08:00,324,0,83,407,1
연산터널→연산교차로,2023.9.3 08:00,178,156,14,348,1
교대→연산교차로,2023.9.3 09:00,224,0,226,450,1
부산시청→연산교차로,2023.9.3 09:00,379,272,141,792,1
사직운동장→연산교차로,2023.9.3 09:00,133,409,36,578,1
신리→연산교차로,2023.9.3 09:00,353,206,30,589,1
안락→연산교차로,2023.9.3 09:00,411,0,99,510,1
연산터널→연산교차로,2023.9.3 09:00,261,241,30,532,1
교대→연산교차로,2023.9.3 10:00,316,0,340,656,1
부산시청→연산교차로,2023.9.3 10:00,443,314,189,946,1
사직운동장→연산교차로,2023.9.3 10:00,189,555,67,811,1
신리→연산교차로,2023.9.3 10:00,435,209,38,682,1
안락→연산교차로,2023.9.3 10:00,548,0,120,668,1
연산터널→연산교차로,2023.9.3 10:00,267,262,26,555,1
교대→연산교차로,2023.9.3 11:00,249,0,335,584,1
부산시청→연산교차로,2023.9.3 11:00,545,373,203,1121,1
사직운동장→연산교차로,2023.9.3 11:00,185,534,85,804,1
신리→연산교차로,2023.9.3 11:00,418,187,30,635,1
안락→연산교차로,2023.9.3 11:00,542,0,131,673,1
연산터널→연산교차로,2023.9.3 11:00,274,276,41,591,1
교대→연산교차로,2023.9.3 12:00,309,0,361,670,1
부산시청→연산교차로,2023.9.3 12:00,573,377,238,1188,1
사직운동장→연산교차로,2023.9.3 12:00,183,590,49,822,1
신리→연산교차로,2023.9.3 12:00,431,291,36,758,1
안락→연산교차로,2023.9.3 12:00,532,0,114,646,1
연산터널→연산교차로,2023.9.3 12:00,279,269,56,604,1
교대→연산교차로,2023.9.3 13:00,299,0,394,693,1
부산시청→연산교차로,2023.9.3 13:00,610,406,232,1248,1
사직운동장→연산교차로,2023.9.3 13:00,210,596,68,874,1
신리→연산교차로,2023.9.3 13:00,401,303,39,743,1
안락→연산교차로,2023.9.3 13:00,541,0,146,687,1
연산터널→연산교차로,2023.9.3 13:00,281,306,42,629,1
교대→연산교차로,2023.9.3 14:00,306,0,371,677,1
부산시청→연산교차로,2023.9.3 14:00,631,391,268,1290,1
사직운동장→연산교차로,2023.9.3 14:00,215,578,64,857,1
신리→연산교차로,2023.9.3 14:00,473,240,48,761,1
안락→연산교차로,2023.9.3 14:00,542,0,133,675,1
연산터널→연산교차로,2023.9.3 14:00,238,290,47,575,1
교대→연산교차로,2023.9.3 15:00,295,0,341,636,1
부산시청→연산교차로,2023.9.3 15:00,585,378,249,1212,1
사직운동장→연산교차로,2023.9.3 15:00,206,610,58,874,1
신리→연산교차로,2023.9.3 15:00,423,250,38,711,1
안락→연산교차로,2023.9.3 15:00,553,0,134,687,1
연산터널→연산교차로,2023.9.3 15:00,271,275,51,597,1
교대→연산교차로,2023.9.3 16:00,309,0,313,622,1
부산시청→연산교차로,2023.9.3 16:00,643,398,255,1296,1
사직운동장→연산교차로,2023.9.3 16:00,217,581,34,832,1
신리→연산교차로,2023.9.3 16:00,454,227,50,731,1
안락→연산교차로,2023.9.3 16:00,514,0,141,655,1
연산터널→연산교차로,2023.9.3 16:00,244,288,63,595,1
교대→연산교차로,2023.9.3 17:00,312,0,323,635,1
부산시청→연산교차로,2023.9.3 17:00,591,368,229,1188,1
사직운동장→연산교차로,2023.9.3 17:00,256,578,37,871,1
신리→연산교차로,2023.9.3 17:00,411,207,38,656,1
안락→연산교차로,2023.9.3 17:00,544,0,126,670,1
연산터널→연산교차로,2023.9.3 17:00,251,264,56,571,1
교대→연산교차로,2023.9.3 18:00,301,0,343,644,1
부산시청→연산교차로,2023.9.3 18:00,492,304,195,991,1
사직운동장→연산교차로,2023.9.3 18:00,202,504,52,758,1
신리→연산교차로,2023.9.3 18:00,372,220,31,623,1
안락→연산교차로,2023.9.3 18:00,468,0,135,603,1
연산터널→연산교차로,2023.9.3 18:00,237,250,73,560,1
교대→연산교차로,2023.9.3 19:00,294,0,293,587,1
부산시청→연산교차로,2023.9.3 19:00,394,297,170,861,1
사직운동장→연산교차로,2023.9.3 19:00,147,427,58,632,1
신리→연산교차로,2023.9.3 19:00,311,172,33,516,1
안락→연산교차로,2023.9.3 19:00,449,0,115,564,1
연산터널→연산교차로,2023.9.3 19:00,214,247,62,523,1
교대→연산교차로,2023.9.3 20:00,288,0,286,574,1
부산시청→연산교차로,2023.9.3 20:00,403,299,151,853,1
사직운동장→연산교차로,2023.9.3 20:00,143,420,49,612,1
신리→연산교차로,2023.9.3 20:00,346,191,28,565,1
안락→연산교차로,2023.9.3 20:00,399,0,118,517,1
연산터널→연산교차로,2023.9.3 20:00,246,238,44,528,1
교대→연산교차로,2023.9.3 21:00,246,0,218,464,1
부산시청→연산교차로,2023.9.3 21:00,359,270,153,782,1
사직운동장→연산교차로,2023.9.3 21:00,122,324,41,487,1
신리→연산교차로,2023.9.3 21:00,288,153,25,466,1
안락→연산교차로,2023.9.3 21:00,345,0,92,437,1
연산터널→연산교차로,2023.9.3 21:00,192,189,59,440,1
교대→연산교차로,2023.9.3 22:00,198,0,220,418,1
부산시청→연산교차로,2023.9.3 22:00,315,198,136,649,1
사직운동장→연산교차로,2023.9.3 22:00,85,293,73,451,1
신리→연산교차로,2023.9.3 22:00,239,124,26,389,1
안락→연산교차로,2023.9.3 22:00,301,0,80,381,1
연산터널→연산교차로,2023.9.3 22:00,170,160,61,391,1
교대→연산교차로,2023.9.3 23:00,128,0,179,307,1
부산시청→연산교차로,2023.9.3 23:00,221,153,89,463,1
사직운동장→연산교차로,2023.9.3 23:00,59,200,29,288,1
신리→연산교차로,2023.9.3 23:00,149,87,27,263,1
안락→연산교차로,2023.9.3 23:00,193,0,54,247,1
연산터널→연산교차로,2023.9.3 23:00,134,143,69,346,1
교대→연산교차로,2023.9.4 00:00,109,0,137,246,0
부산시청→연산교차로,2023.9.4 00:00,179,111,87,377,0
사직운동장→연산교차로,2023.9.4 00:00,48,160,19,227,0
신리→연산교차로,2023.9.4 00:00,118,71,16,205,0
안락→연산교차로,2023.9.4 00:00,151,0,37,188,0
연산터널→연산교차로,2023.9.4 00:00,107,132,43,282,0
교대→연산교차로,2023.9.4 01:00,103,0,124,227,0
부산시청→연산교차로,2023.9.4 01:00,167,86,66,319,0
사직운동장→연산교차로,2023.9.4 01:00,27,144,5,176,0
신리→연산교차로,2023.9.4 01:00,105,54,8,167,0
안락→연산교차로,2023.9.4 01:00,132,0,30,162,0
연산터널→연산교차로,2023.9.4 01:00,88,92,59,239,0
교대→연산교차로,2023.9.4 02:00,56,0,94,150,0
부산시청→연산교차로,2023.9.4 02:00,143,87,54,284,0
사직운동장→연산교차로,2023.9.4 02:00,28,113,1,142,0
신리→연산교차로,2023.9.4 02:00,76,36,13,125,0
안락→연산교차로,2023.9.4 02:00,95,0,26,121,0
연산터널→연산교차로,2023.9.4 02:00,74,88,39,201,0
교대→연산교차로,2023.9.4 03:00,42,0,82,124,0
부산시청→연산교차로,2023.9.4 03:00,129,69,38,236,0
사직운동장→연산교차로,2023.9.4 03:00,16,99,2,117,0
신리→연산교차로,2023.9.4 03:00,70,32,7,109,0
안락→연산교차로,2023.9.4 03:00,84,0,23,107,0
연산터널→연산교차로,2023.9.4 03:00,51,81,33,165,0
교대→연산교차로,2023.9.4 04:00,49,0,65,114,0
부산시청→연산교차로,2023.9.4 04:00,140,63,39,242,0
사직운동장→연산교차로,2023.9.4 04:00,24,96,4,124,0
신리→연산교차로,2023.9.4 04:00,81,49,6,136,0
안락→연산교차로,2023.9.4 04:00,152,0,36,188,0
연산터널→연산교차로,2023.9.4 04:00,62,74,20,156,0
교대→연산교차로,2023.9.4 05:00,93,0,112,205,0
부산시청→연산교차로,2023.9.4 05:00,240,168,76,484,0
사직운동장→연산교차로,2023.9.4 05:00,53,168,16,237,0
신리→연산교차로,2023.9.4 05:00,219,87,10,316,0
안락→연산교차로,2023.9.4 05:00,308,0,45,353,0
연산터널→연산교차로,2023.9.4 05:00,130,129,20,279,0
교대→연산교차로,2023.9.4 06:00,195,0,230,425,0
부산시청→연산교차로,2023.9.4 06:00,412,285,121,818,0
사직운동장→연산교차로,2023.9.4 06:00,89,306,53,448,0
신리→연산교차로,2023.9.4 06:00,365,198,29,592,0
안락→연산교차로,2023.9.4 06:00,509,0,100,609,0
연산터널→연산교차로,2023.9.4 06:00,248,243,41,532,0
교대→연산교차로,2023.9.4 07:00,277,0,429,706,0
부산시청→연산교차로,2023.9.4 07:00,588,376,207,1171,0
사직운동장→연산교차로,2023.9.4 07:00,191,507,52,750,0
신리→연산교차로,2023.9.4 07:00,493,298,26,817,0
안락→연산교차로,2023.9.4 07:00,641,0,82,723,0
연산터널→연산교차로,2023.9.4 07:00,304,377,25,706,0
교대→연산교차로,2023.9.4 08:00,313,0,484,797,0
부산시청→연산교차로,2023.9.4 08:00,582,448,309,1339,0
사직운동장→연산교차로,2023.9.4 08:00,189,670,38,897,0
신리→연산교차로,2023.9.4 08:00,489,350,25,864,0
안락→연산교차로,2023.9.4 08:00,639,0,103,742,0
연산터널→연산교차로,2023.9.4 08:00,333,376,9,718,0
교대→연산교차로,2023.9.4 09:00,317,0,506,823,0
부산시청→연산교차로,2023.9.4 09:00,510,372,288,1170,0
사직운동장→연산교차로,2023.9.4 09:00,180,582,60,822,0
신리→연산교차로,2023.9.4 09:00,490,338,46,874,0
안락→연산교차로,2023.9.4 09:00,610,0,108,718,0
연산터널→연산교차로,2023.9.4 09:00,286,375,43,704,0
교대→연산교차로,2023.9.4 10:00,300,0,463,763,0
부산시청→연산교차로,2023.9.4 10:00,529,361,269,1159,0
사직운동장→연산교차로,2023.9.4 10:00,219,583,66,868,0
신리→연산교차로,2023.9.4 10:00,439,270,50,759,0
안락→연산교차로,2023.9.4 10:00,548,0,128,676,0
연산터널→연산교차로,2023.9.4 10:00,318,345,46,709,0
교대→연산교차로,2023.9.4 11:00,298,0,432,730,0
부산시청→연산교차로,2023.9.4 11:00,548,380,266,1194,0
사직운동장→연산교차로,2023.9.4 11:00,204,585,65,854,0
신리→연산교차로,2023.9.4 11:00,440,255,72,767,0
안락→연산교차로,2023.9.4 11:00,492,0,163,655,0
연산터널→연산교차로,2023.9.4 11:00,303,306,55,664,0
교대→연산교차로,2023.9.4 12:00,278,0,365,643,0
부산시청→연산교차로,2023.9.4 12:00,593,360,258,1211,0
사직운동장→연산교차로,2023.9.4 12:00,200,542,60,802,0
신리→연산교차로,2023.9.4 12:00,389,262,55,706,0
안락→연산교차로,2023.9.4 12:00,489,0,176,665,0
연산터널→연산교차로,2023.9.4 12:00,248,270,41,559,0
교대→연산교차로,2023.9.4 13:00,277,0,394,671,0
부산시청→연산교차로,2023.9.4 13:00,577,424,295,1296,0
사직운동장→연산교차로,2023.9.4 13:00,188,628,83,899,0
신리→연산교차로,2023.9.4 13:00,431,280,47,758,0
안락→연산교차로,2023.9.4 13:00,417,0,110,527,0
연산터널→연산교차로,2023.9.4 13:00,255,281,43,579,0
교대→연산교차로,2023.9.4 14:00,332,0,473,805,0
부산시청→연산교차로,2023.9.4 14:00,556,500,292,1348,0
사직운동장→연산교차로,2023.9.4 14:00,193,654,85,932,0
신리→연산교차로,2023.9.4 14:00,473,276,58,807,0
안락→연산교차로,2023.9.4 14:00,402,0,120,522,0
연산터널→연산교차로,2023.9.4 14:00,239,284,48,571,0
교대→연산교차로,2023.9.4 15:00,330,0,461,791,0
부산시청→연산교차로,2023.9.4 15:00,553,480,325,1358,0
사직운동장→연산교차로,2023.9.4 15:00,236,647,65,948,0
신리→연산교차로,2023.9.4 15:00,478,274,55,807,0
안락→연산교차로,2023.9.4 15:00,423,0,129,552,0
연산터널→연산교차로,2023.9.4 15:00,233,274,34,541,0
교대→연산교차로,2023.9.4 16:00,340,0,527,867,0
부산시청→연산교차로,2023.9.4 16:00,629,542,306,1477,0
사직운동장→연산교차로,2023.9.4 16:00,228,670,64,962,0
신리→연산교차로,2023.9.4 16:00,539,292,61,892,0
안락→연산교차로,2023.9.4 16:00,449,0,89,538,0
연산터널→연산교차로,2023.9.4 16:00,253,276,28,557,0
교대→연산교차로,2023.9.4 17:00,363,0,533,896,0
부산시청→연산교차로,2023.9.4 17:00,631,547,312,1490,0
사직운동장→연산교차로,2023.9.4 17:00,234,709,38,981,0
신리→연산교차로,2023.9.4 17:00,518,302,60,880,0
안락→연산교차로,2023.9.4 17:00,446,0,96,542,0
연산터널→연산교차로,2023.9.4 17:00,240,264,47,551,0
교대→연산교차로,2023.9.4 18:00,366,0,533,899,0
부산시청→연산교차로,2023.9.4 18:00,603,561,332,1496,0
사직운동장→연산교차로,2023.9.4 18:00,240,690,68,998,0
신리→연산교차로,2023.9.4 18:00,533,273,41,847,0
안락→연산교차로,2023.9.4 18:00,463,0,89,552,0
연산터널→연산교차로,2023.9.4 18:00,251,263,40,554,0
교대→연산교차로,2023.9.4 19:00,309,0,422,731,0
부산시청→연산교차로,2023.9.4 19:00,576,398,262,1236,0
사직운동장→연산교차로,2023.9.4 19:00,189,588,62,839,0
신리→연산교차로,2023.9.4 19:00,381,220,31,632,0
안락→연산교차로,2023.9.4 19:00,423,0,95,518,0
연산터널→연산교차로,2023.9.4 19:00,233,265,49,547,0
교대→연산교차로,2023.9.4 20:00,328,0,338,666,0
부산시청→연산교차로,2023.9.4 20:00,463,337,249,1049,0
사직운동장→연산교차로,2023.9.4 20:00,182,513,82,777,0
신리→연산교차로,2023.9.4 20:00,315,169,26,510,0
안락→연산교차로,2023.9.4 20:00,417,0,106,523,0
연산터널→연산교차로,2023.9.4 20:00,195,234,59,488,0
교대→연산교차로,2023.9.4 21:00,276,0,330,606,0
부산시청→연산교차로,2023.9.4 21:00,453,315,236,1004,0
사직운동장→연산교차로,2023.9.4 21:00,160,426,79,665,0
신리→연산교차로,2023.9.4 21:00,297,185,27,509,0
안락→연산교차로,2023.9.4 21:00,369,0,103,472,0
연산터널→연산교차로,2023.9.4 21:00,233,275,67,575,0
교대→연산교차로,2023.9.4 22:00,226,0,239,465,0
부산시청→연산교차로,2023.9.4 22:00,389,269,176,834,0
사직운동장→연산교차로,2023.9.4 22:00,177,413,55,645,0
신리→연산교차로,2023.9.4 22:00,202,159,24,385,0
안락→연산교차로,2023.9.4 22:00,308,0,84,392,0
연산터널→연산교차로,2023.9.4 22:00,209,237,73,519,0
교대→연산교차로,2023.9.4 23:00,166,0,223,389,0
부산시청→연산교차로,2023.9.4 23:00,285,169,118,572,0
사직운동장→연산교차로,2023.9.4 23:00,98,290,45,433,0
신리→연산교차로,2023.9.4 23:00,173,131,21,325,0
안락→연산교차로,2023.9.4 23:00,240,0,71,311,0
연산터널→연산교차로,2023.9.4 23:00,168,151,51,370,0
교대→연산교차로,2023.9.5 00:00,131,0,185,316,0
부산시청→연산교차로,2023.9.5 00:00,231,130,98,459,0
사직운동장→연산교차로,2023.9.5 00:00,69,233,31,333,0
신리→연산교차로,2023.9.5 00:00,143,80,16,239,0
안락→연산교차로,2023.9.5 00:00,183,0,53,236,0
연산터널→연산교차로,2023.9.5 00:00,134,165,68,367,0
교대→연산교차로,2023.9.5 01:00,96,0,148,244,0
부산시청→연산교차로,2023.9.5 01:00,176,126,87,389,0
사직운동장→연산교차로,2023.9.5 01:00,52,176,16,244,0
신리→연산교차로,2023.9.5 01:00,89,51,20,160,0
안락→연산교차로,2023.9.5 01:00,159,0,33,192,0
연산터널→연산교차로,2023.9.5 01:00,125,119,58,302,0
교대→연산교차로,2023.9.5 02:00,86,0,124,210,0
부산시청→연산교차로,2023.9.5 02:00,146,95,53,294,0
사직운동장→연산교차로,2023.9.5 02:00,41,169,8,218,0
신리→연산교차로,2023.9.5 02:00,88,51,15,154,0
안락→연산교차로,2023.9.5 02:00,117,0,51,168,0
연산터널→연산교차로,2023.9.5 02:00,110,125,37,272,0
교대→연산교차로,2023.9.5 03:00,55,0,111,166,0
부산시청→연산교차로,2023.9.5 03:00,151,68,48,267,0
사직운동장→연산교차로,2023.9.5 03:00,27,140,7,174,0
신리→연산교차로,2023.9.5 03:00,62,43,13,118,0
안락→연산교차로,2023.9.5 03:00,90,0,27,117,0
연산터널→연산교차로,2023.9.5 03:00,79,99,42,220,0
교대→연산교차로,2023.9.5 04:00,50,0,83,133,0
부산시청→연산교차로,2023.9.5 04:00,143,73,44,260,0
사직운동장→연산교차로,2023.9.5 04:00,37,127,2,166,0
신리→연산교차로,2023.9.5 04:00,94,38,9,141,0
안락→연산교차로,2023.9.5 04:00,177,0,33,210,0
연산터널→연산교차로,2023.9.5 04:00,83,96,42,221,0
교대→연산교차로,2023.9.5 05:00,87,0,133,220,0
부산시청→연산교차로,2023.9.5 05:00,216,165,89,470,0
사직운동장→연산교차로,2023.9.5 05:00,59,192,25,276,0
신리→연산교차로,2023.9.5 05:00,206,100,13,319,0
안락→연산교차로,2023.9.5 05:00,337,0,56,393,0
연산터널→연산교차로,2023.9.5 05:00,143,161,35,339,0
교대→연산교차로,2023.9.5 06:00,197,0,226,423,0
부산시청→연산교차로,2023.9.5 06:00,393,254,118,765,0
사직운동장→연산교차로,2023.9.5 06:00,85,311,56,452,0
신리→연산교차로,2023.9.5 06:00,358,202,23,583,0
안락→연산교차로,2023.9.5 06:00,488,0,106,594,0
연산터널→연산교차로,2023.9.5 06:00,240,228,39,507,0
교대→연산교차로,2023.9.5 07:00,268,0,378,646,0
부산시청→연산교차로,2023.9.5 07:00,571,379,218,1168,0
사직운동장→연산교차로,2023.9.5 07:00,192,527,57,776,0
신리→연산교차로,2023.9.5 07:00,475,275,31,781,0
안락→연산교차로,2023.9.5 07:00,633,0,91,724,0
연산터널→연산교차로,2023.9.5 07:00,293,376,37,706,0
교대→연산교차로,2023.9.5 08:00,305,0,517,822,0
부산시청→연산교차로,2023.9.5 08:00,577,437,318,1332,0
사직운동장→연산교차로,2023.9.5 08:00,186,706,52,944,0
신리→연산교차로,2023.9.5 08:00,514,351,22,887,0
안락→연산교차로,2023.9.5 08:00,616,0,118,734,0
연산터널→연산교차로,2023.9.5 08:00,337,378,14,729,0
교대→연산교차로,2023.9.5 09:00,279,0,508,787,0
부산시청→연산교차로,2023.9.5 09:00,566,377,287,1230,0
사직운동장→연산교차로,2023.9.5 09:00,203,569,76,848,0
신리→연산교차로,2023.9.5 09:00,453,339,49,841,0
안락→연산교차로,2023.9.5 09:00,580,0,131,711,0
연산터널→연산교차로,2023.9.5 09:00,288,374,30,692,0
교대→연산교차로,2023.9.5 10:00,302,0,487,789,0
부산시청→연산교차로,2023.9.5 10:00,544,384,281,1209,0
사직운동장→연산교차로,2023.9.5 10:00,202,560,66,828,0
신리→연산교차로,2023.9.5 10:00,459,297,48,804,0
안락→연산교차로,2023.9.5 10:00,571,0,118,689,0
연산터널→연산교차로,2023.9.5 10:00,310,319,61,690,0
교대→연산교차로,2023.9.5 11:00,274,0,433,707,0
부산시청→연산교차로,2023.9.5 11:00,548,367,264,1179,0
사직운동장→연산교차로,2023.9.5 11:00,196,566,57,819,0
신리→연산교차로,2023.9.5 11:00,417,285,57,759,0
안락→연산교차로,2023.9.5 11:00,542,0,141,683,0
연산터널→연산교차로,2023.9.5 11:00,262,297,63,622,0
교대→연산교차로,2023.9.5 12:00,258,0,406,664,0
부산시청→연산교차로,2023.9.5 12:00,579,380,233,1192,0
사직운동장→연산교차로,2023.9.5 12:00,189,592,87,868,0
신리→연산교차로,2023.9.5 12:00,426,242,59,727,0
안락→연산교차로,2023.9.5 12:00,427,0,152,579,0
연산터널→연산교차로,2023.9.5 12:00,242,276,53,571,0
교대→연산교차로,2023.9.5 13:00,345,0,446,791,0
부산시청→연산교차로,2023.9.5 13:00,578,413,269,1260,0
사직운동장→연산교차로,2023.9.5 13:00,230,574,54,858,0
신리→연산교차로,2023.9.5 13:00,439,269,44,752,0
안락→연산교차로,2023.9.5 13:00,406,0,143,549,0
연산터널→연산교차로,2023.9.5 13:00,227,273,40,540,0
교대→연산교차로,2023.9.5 14:00,330,0,491,821,0
부산시청→연산교차로,2023.9.5 14:00,585,451,280,1316,0
사직운동장→연산교차로,2023.9.5 14:00,198,626,85,909,0
신리→연산교차로,2023.9.5 14:00,446,270,77,793,0
안락→연산교차로,2023.9.5 14:00,429,0,133,562,0
연산터널→연산교차로,2023.9.5 14:00,236,287,52,575,0
교대→연산교차로,2023.9.5 15:00,344,0,490,834,0
부산시청→연산교차로,2023.9.5 15:00,610,474,310,1394,0
사직운동장→연산교차로,2023.9.5 15:00,193,657,92,942,0
신리→연산교차로,2023.9.5 15:00,424,272,62,758,0
안락→연산교차로,2023.9.5 15:00,425,0,125,550,0
연산터널→연산교차로,2023.9.5 15:00,245,284,35,564,0
교대→연산교차로,2023.9.5 16:00,348,0,517,865,0
부산시청→연산교차로,2023.9.5 16:00,605,502,327,1434,0
사직운동장→연산교차로,2023.9.5 16:00,225,688,73,986,0
신리→연산교차로,2023.9.5 16:00,530,281,50,861,0
안락→연산교차로,2023.9.5 16:00,444,0,130,574,0
연산터널→연산교차로,2023.9.5 16:00,233,260,57,550,0
교대→연산교차로,2023.9.5 17:00,372,0,500,872,0
부산시청→연산교차로,2023.9.5 17:00,639,538,297,1474,0
사직운동장→연산교차로,2023.9.5 17:00,201,734,64,999,0
신리→연산교차로,2023.9.5 17:00,523,263,63,849,0
안락→연산교차로,2023.9.5 17:00,422,0,96,518,0
연산터널→연산교차로,2023.9.5 17:00,222,276,41,539,0
교대→연산교차로,2023.9.5 18:00,367,0,573,940,0
부산시청→연산교차로,2023.9.5 18:00,572,573,362,1507,0
사직운동장→연산교차로,2023.9.5 18:00,242,706,51,999,0
신리→연산교차로,2023.9.5 18:00,511,264,58,833,0
안락→연산교차로,2023.9.5 18:00,453,0,85,538,0
연산터널→연산교차로,2023.9.5 18:00,246,276,45,567,0
교대→연산교차로,2023.9.5 19:00,317,0,451,768,0
부산시청→연산교차로,2023.9.5 19:00,534,421,260,1215,0
사직운동장→연산교차로,2023.9.5 19:00,212,609,61,882,0
신리→연산교차로,2023.9.5 19:00,369,224,42,635,0
안락→연산교차로,2023.9.5 19:00,435,0,85,520,0
연산터널→연산교차로,2023.9.5 19:00,205,270,41,516,0
교대→연산교차로,2023.9.5 20:00,336,0,369,705,0
부산시청→연산교차로,2023.9.5 20:00,503,367,269,1139,0
사직운동장→연산교차로,2023.9.5 20:00,152,507,68,727,0
신리→연산교차로,2023.9.5 20:00,341,175,50,566,0
안락→연산교차로,2023.9.5 20:00,443,0,100,543,0
연산터널→연산교차로,2023.9.5 20:00,221,284,49,554,0
교대→연산교차로,2023.9.5 21:00,285,0,324,609,0
부산시청→연산교차로,2023.9.5 21:00,495,339,254,1088,0
사직운동장→연산교차로,2023.9.5 21:00,182,481,55,718,0
신리→연산교차로,2023.9.5 21:00,338,175,35,548,0
안락→연산교차로,2023.9.5 21:00,404,0,108,512,0
연산터널→연산교차로,2023.9.5 21:00,233,272,69,574,0
교대→연산교차로,2023.9.5 22:00,227,0,252,479,0
부산시청→연산교차로,2023.9.5 22:00,362,253,153,768,0
사직운동장→연산교차로,2023.9.5 22:00,138,374,62,574,0
신리→연산교차로,2023.9.5 22:00,243,151,25,419,0
안락→연산교차로,2023.9.5 22:00,338,0,98,436,0
연산터널→연산교차로,2023.9.5 22:00,192,246,77,515,0
교대→연산교차로,2023.9.5 23:00,189,0,226,415,0
부산시청→연산교차로,2023.9.5 23:00,333,186,130,649,0
사직운동장→연산교차로,2023.9.5 23:00,101,304,44,449,0
신리→연산교차로,2023.9.5 23:00,197,99,21,317,0
안락→연산교차로,2023.9.5 23:00,250,0,83,333,0
연산터널→연산교차로,2023.9.5 23:00,168,200,72,440,0
교대→연산교차로,2023.9.6 00:00,144,0,184,328,0
부산시청→연산교차로,2023.9.6 00:00,257,140,94,491,0
사직운동장→연산교차로,2023.9.6 00:00,73,238,23,334,0
신리→연산교차로,2023.9.6 00:00,175,90,20,285,0
안락→연산교차로,2023.9.6 00:00,202,0,47,249,0
연산터널→연산교차로,2023.9.6 00:00,126,194,60,380,0
교대→연산교차로,2023.9.6 01:00,102,0,188,290,0
부산시청→연산교차로,2023.9.6 01:00,209,146,78,433,0
사직운동장→연산교차로,2023.9.6 01:00,45,200,18,263,0
신리→연산교차로,2023.9.6 01:00,109,56,13,178,0
안락→연산교차로,2023.9.6 01:00,164,0,35,199,0
연산터널→연산교차로,2023.9.6 01:00,118,135,57,310,0
교대→연산교차로,2023.9.6 02:00,92,0,113,205,0
부산시청→연산교차로,2023.9.6 02:00,137,76,51,264,0
사직운동장→연산교차로,2023.9.6 02:00,50,142,5,197,0
신리→연산교차로,2023.9.6 02:00,86,55,12,153,0
안락→연산교차로,2023.9.6 02:00,114,0,39,153,0
연산터널→연산교차로,2023.9.6 02:00,99,98,51,248,0
교대→연산교차로,2023.9.6 03:00,58,0,118,176,0
부산시청→연산교차로,2023.9.6 03:00,160,79,47,286,0
사직운동장→연산교차로,2023.9.6 03:00,31,137,8,176,0
신리→연산교차로,2023.9.6 03:00,68,52,10,130,0
안락→연산교차로,2023.9.6 03:00,102,0,18,120,0
연산터널→연산교차로,2023.9.6 03:00,77,96,52,225,0
교대→연산교차로,2023.9.6 04:00,59,0,71,130,0
부산시청→연산교차로,2023.9.6 04:00,164,74,35,273,0
사직운동장→연산교차로,2023.9.6 04:00,30,119,0,149,0
신리→연산교차로,2023.9.6 04:00,89,57,14,160,0
안락→연산교차로,2023.9.6 04:00,164,0,48,212,0
연산터널→연산교차로,2023.9.6 04:00,79,96,36,211,0
교대→연산교차로,2023.9.6 05:00,88,0,134,222,0
부산시청→연산교차로,2023.9.6 05:00,226,158,84,468,0
사직운동장→연산교차로,2023.9.6 05:00,54,169,19,242,0
신리→연산교차로,2023.9.6 05:00,203,104,16,323,0
안락→연산교차로,2023.9.6 05:00,306,0,54,360,0
연산터널→연산교차로,2023.9.6 05:00,136,142,30,308,0
교대→연산교차로,2023.9.6 06:00,194,0,234,428,0
부산시청→연산교차로,2023.9.6 06:00,387,243,106,736,0
사직운동장→연산교차로,2023.9.6 06:00,96,296,42,434,0
신리→연산교차로,2023.9.6 06:00,361,207,20,588,0
안락→연산교차로,2023.9.6 06:00,503,0,125,628,0
연산터널→연산교차로,2023.9.6 06:00,249,227,37,513,0
교대→연산교차로,2023.9.6 07:00,273,0,418,691,0
부산시청→연산교차로,2023.9.6 07:00,599,374,219,1192,0
사직운동장→연산교차로,2023.9.6 07:00,181,541,63,785,0
신리→연산교차로,2023.9.6 07:00,479,286,23,788,0
안락→연산교차로,2023.9.6 07:00,619,0,86,705,0
연산터널→연산교차로,2023.9.6 07:00,294,376,31,701,0
교대→연산교차로,2023.9.6 08:00,308,0,485,793,0
부산시청→연산교차로,2023.9.6 08:00,584,421,333,1338,0
사직운동장→연산교차로,2023.9.6 08:00,189,666,62,917,0
신리→연산교차로,2023.9.6 08:00,474,353,26,853,0
안락→연산교차로,2023.9.6 08:00,618,0,96,714,0
연산터널→연산교차로,2023.9.6 08:00,329,371,21,721,0
교대→연산교차로,2023.9.6 09:00,283,0,530,813,0
부산시청→연산교차로,2023.9.6 09:00,540,401,307,1248,0
사직운동장→연산교차로,2023.9.6 09:00,159,616,74,849,0
신리→연산교차로,2023.9.6 09:00,480,315,48,843,0
안락→연산교차로,2023.9.6 09:00,574,0,122,696,0
연산터널→연산교차로,2023.9.6 09:00,291,362,44,697,0
교대→연산교차로,2023.9.6 10:00,281,0,479,760,0
부산시청→연산교차로,2023.9.6 10:00,544,343,325,1212,0
사직운동장→연산교차로,2023.9.6 10:00,188,613,64,865,0
신리→연산교차로,2023.9.6 10:00,465,269,54,788,0
안락→연산교차로,2023.9.6 10:00,529,0,151,680,0
연산터널→연산교차로,2023.9.6 10:00,309,347,38,694,0
교대→연산교차로,2023.9.6 11:00,286,0,465,751,0
부산시청→연산교차로,2023.9.6 11:00,550,378,263,1191,0
사직운동장→연산교차로,2023.9.6 11:00,203,583,75,861,0
신리→연산교차로,2023.9.6 11:00,450,242,58,750,0
안락→연산교차로,2023.9.6 11:00,511,0,131,642,0
연산터널→연산교차로,2023.9.6 11:00,278,338,56,672,0
교대→연산교차로,2023.9.6 12:00,286,0,428,714,0
부산시청→연산교차로,2023.9.6 12:00,557,363,253,1173,0
사직운동장→연산교차로,2023.9.6 12:00,184,555,72,811,0
신리→연산교차로,2023.9.6 12:00,417,240,45,702,0
안락→연산교차로,2023.9.6 12:00,456,0,185,641,0
연산터널→연산교차로,2023.9.6 12:00,262,270,46,578,0
교대→연산교차로,2023.9.6 13:00,337,0,455,792,0
부산시청→연산교차로,2023.9.6 13:00,526,451,267,1244,0
사직운동장→연산교차로,2023.9.6 13:00,204,595,87,886,0
신리→연산교차로,2023.9.6 13:00,448,272,56,776,0
안락→연산교차로,2023.9.6 13:00,419,0,128,547,0
연산터널→연산교차로,2023.9.6 13:00,248,284,35,567,0
교대→연산교차로,2023.9.6 14:00,345,0,476,821,0
부산시청→연산교차로,2023.9.6 14:00,603,464,302,1369,0
사직운동장→연산교차로,2023.9.6 14:00,199,642,73,914,0
신리→연산교차로,2023.9.6 14:00,451,293,57,801,0
안락→연산교차로,2023.9.6 14:00,417,0,108,525,0
연산터널→연산교차로,2023.9.6 14:00,227,276,60,563,0
교대→연산교차로,2023.9.6 15:00,368,0,489,857,0
부산시청→연산교차로,2023.9.6 15:00,570,516,315,1401,0
사직운동장→연산교차로,2023.9.6 15:00,229,620,85,934,0
신리→연산교차로,2023.9.6 15:00,466,246,66,778,0
안락→연산교차로,2023.9.6 15:00,450,0,117,567,0
연산터널→연산교차로,2023.9.6 15:00,223,274,52,549,0
교대→연산교차로,2023.9.6 16:00,360,0,485,845,0
부산시청→연산교차로,2023.9.6 16:00,571,536,289,1396,0
사직운동장→연산교차로,2023.9.6 16:00,222,691,56,969,0
신리→연산교차로,2023.9.6 16:00,536,288,52,876,0
안락→연산교차로,2023.9.6 16:00,438,0,113,551,0
연산터널→연산교차로,2023.9.6 16:00,231,281,35,547,0
교대→연산교차로,2023.9.6 17:00,369,0,510,879,0
부산시청→연산교차로,2023.9.6 17:00,659,546,293,1498,0
사직운동장→연산교차로,2023.9.6 17:00,226,654,41,921,0
신리→연산교차로,2023.9.6 17:00,490,285,60,835,0
안락→연산교차로,2023.9.6 17:00,450,0,101,551,0
연산터널→연산교차로,2023.9.6 17:00,232,282,43,557,0
교대→연산교차로,2023.9.6 18:00,346,0,579,925,0
부산시청→연산교차로,2023.9.6 18:00,564,537,283,1384,0
사직운동장→연산교차로,2023.9.6 18:00,195,564,49,808,0
신리→연산교차로,2023.9.6 18:00,545,274,46,865,0
안락→연산교차로,2023.9.6 18:00,414,0,101,515,0
연산터널→연산교차로,2023.9.6 18:00,213,263,43,519,0
교대→연산교차로,2023.9.6 19:00,334,0,462,796,0
부산시청→연산교차로,2023.9.6 19:00,534,427,298,1259,0
사직운동장→연산교차로,2023.9.6 19:00,218,555,59,832,0
신리→연산교차로,2023.9.6 19:00,333,225,41,599,0
안락→연산교차로,2023.9.6 19:00,414,0,97,511,0
연산터널→연산교차로,2023.9.6 19:00,228,269,47,544,0
교대→연산교차로,2023.9.6 20:00,296,0,352,648,0
부산시청→연산교차로,2023.9.6 20:00,489,349,222,1060,0
사직운동장→연산교차로,2023.9.6 20:00,182,503,84,769,0
신리→연산교차로,2023.9.6 20:00,305,170,41,516,0
안락→연산교차로,2023.9.6 20:00,380,0,106,486,0
연산터널→연산교차로,2023.9.6 20:00,185,256,59,500,0
교대→연산교차로,2023.9.6 21:00,273,0,290,563,0
부산시청→연산교차로,2023.9.6 21:00,526,337,239,1102,0
사직운동장→연산교차로,2023.9.6 21:00,160,503,69,732,0
신리→연산교차로,2023.9.6 21:00,320,192,38,550,0
안락→연산교차로,2023.9.6 21:00,405,0,106,511,0
연산터널→연산교차로,2023.9.6 21:00,226,285,67,578,0
교대→연산교차로,2023.9.6 22:00,255,0,282,537,0
부산시청→연산교차로,2023.9.6 22:00,434,271,175,880,0
사직운동장→연산교차로,2023.9.6 22:00,136,453,51,640,0
신리→연산교차로,2023.9.6 22:00,268,170,32,470,0
안락→연산교차로,2023.9.6 22:00,325,0,97,422,0
연산터널→연산교차로,2023.9.6 22:00,205,217,66,488,0
교대→연산교차로,2023.9.6 23:00,186,0,213,399,0
부산시청→연산교차로,2023.9.6 23:00,328,190,140,658,0
사직운동장→연산교차로,2023.9.6 23:00,95,337,35,467,0
신리→연산교차로,2023.9.6 23:00,196,122,19,337,0
안락→연산교차로,2023.9.6 23:00,269,0,53,322,0
연산터널→연산교차로,2023.9.6 23:00,156,223,70,449,0
교대→연산교차로,2023.9.7 00:00,138,0,215,353,0
부산시청→연산교차로,2023.9.7 00:00,259,157,104,520,0
사직운동장→연산교차로,2023.9.7 00:00,81,273,15,369,0
신리→연산교차로,2023.9.7 00:00,167,108,24,299,0
안락→연산교차로,2023.9.7 00:00,208,0,69,277,0
연산터널→연산교차로,2023.9.7 00:00,137,146,74,357,0
교대→연산교차로,2023.9.7 01:00,118,0,181,299,0
부산시청→연산교차로,2023.9.7 01:00,191,114,74,379,0
사직운동장→연산교차로,2023.9.7 01:00,49,186,13,248,0
신리→연산교차로,2023.9.7 01:00,117,74,23,214,0
안락→연산교차로,2023.9.7 01:00,150,0,51,201,0
연산터널→연산교차로,2023.9.7 01:00,118,147,85,350,0
교대→연산교차로,2023.9.7 02:00,85,0,144,229,0
부산시청→연산교차로,2023.9.7 02:00,163,94,62,319,0
사직운동장→연산교차로,2023.9.7 02:00,28,160,11,199,0
신리→연산교차로,2023.9.7 02:00,91,49,15,155,0
안락→연산교차로,2023.9.7 02:00,124,0,35,159,0
연산터널→연산교차로,2023.9.7 02:00,91,135,53,279,0
교대→연산교차로,2023.9.7 03:00,74,0,132,206,0
부산시청→연산교차로,2023.9.7 03:00,135,74,53,262,0
사직운동장→연산교차로,2023.9.7 03:00,34,149,2,185,0
신리→연산교차로,2023.9.7 03:00,71,31,9,111,0
안락→연산교차로,2023.9.7 03:00,97,0,26,123,0
연산터널→연산교차로,2023.9.7 03:00,80,98,52,230,0
교대→연산교차로,2023.9.7 04:00,60,0,85,145,0
부산시청→연산교차로,2023.9.7 04:00,144,78,47,269,0
사직운동장→연산교차로,2023.9.7 04:00,30,115,0,145,0
신리→연산교차로,2023.9.7 04:00,82,40,6,128,0
안락→연산교차로,2023.9.7 04:00,170,0,34,204,0
연산터널→연산교차로,2023.9.7 04:00,83,90,32,205,0
교대→연산교차로,2023.9.7 05:00,95,0,128,223,0
부산시청→연산교차로,2023.9.7 05:00,255,164,84,503,0
사직운동장→연산교차로,2023.9.7 05:00,54,172,21,247,0
신리→연산교차로,2023.9.7 05:00,223,104,10,337,0
안락→연산교차로,2023.9.7 05:00,305,0,51,356,0
연산터널→연산교차로,2023.9.7 05:00,138,159,30,327,0
교대→연산교차로,2023.9.7 06:00,188,0,218,406,0
부산시청→연산교차로,2023.9.7 06:00,382,248,109,739,0
사직운동장→연산교차로,2023.9.7 06:00,91,304,39,434,0
신리→연산교차로,2023.9.7 06:00,312,206,24,542,0
안락→연산교차로,2023.9.7 06:00,495,0,108,603,0
연산터널→연산교차로,2023.9.7 06:00,230,220,40,490,0
교대→연산교차로,2023.9.7 07:00,266,0,409,675,0
부산시청→연산교차로,2023.9.7 07:00,589,384,218,1191,0
사직운동장→연산교차로,2023.9.7 07:00,187,533,56,776,0
신리→연산교차로,2023.9.7 07:00,423,294,37,754,0
안락→연산교차로,2023.9.7 07:00,616,0,75,691,0
연산터널→연산교차로,2023.9.7 07:00,305,377,34,716,0
교대→연산교차로,2023.9.7 08:00,320,0,524,844,0
부산시청→연산교차로,2023.9.7 08:00,564,434,348,1346,0
사직운동장→연산교차로,2023.9.7 08:00,202,653,57,912,0
신리→연산교차로,2023.9.7 08:00,522,336,33,891,0
안락→연산교차로,2023.9.7 08:00,618,0,99,717,0
연산터널→연산교차로,2023.9.7 08:00,325,371,28,724,0
교대→연산교차로,2023.9.7 09:00,283,0,506,789,0
부산시청→연산교차로,2023.9.7 09:00,506,363,259,1128,0
사직운동장→연산교차로,2023.9.7 09:00,195,587,66,848,0
신리→연산교차로,2023.9.7 09:00,475,304,41,820,0
안락→연산교차로,2023.9.7 09:00,620,0,87,707,0
연산터널→연산교차로,2023.9.7 09:00,297,378,39,714,0
교대→연산교차로,2023.9.7 10:00,296,0,447,743,0
부산시청→연산교차로,2023.9.7 10:00,541,374,244,1159,0
사직운동장→연산교차로,2023.9.7 10:00,194,596,67,857,0
신리→연산교차로,2023.9.7 10:00,426,301,55,782,0
안락→연산교차로,2023.9.7 10:00,535,0,133,668,0
연산터널→연산교차로,2023.9.7 10:00,288,329,46,663,0
교대→연산교차로,2023.9.7 11:00,301,0,410,711,0
부산시청→연산교차로,2023.9.7 11:00,583,368,289,1240,0
사직운동장→연산교차로,2023.9.7 11:00,210,568,67,845,0
신리→연산교차로,2023.9.7 11:00,395,279,43,717,0
안락→연산교차로,2023.9.7 11:00,505,0,162,667,0
연산터널→연산교차로,2023.9.7 11:00,256,318,56,630,0
교대→연산교차로,2023.9.7 12:00,285,0,374,659,0
부산시청→연산교차로,2023.9.7 12:00,554,373,251,1178,0
사직운동장→연산교차로,2023.9.7 12:00,190,540,70,800,0
신리→연산교차로,2023.9.7 12:00,403,228,52,683,0
안락→연산교차로,2023.9.7 12:00,475,0,142,617,0
연산터널→연산교차로,2023.9.7 12:00,219,269,42,530,0
교대→연산교차로,2023.9.7 13:00,325,0,420,745,0
부산시청→연산교차로,2023.9.7 13:00,590,376,246,1212,0
사직운동장→연산교차로,2023.9.7 13:00,190,607,81,878,0
신리→연산교차로,2023.9.7 13:00,406,284,41,731,0
안락→연산교차로,2023.9.7 13:00,454,0,131,585,0
연산터널→연산교차로,2023.9.7 13:00,241,261,37,539,0
교대→연산교차로,2023.9.7 14:00,346,0,461,807,0
부산시청→연산교차로,2023.9.7 14:00,555,439,299,1293,0
사직운동장→연산교차로,2023.9.7 14:00,199,632,66,897,0
신리→연산교차로,2023.9.7 14:00,480,249,50,779,0
안락→연산교차로,2023.9.7 14:00,446,0,106,552,0
연산터널→연산교차로,2023.9.7 14:00,226,283,41,550,0
교대→연산교차로,2023.9.7 15:00,364,0,457,821,0
부산시청→연산교차로,2023.9.7 15:00,610,462,283,1355,0
사직운동장→연산교차로,2023.9.7 15:00,210,628,80,918,0
신리→연산교차로,2023.9.7 15:00,466,282,51,799,0
안락→연산교차로,2023.9.7 15:00,441,0,102,543,0
연산터널→연산교차로,2023.9.7 15:00,244,260,38,542,0
교대→연산교차로,2023.9.7 16:00,339,0,479,818,0
부산시청→연산교차로,2023.9.7 16:00,600,525,300,1425,0
사직운동장→연산교차로,2023.9.7 16:00,223,673,78,974,0
신리→연산교차로,2023.9.7 16:00,482,291,58,831,0
안락→연산교차로,2023.9.7 16:00,427,0,97,524,0
연산터널→연산교차로,2023.9.7 16:00,229,289,37,555,0
교대→연산교차로,2023.9.7 17:00,357,0,508,865,0
부산시청→연산교차로,2023.9.7 17:00,592,537,291,1420,0
사직운동장→연산교차로,2023.9.7 17:00,228,695,58,981,0
신리→연산교차로,2023.9.7 17:00,522,279,46,847,0
안락→연산교차로,2023.9.7 17:00,436,0,109,545,0
연산터널→연산교차로,2023.9.7 17:00,257,280,51,588,0
교대→연산교차로,2023.9.7 18:00,325,0,576,901,0
부산시청→연산교차로,2023.9.7 18:00,538,510,383,1431,0
사직운동장→연산교차로,2023.9.7 18:00,155,576,31,762,0
신리→연산교차로,2023.9.7 18:00,449,267,42,758,0
안락→연산교차로,2023.9.7 18:00,430,0,105,535,0
연산터널→연산교차로,2023.9.7 18:00,233,263,43,539,0
교대→연산교차로,2023.9.7 19:00,344,0,454,798,0
부산시청→연산교차로,2023.9.7 19:00,529,438,262,1229,0
사직운동장→연산교차로,2023.9.7 19:00,219,604,63,886,0
신리→연산교차로,2023.9.7 19:00,376,226,32,634,0
안락→연산교차로,2023.9.7 19:00,418,0,84,502,0
연산터널→연산교차로,2023.9.7 19:00,219,278,51,548,0
교대→연산교차로,2023.9.7 20:00,325,0,351,676,0
부산시청→연산교차로,2023.9.7 20:00,484,380,248,1112,0
사직운동장→연산교차로,2023.9.7 20:00,185,518,56,759,0
신리→연산교차로,2023.9.7 20:00,295,184,40,519,0
안락→연산교차로,2023.9.7 20:00,400,0,89,489,0
연산터널→연산교차로,2023.9.7 20:00,192,262,53,507,0
교대→연산교차로,2023.9.7 21:00,292,0,356,648,0
부산시청→연산교차로,2023.9.7 21:00,437,310,216,963,0
사직운동장→연산교차로,2023.9.7 21:00,182,498,56,736,0
신리→연산교차로,2023.9.7 21:00,319,197,35,551,0
안락→연산교차로,2023.9.7 21:00,418,0,94,512,0
연산터널→연산교차로,2023.9.7 21:00,232,271,54,557,0
교대→연산교차로,2023.9.7 22:00,238,0,229,467,0
부산시청→연산교차로,2023.9.7 22:00,401,290,179,870,0
사직운동장→연산교차로,2023.9.7 22:00,137,401,42,580,0
신리→연산교차로,2023.9.7 22:00,249,156,30,435,0
안락→연산교차로,2023.9.7 22:00,346,0,84,430,0
연산터널→연산교차로,2023.9.7 22:00,210,223,53,486,0
교대→연산교차로,2023.9.7 23:00,199,0,203,402,0
부산시청→연산교차로,2023.9.7 23:00,332,184,134,650,0
사직운동장→연산교차로,2023.9.7 23:00,103,305,39,447,0
신리→연산교차로,2023.9.7 23:00,211,131,23,365,0
안락→연산교차로,2023.9.7 23:00,251,0,70,321,0
연산터널→연산교차로,2023.9.7 23:00,154,211,46,411,0
교대→연산교차로,2023.9.8 00:00,145,0,203,348,0
부산시청→연산교차로,2023.9.8 00:00,246,164,116,526,0
사직운동장→연산교차로,2023.9.8 00:00,68,301,21,390,0
신리→연산교차로,2023.9.8 00:00,172,119,21,312,0
안락→연산교차로,2023.9.8 00:00,179,0,54,233,0
연산터널→연산교차로,2023.9.8 00:00,115,195,72,382,0
교대→연산교차로,2023.9.8 01:00,123,0,177,300,0
부산시청→연산교차로,2023.9.8 01:00,208,111,91,410,0
사직운동장→연산교차로,2023.9.8 01:00,55,204,4,263,0
신리→연산교차로,2023.9.8 01:00,114,77,19,210,0
안락→연산교차로,2023.9.8 01:00,166,0,37,203,0
연산터널→연산교차로,2023.9.8 01:00,105,148,67,320,0
교대→연산교차로,2023.9.8 02:00,93,0,142,235,0
부산시청→연산교차로,2023.9.8 02:00,180,113,65,358,0
사직운동장→연산교차로,2023.9.8 02:00,42,217,3,262,0
신리→연산교차로,2023.9.8 02:00,90,54,16,160,0
안락→연산교차로,2023.9.8 02:00,140,0,35,175,0
연산터널→연산교차로,2023.9.8 02:00,102,133,51,286,0
교대→연산교차로,2023.9.8 03:00,64,0,135,199,0
부산시청→연산교차로,2023.9.8 03:00,173,76,42,291,0
사직운동장→연산교차로,2023.9.8 03:00,21,147,1,169,0
신리→연산교차로,2023.9.8 03:00,83,44,10,137,0
안락→연산교차로,2023.9.8 03:00,97,0,39,136,0
연산터널→연산교차로,2023.9.8 03:00,74,110,59,243,0
교대→연산교차로,2023.9.8 04:00,65,0,79,144,0
부산시청→연산교차로,2023.9.8 04:00,173,70,61,304,0
사직운동장→연산교차로,2023.9.8 04:00,25,126,3,154,0
신리→연산교차로,2023.9.8 04:00,102,62,9,173,0
안락→연산교차로,2023.9.8 04:00,175,0,41,216,0
연산터널→연산교차로,2023.9.8 04:00,87,99,40,226,0
교대→연산교차로,2023.9.8 05:00,92,0,126,218,0
부산시청→연산교차로,2023.9.8 05:00,232,142,89,463,0
사직운동장→연산교차로,2023.9.8 05:00,55,190,13,258,0
신리→연산교차로,2023.9.8 05:00,242,98,22,362,0
안락→연산교차로,2023.9.8 05:00,307,0,69,376,0
연산터널→연산교차로,2023.9.8 05:00,134,155,28,317,0
교대→연산교차로,2023.9.8 06:00,184,0,217,401,0
부산시청→연산교차로,2023.9.8 06:00,376,260,121,757,0
사직운동장→연산교차로,2023.9.8 06:00,101,317,42,460,0
신리→연산교차로,2023.9.8 06:00,327,205,23,555,0
안락→연산교차로,2023.9.8 06:00,509,0,107,616,0
연산터널→연산교차로,2023.9.8 06:00,246,228,36,510,0
교대→연산교차로,2023.9.8 07:00,263,0,375,638,0
부산시청→연산교차로,2023.9.8 07:00,540,386,209,1135,0
사직운동장→연산교차로,2023.9.8 07:00,172,510,51,733,0
신리→연산교차로,2023.9.8 07:00,464,295,23,782,0
안락→연산교차로,2023.9.8 07:00,601,0,62,663,0
연산터널→연산교차로,2023.9.8 07:00,279,384,31,694,0
교대→연산교차로,2023.9.8 08:00,344,0,510,854,0
부산시청→연산교차로,2023.9.8 08:00,564,431,381,1376,0
사직운동장→연산교차로,2023.9.8 08:00,197,671,69,937,0
신리→연산교차로,2023.9.8 08:00,522,332,38,892,0
안락→연산교차로,2023.9.8 08:00,624,0,120,744,0
연산터널→연산교차로,2023.9.8 08:00,318,381,32,731,0
교대→연산교차로,2023.9.8 09:00,295,0,522,817,0
부산시청→연산교차로,2023.9.8 09:00,559,381,342,1282,0
사직운동장→연산교차로,2023.9.8 09:00,189,632,64,885,0
신리→연산교차로,2023.9.8 09:00,473,329,39,841,0
안락→연산교차로,2023.9.8 09:00,610,0,101,711,0
연산터널→연산교차로,2023.9.8 09:00,309,372,43,724,0
교대→연산교차로,2023.9.8 10:00,287,0,483,770,0
부산시청→연산교차로,2023.9.8 10:00,551,369,270,1190,0
사직운동장→연산교차로,2023.9.8 10:00,190,559,64,813,0
신리→연산교차로,2023.9.8 10:00,416,309,63,788,0
안락→연산교차로,2023.9.8 10:00,566,0,122,688,0
연산터널→연산교차로,2023.9.8 10:00,306,346,54,706,0
교대→연산교차로,2023.9.8 11:00,297,0,419,716,0
부산시청→연산교차로,2023.9.8 11:00,593,373,257,1223,0
사직운동장→연산교차로,2023.9.8 11:00,200,583,61,844,0
신리→연산교차로,2023.9.8 11:00,448,294,74,816,0
안락→연산교차로,2023.9.8 11:00,514,0,154,668,0
연산터널→연산교차로,2023.9.8 11:00,293,342,45,680,0
교대→연산교차로,2023.9.8 12:00,280,0,347,627,0
부산시청→연산교차로,2023.9.8 12:00,562,369,248,1179,0
사직운동장→연산교차로,2023.9.8 12:00,182,588,62,832,0
신리→연산교차로,2023.9.8 12:00,398,241,38,677,0
안락→연산교차로,2023.9.8 12:00,478,0,146,624,0
연산터널→연산교차로,2023.9.8 12:00,283,303,37,623,0
교대→연산교차로,2023.9.8 13:00,318,0,414,732,0
부산시청→연산교차로,2023.9.8 13:00,578,440,276,1294,0
사직운동장→연산교차로,2023.9.8 13:00,233,559,68,860,0
신리→연산교차로,2023.9.8 13:00,425,229,50,704,0
안락→연산교차로,2023.9.8 13:00,421,0,119,540,0
연산터널→연산교차로,2023.9.8 13:00,235,269,41,545,0
교대→연산교차로,2023.9.8 14:00,311,0,451,762,0
부산시청→연산교차로,2023.9.8 14:00,587,461,309,1357,0
사직운동장→연산교차로,2023.9.8 14:00,212,641,74,927,0
신리→연산교차로,2023.9.8 14:00,444,293,53,790,0
안락→연산교차로,2023.9.8 14:00,414,0,109,523,0
연산터널→연산교차로,2023.9.8 14:00,221,273,57,551,0
교대→연산교차로,2023.9.8 15:00,338,0,485,823,0
부산시청→연산교차로,2023.9.8 15:00,594,486,303,1383,0
사직운동장→연산교차로,2023.9.8 15:00,223,655,81,959,0
신리→연산교차로,2023.9.8 15:00,497,263,56,816,0
안락→연산교차로,2023.9.8 15:00,434,0,111,545,0
연산터널→연산교차로,2023.9.8 15:00,252,276,50,578,0
교대→연산교차로,2023.9.8 16:00,357,0,487,844,0
부산시청→연산교차로,2023.9.8 16:00,585,511,318,1414,0
사직운동장→연산교차로,2023.9.8 16:00,222,659,66,947,0
신리→연산교차로,2023.9.8 16:00,504,298,41,843,0
안락→연산교차로,2023.9.8 16:00,430,0,104,534,0
연산터널→연산교차로,2023.9.8 16:00,258,269,30,557,0
교대→연산교차로,2023.9.8 17:00,362,0,544,906,0
부산시청→연산교차로,2023.9.8 17:00,592,532,312,1436,0
사직운동장→연산교차로,2023.9.8 17:00,232,701,46,979,0
신리→연산교차로,2023.9.8 17:00,534,297,57,888,0
안락→연산교차로,2023.9.8 17:00,465,0,82,547,0
연산터널→연산교차로,2023.9.8 17:00,213,272,45,530,0
교대→연산교차로,2023.9.8 18:00,368,0,546,914,0
부산시청→연산교차로,2023.9.8 18:00,601,525,321,1447,0
사직운동장→연산교차로,2023.9.8 18:00,238,698,43,979,0
신리→연산교차로,2023.9.8 18:00,520,272,46,838,0
안락→연산교차로,2023.9.8 18:00,462,0,103,565,0
연산터널→연산교차로,2023.9.8 18:00,241,277,51,569,0
교대→연산교차로,2023.9.8 19:00,314,0,436,750,0
부산시청→연산교차로,2023.9.8 19:00,555,423,275,1253,0
사직운동장→연산교차로,2023.9.8 19:00,186,624,62,872,0
신리→연산교차로,2023.9.8 19:00,407,236,38,681,0
안락→연산교차로,2023.9.8 19:00,425,0,93,518,0
연산터널→연산교차로,2023.9.8 19:00,216,261,63,540,0
교대→연산교차로,2023.9.8 20:00,343,0,461,804,0
부산시청→연산교차로,2023.9.8 20:00,526,347,246,1119,0
사직운동장→연산교차로,2023.9.8 20:00,190,554,82,826,0
신리→연산교차로,2023.9.8 20:00,328,197,32,557,0
안락→연산교차로,2023.9.8 20:00,438,0,109,547,0
연산터널→연산교차로,2023.9.8 20:00,212,277,63,552,0
교대→연산교차로,2023.9.8 21:00,287,0,353,640,0
부산시청→연산교차로,2023.9.8 21:00,505,340,239,1084,0
사직운동장→연산교차로,2023.9.8 21:00,159,471,70,700,0
신리→연산교차로,2023.9.8 21:00,317,216,39,572,0
안락→연산교차로,2023.9.8 21:00,439,0,117,556,0
연산터널→연산교차로,2023.9.8 21:00,233,275,68,576,0
교대→연산교차로,2023.9.8 22:00,289,0,292,581,0
부산시청→연산교차로,2023.9.8 22:00,454,284,199,937,0
사직운동장→연산교차로,2023.9.8 22:00,153,372,48,573,0
신리→연산교차로,2023.9.8 22:00,308,200,18,526,0
안락→연산교차로,2023.9.8 22:00,409,0,104,513,0
연산터널→연산교차로,2023.9.8 22:00,208,271,70,549,0
교대→연산교차로,2023.9.8 23:00,261,0,269,530,0
부산시청→연산교차로,2023.9.8 23:00,370,250,126,746,0
사직운동장→연산교차로,2023.9.8 23:00,129,351,45,525,0
신리→연산교차로,2023.9.8 23:00,231,151,25,407,0
안락→연산교차로,2023.9.8 23:00,320,0,94,414,0
연산터널→연산교차로,2023.9.8 23:00,155,244,70,469,0
교대→연산교차로,2023.9.9 00:00,194,0,240,434,0
부산시청→연산교차로,2023.9.9 00:00,334,216,135,685,0
사직운동장→연산교차로,2023.9.9 00:00,90,267,27,384,0
신리→연산교차로,2023.9.9 00:00,244,162,16,422,0
안락→연산교차로,2023.9.9 00:00,279,0,78,357,0
연산터널→연산교차로,2023.9.9 00:00,120,198,59,377,0
교대→연산교차로,2023.9.9 01:00,153,0,250,403,0
부산시청→연산교차로,2023.9.9 01:00,271,161,112,544,0
사직운동장→연산교차로,2023.9.9 01:00,78,225,20,323,0
신리→연산교차로,2023.9.9 01:00,190,104,17,311,0
안락→연산교차로,2023.9.9 01:00,203,0,62,265,0
연산터널→연산교차로,2023.9.9 01:00,140,203,63,406,0
교대→연산교차로,2023.9.9 02:00,137,0,197,334,0
부산시청→연산교차로,2023.9.9 02:00,235,122,88,445,0
사직운동장→연산교차로,2023.9.9 02:00,67,193,1,261,0
신리→연산교차로,2023.9.9 02:00,156,79,16,251,0
안락→연산교차로,2023.9.9 02:00,173,0,55,228,0
연산터널→연산교차로,2023.9.9 02:00,113,179,51,343,0
교대→연산교차로,2023.9.9 03:00,83,0,173,256,0
부산시청→연산교차로,2023.9.9 03:00,196,121,68,385,0
사직운동장→연산교차로,2023.9.9 03:00,43,176,3,222,0
신리→연산교차로,2023.9.9 03:00,110,53,7,170,0
안락→연산교차로,2023.9.9 03:00,156,0,56,212,0
연산터널→연산교차로,2023.9.9 03:00,86,128,40,254,0
교대→연산교차로,2023.9.9 04:00,80,0,114,194,0
부산시청→연산교차로,2023.9.9 04:00,200,115,53,368,0
사직운동장→연산교차로,2023.9.9 04:00,38,125,1,164,0
신리→연산교차로,2023.9.9 04:00,122,66,7,195,0
안락→연산교차로,2023.9.9 04:00,183,0,37,220,0
연산터널→연산교차로,2023.9.9 04:00,74,131,34,239,0
교대→연산교차로,2023.9.9 05:00,82,0,151,233,0
부산시청→연산교차로,2023.9.9 05:00,249,148,83,480,0
사직운동장→연산교차로,2023.9.9 05:00,46,167,8,221,0
신리→연산교차로,2023.9.9 05:00,204,99,14,317,0
안락→연산교차로,2023.9.9 05:00,296,0,64,360,0
연산터널→연산교차로,2023.9.9 05:00,138,174,22,334,0
교대→연산교차로,2023.9.9 06:00,163,0,186,349,0
부산시청→연산교차로,2023.9.9 06:00,318,230,90,638,0
사직운동장→연산교차로,2023.9.9 06:00,78,248,51,377,0
신리→연산교차로,2023.9.9 06:00,301,165,22,488,0
안락→연산교차로,2023.9.9 06:00,394,0,102,496,0
연산터널→연산교차로,2023.9.9 06:00,205,208,29,442,0
교대→연산교차로,2023.9.9 07:00,194,0,196,390,0
부산시청→연산교차로,2023.9.9 07:00,445,256,138,839,0
사직운동장→연산교차로,2023.9.9 07:00,104,324,42,470,0
신리→연산교차로,2023.9.9 07:00,277,161,23,461,0
안락→연산교차로,2023.9.9 07:00,430,0,89,519,0
연산터널→연산교차로,2023.9.9 07:00,192,211,31,434,0
교대→연산교차로,2023.9.9 08:00,258,0,328,586,0
부산시청→연산교차로,2023.9.9 08:00,483,310,239,1032,0
사직운동장→연산교차로,2023.9.9 08:00,180,557,61,798,0
신리→연산교차로,2023.9.9 08:00,425,247,47,719,0
안락→연산교차로,2023.9.9 08:00,519,0,102,621,0
연산터널→연산교차로,2023.9.9 08:00,299,299,24,622,0
교대→연산교차로,2023.9.9 09:00,297,0,401,698,0
부산시청→연산교차로,2023.9.9 09:00,479,344,250,1073,0
사직운동장→연산교차로,2023.9.9 09:00,189,598,38,825,0
신리→연산교차로,2023.9.9 09:00,458,266,58,782,0
안락→연산교차로,2023.9.9 09:00,527,0,127,654,0
연산터널→연산교차로,2023.9.9 09:00,293,317,44,654,0
교대→연산교차로,2023.9.9 10:00,299,0,489,788,0
부산시청→연산교차로,2023.9.9 10:00,581,374,338,1293,0
사직운동장→연산교차로,2023.9.9 10:00,192,615,30,837,0
신리→연산교차로,2023.9.9 10:00,511,272,81,864,0
안락→연산교차로,2023.9.9 10:00,578,0,156,734,0
연산터널→연산교차로,2023.9.9 10:00,303,321,44,668,0
교대→연산교차로,2023.9.9 11:00,301,0,474,775,0
부산시청→연산교차로,2023.9.9 11:00,601,394,274,1269,0
사직운동장→연산교차로,2023.9.9 11:00,200,609,41,850,0
신리→연산교차로,2023.9.9 11:00,544,257,71,872,0
안락→연산교차로,2023.9.9 11:00,567,0,168,735,0
연산터널→연산교차로,2023.9.9 11:00,280,348,64,692,0
교대→연산교차로,2023.9.9 12:00,321,0,473,794,0
부산시청→연산교차로,2023.9.9 12:00,629,385,274,1288,0
사직운동장→연산교차로,2023.9.9 12:00,193,609,46,848,0
신리→연산교차로,2023.9.9 12:00,488,291,54,833,0
안락→연산교차로,2023.9.9 12:00,550,0,127,677,0
연산터널→연산교차로,2023.9.9 12:00,298,328,63,689,0
교대→연산교차로,2023.9.9 13:00,364,0,434,798,0
부산시청→연산교차로,2023.9.9 13:00,616,466,332,1414,0
사직운동장→연산교차로,2023.9.9 13:00,190,699,33,922,0
신리→연산교차로,2023.9.9 13:00,474,278,76,828,0
안락→연산교차로,2023.9.9 13:00,462,0,95,557,0
연산터널→연산교차로,2023.9.9 13:00,256,281,40,577,0
교대→연산교차로,2023.9.9 14:00,379,0,545,924,0
부산시청→연산교차로,2023.9.9 14:00,674,432,287,1393,0
사직운동장→연산교차로,2023.9.9 14:00,207,674,40,921,0
신리→연산교차로,2023.9.9 14:00,458,305,68,831,0
안락→연산교차로,2023.9.9 14:00,466,0,76,542,0
연산터널→연산교차로,2023.9.9 14:00,230,295,54,579,0
교대→연산교차로,2023.9.9 15:00,359,0,435,794,0
부산시청→연산교차로,2023.9.9 15:00,677,448,301,1426,0
사직운동장→연산교차로,2023.9.9 15:00,245,643,33,921,0
신리→연산교차로,2023.9.9 15:00,487,243,61,791,0
안락→연산교차로,2023.9.9 15:00,446,0,97,543,0
연산터널→연산교차로,2023.9.9 15:00,227,267,52,546,0
교대→연산교차로,2023.9.9 16:00,361,0,443,804,0
부산시청→연산교차로,2023.9.9 16:00,624,439,268,1331,0
사직운동장→연산교차로,2023.9.9 16:00,234,675,55,964,0
신리→연산교차로,2023.9.9 16:00,509,254,60,823,0
안락→연산교차로,2023.9.9 16:00,458,0,91,549,0
연산터널→연산교차로,2023.9.9 16:00,220,300,49,569,0
교대→연산교차로,2023.9.9 17:00,354,0,417,771,0
부산시청→연산교차로,2023.9.9 17:00,614,428,303,1345,0
사직운동장→연산교차로,2023.9.9 17:00,202,681,49,932,0
신리→연산교차로,2023.9.9 17:00,515,233,38,786,0
안락→연산교차로,2023.9.9 17:00,464,0,67,531,0
연산터널→연산교차로,2023.9.9 17:00,236,270,46,552,0
교대→연산교차로,2023.9.9 18:00,356,0,394,750,0
부산시청→연산교차로,2023.9.9 18:00,556,389,237,1182,0
사직운동장→연산교차로,2023.9.9 18:00,241,581,56,878,0
신리→연산교차로,2023.9.9 18:00,420,210,48,678,0
안락→연산교차로,2023.9.9 18:00,427,0,121,548,0
연산터널→연산교차로,2023.9.9 18:00,231,274,73,578,0
교대→연산교차로,2023.9.9 19:00,290,0,364,654,0
부산시청→연산교차로,2023.9.9 19:00,475,355,211,1041,0
사직운동장→연산교차로,2023.9.9 19:00,178,491,60,729,0
신리→연산교차로,2023.9.9 19:00,329,207,31,567,0
안락→연산교차로,2023.9.9 19:00,421,0,109,530,0
연산터널→연산교차로,2023.9.9 19:00,193,278,52,523,0
교대→연산교차로,2023.9.9 20:00,315,0,322,637,0
부산시청→연산교차로,2023.9.9 20:00,469,327,202,998,0
사직운동장→연산교차로,2023.9.9 20:00,160,481,43,684,0
신리→연산교차로,2023.9.9 20:00,352,188,31,571,0
안락→연산교차로,2023.9.9 20:00,434,0,93,527,0
연산터널→연산교차로,2023.9.9 20:00,221,250,61,532,0
교대→연산교차로,2023.9.9 21:00,272,0,313,585,0
부산시청→연산교차로,2023.9.9 21:00,478,299,188,965,0
사직운동장→연산교차로,2023.9.9 21:00,166,400,47,613,0
신리→연산교차로,2023.9.9 21:00,337,199,32,568,0
안락→연산교차로,2023.9.9 21:00,397,0,82,479,0
연산터널→연산교차로,2023.9.9 21:00,245,263,53,561,0
교대→연산교차로,2023.9.9 22:00,248,0,306,554,0
부산시청→연산교차로,2023.9.9 22:00,430,258,169,857,0
사직운동장→연산교차로,2023.9.9 22:00,149,396,47,592,0
신리→연산교차로,2023.9.9 22:00,304,167,27,498,0
안락→연산교차로,2023.9.9 22:00,349,0,108,457,0
연산터널→연산교차로,2023.9.9 22:00,188,223,75,486,0
교대→연산교차로,2023.9.9 23:00,196,0,259,455,0
부산시청→연산교차로,2023.9.9 23:00,362,208,142,712,0
사직운동장→연산교차로,2023.9.9 23:00,103,320,44,467,0
신리→연산교차로,2023.9.9 23:00,276,165,24,465,0
안락→연산교차로,2023.9.9 23:00,286,0,86,372,0
연산터널→연산교차로,2023.9.9 23:00,168,233,57,458,0
교대→연산교차로,2023.9.10 00:00,160,0,247,407,1
부산시청→연산교차로,2023.9.10 00:00,306,193,99,598,1
사직운동장→연산교차로,2023.9.10 00:00,85,251,18,354,1
신리→연산교차로,2023.9.10 00:00,237,136,21,394,1
안락→연산교차로,2023.9.10 00:00,265,0,69,334,1
연산터널→연산교차로,2023.9.10 00:00,155,185,57,397,1
교대→연산교차로,2023.9.10 01:00,136,0,232,368,1
부산시청→연산교차로,2023.9.10 01:00,277,169,97,543,1
사직운동장→연산교차로,2023.9.10 01:00,64,187,22,273,1
신리→연산교차로,2023.9.10 01:00,193,111,18,322,1
안락→연산교차로,2023.9.10 01:00,220,0,63,283,1
연산터널→연산교차로,2023.9.10 01:00,138,168,58,364,1
교대→연산교차로,2023.9.10 02:00,95,0,171,266,1
부산시청→연산교차로,2023.9.10 02:00,246,145,84,475,1
사직운동장→연산교차로,2023.9.10 02:00,63,140,8,211,1
신리→연산교차로,2023.9.10 02:00,126,67,15,208,1
안락→연산교차로,2023.9.10 02:00,178,0,41,219,1
연산터널→연산교차로,2023.9.10 02:00,113,138,34,285,1
교대→연산교차로,2023.9.10 03:00,92,0,174,266,1
부산시청→연산교차로,2023.9.10 03:00,222,97,65,384,1
사직운동장→연산교차로,2023.9.10 03:00,44,160,5,209,1
신리→연산교차로,2023.9.10 03:00,104,72,15,191,1
안락→연산교차로,2023.9.10 03:00,142,0,32,174,1
연산터널→연산교차로,2023.9.10 03:00,94,116,45,255,1
교대→연산교차로,2023.9.10 04:00,84,0,117,201,1
부산시청→연산교차로,2023.9.10 04:00,164,83,67,314,1
사직운동장→연산교차로,2023.9.10 04:00,45,97,4,146,1
신리→연산교차로,2023.9.10 04:00,87,53,6,146,1
안락→연산교차로,2023.9.10 04:00,129,0,44,173,1
연산터널→연산교차로,2023.9.10 04:00,80,100,26,206,1
교대→연산교차로,2023.9.10 05:00,69,0,103,172,1
부산시청→연산교차로,2023.9.10 05:00,188,127,52,367,1
사직운동장→연산교차로,2023.9.10 05:00,43,124,10,177,1
신리→연산교차로,2023.9.10 05:00,158,79,7,244,1
안락→연산교차로,2023.9.10 05:00,201,0,37,238,1
연산터널→연산교차로,2023.9.10 05:00,100,122,21,243,1
교대→연산교차로,2023.9.10 06:00,99,0,126,225,1
부산시청→연산교차로,2023.9.10 06:00,222,188,60,470,1
사직운동장→연산교차로,2023.9.10 06:00,48,173,36,257,1
신리→연산교차로,2023.9.10 06:00,217,92,12,321,1
안락→연산교차로,2023.9.10 06:00,256,0,64,320,1
연산터널→연산교차로,2023.9.10 06:00,140,163,26,329,1
교대→연산교차로,2023.9.10 07:00,135,0,119,254,1
부산시청→연산교차로,2023.9.10 07:00,258,182,96,536,1
사직운동장→연산교차로,2023.9.10 07:00,82,203,22,307,1
신리→연산교차로,2023.9.10 07:00,224,93,11,328,1
안락→연산교차로,2023.9.10 07:00,259,0,70,329,1
연산터널→연산교차로,2023.9.10 07:00,119,119,25,263,1
교대→연산교차로,2023.9.10 08:00,154,0,170,324,1
부산시청→연산교차로,2023.9.10 08:00,292,232,123,647,1
사직운동장→연산교차로,2023.9.10 08:00,112,311,38,461,1
신리→연산교차로,2023.9.10 08:00,267,147,21,435,1
안락→연산교차로,2023.9.10 08:00,320,0,85,405,1
연산터널→연산교차로,2023.9.10 08:00,186,163,13,362,1
교대→연산교차로,2023.9.10 09:00,230,0,235,465,1
부산시청→연산교차로,2023.9.10 09:00,368,311,141,820,1
사직운동장→연산교차로,2023.9.10 09:00,157,406,41,604,1
신리→연산교차로,2023.9.10 09:00,397,219,29,645,1
안락→연산교차로,2023.9.10 09:00,420,0,107,527,1
연산터널→연산교차로,2023.9.10 09:00,247,209,29,485,1
교대→연산교차로,2023.9.10 10:00,285,0,290,575,1
부산시청→연산교차로,2023.9.10 10:00,450,317,176,943,1
사직운동장→연산교차로,2023.9.10 10:00,175,553,40,768,1
신리→연산교차로,2023.9.10 10:00,442,216,30,688,1
안락→연산교차로,2023.9.10 10:00,541,0,93,634,1
연산터널→연산교차로,2023.9.10 10:00,253,255,41,549,1
교대→연산교차로,2023.9.10 11:00,268,0,332,600,1
부산시청→연산교차로,2023.9.10 11:00,478,340,170,988,1
사직운동장→연산교차로,2023.9.10 11:00,182,504,34,720,1
신리→연산교차로,2023.9.10 11:00,440,213,35,688,1
안락→연산교차로,2023.9.10 11:00,513,0,135,648,1
연산터널→연산교차로,2023.9.10 11:00,228,232,42,502,1
교대→연산교차로,2023.9.10 12:00,277,0,341,618,1
부산시청→연산교차로,2023.9.10 12:00,509,342,199,1050,1
사직운동장→연산교차로,2023.9.10 12:00,178,551,41,770,1
신리→연산교차로,2023.9.10 12:00,419,226,32,677,1
안락→연산교차로,2023.9.10 12:00,520,0,119,639,1
연산터널→연산교차로,2023.9.10 12:00,247,251,40,538,1
교대→연산교차로,2023.9.10 13:00,293,0,376,669,1
부산시청→연산교차로,2023.9.10 13:00,524,347,213,1084,1
사직운동장→연산교차로,2023.9.10 13:00,178,527,43,748,1
신리→연산교차로,2023.9.10 13:00,414,217,34,665,1
안락→연산교차로,2023.9.10 13:00,540,0,104,644,1
연산터널→연산교차로,2023.9.10 13:00,256,238,49,543,1
교대→연산교차로,2023.9.10 14:00,304,0,389,693,1
부산시청→연산교차로,2023.9.10 14:00,540,367,217,1124,1
사직운동장→연산교차로,2023.9.10 14:00,177,547,38,762,1
신리→연산교차로,2023.9.10 14:00,414,224,34,672,1
안락→연산교차로,2023.9.10 14:00,565,0,122,687,1
연산터널→연산교차로,2023.9.10 14:00,262,258,61,581,1
교대→연산교차로,2023.9.10 15:00,290,0,331,621,1
부산시청→연산교차로,2023.9.10 15:00,540,373,189,1102,1
사직운동장→연산교차로,2023.9.10 15:00,199,527,31,757,1
신리→연산교차로,2023.9.10 15:00,443,226,42,711,1
안락→연산교차로,2023.9.10 15:00,540,0,147,687,1
연산터널→연산교차로,2023.9.10 15:00,228,246,43,517,1
교대→연산교차로,2023.9.10 16:00,303,0,293,596,1
부산시청→연산교차로,2023.9.10 16:00,527,350,215,1092,1
사직운동장→연산교차로,2023.9.10 16:00,194,530,32,756,1
신리→연산교차로,2023.9.10 16:00,420,176,41,637,1
안락→연산교차로,2023.9.10 16:00,551,0,118,669,1
연산터널→연산교차로,2023.9.10 16:00,250,246,50,546,1
교대→연산교차로,2023.9.10 17:00,284,0,284,568,1
부산시청→연산교차로,2023.9.10 17:00,497,349,172,1018,1
사직운동장→연산교차로,2023.9.10 17:00,157,535,48,740,1
신리→연산교차로,2023.9.10 17:00,398,197,36,631,1
안락→연산교차로,2023.9.10 17:00,542,0,109,651,1
연산터널→연산교차로,2023.9.10 17:00,260,259,50,569,1
교대→연산교차로,2023.9.10 18:00,298,0,305,603,1
부산시청→연산교차로,2023.9.10 18:00,477,282,177,936,1
사직운동장→연산교차로,2023.9.10 18:00,171,444,53,668,1
신리→연산교차로,2023.9.10 18:00,365,200,36,601,1
안락→연산교차로,2023.9.10 18:00,457,0,132,589,1
연산터널→연산교차로,2023.9.10 18:00,211,221,72,504,1
교대→연산교차로,2023.9.10 19:00,283,0,288,571,1
부산시청→연산교차로,2023.9.10 19:00,403,290,178,871,1
사직운동장→연산교차로,2023.9.10 19:00,166,393,36,595,1
신리→연산교차로,2023.9.10 19:00,297,178,27,502,1
안락→연산교차로,2023.9.10 19:00,426,0,125,551,1
연산터널→연산교차로,2023.9.10 19:00,223,225,35,483,1
교대→연산교차로,2023.9.10 20:00,257,0,250,507,1
부산시청→연산교차로,2023.9.10 20:00,399,250,156,805,1
사직운동장→연산교차로,2023.9.10 20:00,133,368,35,536,1
신리→연산교차로,2023.9.10 20:00,307,163,30,500,1
안락→연산교차로,2023.9.10 20:00,390,0,110,500,1
연산터널→연산교차로,2023.9.10 20:00,196,211,49,456,1
교대→연산교차로,2023.9.10 21:00,225,0,221,446,1
부산시청→연산교차로,2023.9.10 21:00,371,249,136,756,1
사직운동장→연산교차로,2023.9.10 21:00,101,318,50,469,1
신리→연산교차로,2023.9.10 21:00,268,161,16,445,1
안락→연산교차로,2023.9.10 21:00,368,0,85,453,1
연산터널→연산교차로,2023.9.10 21:00,179,213,42,434,1
교대→연산교차로,2023.9.10 22:00,201,0,195,396,1
부산시청→연산교차로,2023.9.10 22:00,328,203,119,650,1
사직운동장→연산교차로,2023.9.10 22:00,95,285,37,417,1
신리→연산교차로,2023.9.10 22:00,212,116,26,354,1
안락→연산교차로,2023.9.10 22:00,263,0,72,335,1
연산터널→연산교차로,2023.9.10 22:00,155,160,42,357,1
교대→연산교차로,2023.9.10 23:00,119,0,177,296,1
부산시청→연산교차로,2023.9.10 23:00,261,147,112,520,1
사직운동장→연산교차로,2023.9.10 23:00,66,200,21,287,1
신리→연산교차로,2023.9.10 23:00,171,101,21,293,1
안락→연산교차로,2023.9.10 23:00,228,0,54,282,1
연산터널→연산교차로,2023.9.10 23:00,143,144,80,367,1
교대→연산교차로,2023.9.11 00:00,92,0,160,252,0
부산시청→연산교차로,2023.9.11 00:00,198,120,82,400,0
사직운동장→연산교차로,2023.9.11 00:00,43,180,6,229,0
신리→연산교차로,2023.9.11 00:00,132,53,20,205,0
안락→연산교차로,2023.9.11 00:00,155,0,39,194,0
연산터널→연산교차로,2023.9.11 00:00,91,130,61,282,0
교대→연산교차로,2023.9.11 01:00,87,0,124,211,0
부산시청→연산교차로,2023.9.11 01:00,160,76,65,301,0
사직운동장→연산교차로,2023.9.11 01:00,36,120,5,161,0
신리→연산교차로,2023.9.11 01:00,92,62,12,166,0
안락→연산교차로,2023.9.11 01:00,127,0,27,154,0
연산터널→연산교차로,2023.9.11 01:00,71,103,53,227,0
교대→연산교차로,2023.9.11 02:00,50,0,84,134,0
부산시청→연산교차로,2023.9.11 02:00,112,71,37,220,0
사직운동장→연산교차로,2023.9.11 02:00,26,95,3,124,0
신리→연산교차로,2023.9.11 02:00,70,35,8,113,0
안락→연산교차로,2023.9.11 02:00,98,0,25,123,0
연산터널→연산교차로,2023.9.11 02:00,57,87,35,179,0
교대→연산교차로,2023.9.11 03:00,44,0,66,110,0
부산시청→연산교차로,2023.9.11 03:00,139,62,41,242,0
사직운동장→연산교차로,2023.9.11 03:00,21,89,3,113,0
신리→연산교차로,2023.9.11 03:00,51,31,7,89,0
안락→연산교차로,2023.9.11 03:00,74,0,18,92,0
연산터널→연산교차로,2023.9.11 03:00,54,79,40,173,0
교대→연산교차로,2023.9.11 04:00,48,0,55,103,0
부산시청→연산교차로,2023.9.11 04:00,139,70,52,261,0
사직운동장→연산교차로,2023.9.11 04:00,22,103,0,125,0
신리→연산교차로,2023.9.11 04:00,105,45,5,155,0
안락→연산교차로,2023.9.11 04:00,153,0,31,184,0
연산터널→연산교차로,2023.9.11 04:00,71,81,23,175,0
교대→연산교차로,2023.9.11 05:00,88,0,115,203,0
부산시청→연산교차로,2023.9.11 05:00,230,174,68,472,0
사직운동장→연산교차로,2023.9.11 05:00,54,155,5,214,0
신리→연산교차로,2023.9.11 05:00,224,89,7,320,0
안락→연산교차로,2023.9.11 05:00,314,0,55,369,0
연산터널→연산교차로,2023.9.11 05:00,124,145,30,299,0
교대→연산교차로,2023.9.11 06:00,184,0,238,422,0
부산시청→연산교차로,2023.9.11 06:00,384,276,131,791,0
사직운동장→연산교차로,2023.9.11 06:00,83,302,48,433,0
신리→연산교차로,2023.9.11 06:00,352,210,24,586,0
안락→연산교차로,2023.9.11 06:00,538,0,97,635,0
연산터널→연산교차로,2023.9.11 06:00,226,257,39,522,0
교대→연산교차로,2023.9.11 07:00,259,0,395,654,0
부산시청→연산교차로,2023.9.11 07:00,615,383,232,1230,0
사직운동장→연산교차로,2023.9.11 07:00,183,503,67,753,0
신리→연산교차로,2023.9.11 07:00,483,292,29,804,0
안락→연산교차로,2023.9.11 07:00,629,0,85,714,0
연산터널→연산교차로,2023.9.11 07:00,294,377,34,705,0
교대→연산교차로,2023.9.11 08:00,303,0,471,774,0
부산시청→연산교차로,2023.9.11 08:00,609,448,332,1389,0
사직운동장→연산교차로,2023.9.11 08:00,199,652,46,897,0
신리→연산교차로,2023.9.11 08:00,507,333,25,865,0
안락→연산교차로,2023.9.11 08:00,630,0,94,724,0
연산터널→연산교차로,2023.9.11 08:00,324,366,25,715,0
교대→연산교차로,2023.9.11 09:00,294,0,509,803,0
부산시청→연산교차로,2023.9.11 09:00,560,378,287,1225,0
사직운동장→연산교차로,2023.9.11 09:00,186,602,67,855,0
신리→연산교차로,2023.9.11 09:00,448,344,37,829,0
안락→연산교차로,2023.9.11 09:00,623,0,97,720,0
연산터널→연산교차로,2023.9.11 09:00,305,382,38,725,0
교대→연산교차로,2023.9.11 10:00,303,0,440,743,0
부산시청→연산교차로,2023.9.11 10:00,604,351,268,1223,0
사직운동장→연산교차로,2023.9.11 10:00,212,574,67,853,0
신리→연산교차로,2023.9.11 10:00,427,292,69,788,0
안락→연산교차로,2023.9.11 10:00,565,0,119,684,0
연산터널→연산교차로,2023.9.11 10:00,280,340,58,678,0
교대→연산교차로,2023.9.11 11:00,312,0,422,734,0
부산시청→연산교차로,2023.9.11 11:00,603,368,288,1259,0
사직운동장→연산교차로,2023.9.11 11:00,204,574,75,853,0
신리→연산교차로,2023.9.11 11:00,434,275,51,760,0
안락→연산교차로,2023.9.11 11:00,523,0,144,667,0
연산터널→연산교차로,2023.9.11 11:00,283,320,39,642,0
교대→연산교차로,2023.9.11 12:00,296,0,394,690,0
부산시청→연산교차로,2023.9.11 12:00,589,360,281,1230,0
사직운동장→연산교차로,2023.9.11 12:00,206,565,73,844,0
신리→연산교차로,2023.9.11 12:00,429,230,51,710,0
안락→연산교차로,2023.9.11 12:00,528,0,162,690,0
연산터널→연산교차로,2023.9.11 12:00,266,272,45,583,0
교대→연산교차로,2023.9.11 13:00,326,0,418,744,0
부산시청→연산교차로,2023.9.11 13:00,623,438,239,1300,0
사직운동장→연산교차로,2023.9.11 13:00,191,590,69,850,0
신리→연산교차로,2023.9.11 13:00,450,261,37,748,0
안락→연산교차로,2023.9.11 13:00,451,0,110,561,0
연산터널→연산교차로,2023.9.11 13:00,215,278,42,535,0
교대→연산교차로,2023.9.11 14:00,337,0,476,813,0
부산시청→연산교차로,2023.9.11 14:00,630,431,295,1356,0
사직운동장→연산교차로,2023.9.11 14:00,215,612,65,892,0
신리→연산교차로,2023.9.11 14:00,452,287,58,797,0
안락→연산교차로,2023.9.11 14:00,436,0,98,534,0
연산터널→연산교차로,2023.9.11 14:00,227,299,45,571,0
교대→연산교차로,2023.9.11 15:00,342,0,441,783,0
부산시청→연산교차로,2023.9.11 15:00,625,511,320,1456,0
사직운동장→연산교차로,2023.9.11 15:00,224,648,93,965,0
신리→연산교차로,2023.9.11 15:00,483,268,48,799,0
안락→연산교차로,2023.9.11 15:00,444,0,96,540,0
연산터널→연산교차로,2023.9.11 15:00,255,276,47,578,0
교대→연산교차로,2023.9.11 16:00,342,0,464,806,0
부산시청→연산교차로,2023.9.11 16:00,685,523,322,1530,0
사직운동장→연산교차로,2023.9.11 16:00,228,643,58,929,0
신리→연산교차로,2023.9.11 16:00,547,271,55,873,0
안락→연산교차로,2023.9.11 16:00,439,0,109,548,0
연산터널→연산교차로,2023.9.11 16:00,254,283,37,574,0
교대→연산교차로,2023.9.11 17:00,373,0,503,876,0
부산시청→연산교차로,2023.9.11 17:00,675,553,314,1542,0
사직운동장→연산교차로,2023.9.11 17:00,246,693,44,983,0
신리→연산교차로,2023.9.11 17:00,509,262,53,824,0
안락→연산교차로,2023.9.11 17:00,435,0,106,541,0
연산터널→연산교차로,2023.9.11 17:00,244,265,46,555,0
교대→연산교차로,2023.9.11 18:00,361,0,541,902,0
부산시청→연산교차로,2023.9.11 18:00,602,593,349,1544,0
사직운동장→연산교차로,2023.9.11 18:00,238,689,45,972,0
신리→연산교차로,2023.9.11 18:00,507,245,50,802,0
안락→연산교차로,2023.9.11 18:00,470,0,99,569,0
연산터널→연산교차로,2023.9.11 18:00,217,275,39,531,0
교대→연산교차로,2023.9.11 19:00,325,0,376,701,0
부산시청→연산교차로,2023.9.11 19:00,544,407,234,1185,0
사직운동장→연산교차로,2023.9.11 19:00,199,560,75,834,0
신리→연산교차로,2023.9.11 19:00,382,215,40,637,0
안락→연산교차로,2023.9.11 19:00,407,0,97,504,0
연산터널→연산교차로,2023.9.11 19:00,209,266,51,526,0
교대→연산교차로,2023.9.11 20:00,304,0,355,659,0
부산시청→연산교차로,2023.9.11 20:00,470,359,271,1100,0
사직운동장→연산교차로,2023.9.11 20:00,157,474,69,700,0
신리→연산교차로,2023.9.11 20:00,324,188,35,547,0
안락→연산교차로,2023.9.11 20:00,413,0,86,499,0
연산터널→연산교차로,2023.9.11 20:00,221,253,73,547,0
교대→연산교차로,2023.9.11 21:00,269,0,293,562,0
부산시청→연산교차로,2023.9.11 21:00,481,303,223,1007,0
사직운동장→연산교차로,2023.9.11 21:00,173,429,47,649,0
신리→연산교차로,2023.9.11 21:00,292,170,30,492,0
안락→연산교차로,2023.9.11 21:00,399,0,95,494,0
연산터널→연산교차로,2023.9.11 21:00,217,256,63,536,0
교대→연산교차로,2023.9.11 22:00,238,0,245,483,0
부산시청→연산교차로,2023.9.11 22:00,374,243,145,762,0
사직운동장→연산교차로,2023.9.11 22:00,116,377,69,562,0
신리→연산교차로,2023.9.11 22:00,242,156,42,440,0
안락→연산교차로,2023.9.11 22:00,321,0,87,408,0
연산터널→연산교차로,2023.9.11 22:00,198,215,61,474,0
교대→연산교차로,2023.9.11 23:00,179,0,180,359,0
부산시청→연산교차로,2023.9.11 23:00,304,192,112,608,0
사직운동장→연산교차로,2023.9.11 23:00,103,276,25,404,0
신리→연산교차로,2023.9.11 23:00,181,105,22,308,0
안락→연산교차로,2023.9.11 23:00,256,0,65,321,0
연산터널→연산교차로,2023.9.11 23:00,148,186,61,395,0
교대→연산교차로,2023.9.12 00:00,121,0,188,309,0
부산시청→연산교차로,2023.9.12 00:00,232,154,114,500,0
사직운동장→연산교차로,2023.9.12 00:00,49,260,28,337,0
신리→연산교차로,2023.9.12 00:00,150,81,22,253,0
안락→연산교차로,2023.9.12 00:00,193,0,60,253,0
연산터널→연산교차로,2023.9.12 00:00,149,167,58,374,0
교대→연산교차로,2023.9.12 01:00,104,0,150,254,0
부산시청→연산교차로,2023.9.12 01:00,170,119,71,360,0
사직운동장→연산교차로,2023.9.12 01:00,43,166,11,220,0
신리→연산교차로,2023.9.12 01:00,94,67,14,175,0
안락→연산교차로,2023.9.12 01:00,133,0,38,171,0
연산터널→연산교차로,2023.9.12 01:00,106,132,51,289,0
교대→연산교차로,2023.9.12 02:00,73,0,118,191,0
부산시청→연산교차로,2023.9.12 02:00,119,89,64,272,0
사직운동장→연산교차로,2023.9.12 02:00,30,157,9,196,0
신리→연산교차로,2023.9.12 02:00,83,37,13,133,0
안락→연산교차로,2023.9.12 02:00,110,0,35,145,0
연산터널→연산교차로,2023.9.12 02:00,92,124,36,252,0
교대→연산교차로,2023.9.12 03:00,51,0,97,148,0
부산시청→연산교차로,2023.9.12 03:00,145,75,52,272,0
사직운동장→연산교차로,2023.9.12 03:00,31,118,2,151,0
신리→연산교차로,2023.9.12 03:00,57,34,9,100,0
안락→연산교차로,2023.9.12 03:00,84,0,24,108,0
연산터널→연산교차로,2023.9.12 03:00,60,99,30,189,0
교대→연산교차로,2023.9.12 04:00,48,0,83,131,0
부산시청→연산교차로,2023.9.12 04:00,156,76,46,278,0
사직운동장→연산교차로,2023.9.12 04:00,24,115,2,141,0
신리→연산교차로,2023.9.12 04:00,106,34,7,147,0
안락→연산교차로,2023.9.12 04:00,155,0,50,205,0
연산터널→연산교차로,2023.9.12 04:00,78,95,29,202,0
교대→연산교차로,2023.9.12 05:00,80,0,118,198,0
부산시청→연산교차로,2023.9.12 05:00,248,155,70,473,0
사직운동장→연산교차로,2023.9.12 05:00,47,184,11,242,0
신리→연산교차로,2023.9.12 05:00,211,105,8,324,0
안락→연산교차로,2023.9.12 05:00,295,0,60,355,0
연산터널→연산교차로,2023.9.12 05:00,134,146,35,315,0
교대→연산교차로,2023.9.12 06:00,176,0,245,421,0
부산시청→연산교차로,2023.9.12 06:00,361,261,126,748,0
사직운동장→연산교차로,2023.9.12 06:00,78,306,44,428,0
신리→연산교차로,2023.9.12 06:00,340,176,23,539,0
안락→연산교차로,2023.9.12 06:00,505,0,119,624,0
연산터널→연산교차로,2023.9.12 06:00,235,215,42,492,0
교대→연산교차로,2023.9.12 07:00,264,0,364,628,0
부산시청→연산교차로,2023.9.12 07:00,600,371,216,1187,0
사직운동장→연산교차로,2023.9.12 07:00,198,513,71,782,0
신리→연산교차로,2023.9.12 07:00,461,297,28,786,0
안락→연산교차로,2023.9.12 07:00,622,0,80,702,0
연산터널→연산교차로,2023.9.12 07:00,308,387,35,730,0
교대→연산교차로,2023.9.12 08:00,298,0,480,778,0
부산시청→연산교차로,2023.9.12 08:00,580,438,336,1354,0
사직운동장→연산교차로,2023.9.12 08:00,206,650,46,902,0
신리→연산교차로,2023.9.12 08:00,505,338,29,872,0
안락→연산교차로,2023.9.12 08:00,623,0,91,714,0
연산터널→연산교차로,2023.9.12 08:00,306,404,12,722,0
교대→연산교차로,2023.9.12 09:00,298,0,521,819,0
부산시청→연산교차로,2023.9.12 09:00,586,384,276,1246,0
사직운동장→연산교차로,2023.9.12 09:00,187,563,64,814,0
신리→연산교차로,2023.9.12 09:00,492,333,37,862,0
안락→연산교차로,2023.9.12 09:00,555,0,81,636,0
연산터널→연산교차로,2023.9.12 09:00,298,352,21,671,0
교대→연산교차로,2023.9.12 10:00,286,0,517,803,0
부산시청→연산교차로,2023.9.12 10:00,569,386,290,1245,0
사직운동장→연산교차로,2023.9.12 10:00,197,577,41,815,0
신리→연산교차로,2023.9.12 10:00,480,283,46,809,0
안락→연산교차로,2023.9.12 10:00,538,0,122,660,0
연산터널→연산교차로,2023.9.12 10:00,299,315,45,659,0
교대→연산교차로,2023.9.12 11:00,293,0,490,783,0
부산시청→연산교차로,2023.9.12 11:00,612,343,315,1270,0
사직운동장→연산교차로,2023.9.12 11:00,200,566,69,835,0
신리→연산교차로,2023.9.12 11:00,455,264,59,778,0
안락→연산교차로,2023.9.12 11:00,550,0,150,700,0
연산터널→연산교차로,2023.9.12 11:00,258,326,63,647,0
교대→연산교차로,2023.9.12 12:00,291,0,385,676,0
부산시청→연산교차로,2023.9.12 12:00,587,388,244,1219,0
사직운동장→연산교차로,2023.9.12 12:00,177,566,63,806,0
신리→연산교차로,2023.9.12 12:00,414,235,55,704,0
안락→연산교차로,2023.9.12 12:00,503,0,130,633,0
연산터널→연산교차로,2023.9.12 12:00,260,285,39,584,0
교대→연산교차로,2023.9.12 13:00,334,0,468,802,0
부산시청→연산교차로,2023.9.12 13:00,581,419,292,1292,0
사직운동장→연산교차로,2023.9.12 13:00,211,602,84,897,0
신리→연산교차로,2023.9.12 13:00,448,256,49,753,0
안락→연산교차로,2023.9.12 13:00,424,0,133,557,0
연산터널→연산교차로,2023.9.12 13:00,238,277,39,554,0
교대→연산교차로,2023.9.12 14:00,326,0,496,822,0
부산시청→연산교차로,2023.9.12 14:00,593,428,305,1326,0
사직운동장→연산교차로,2023.9.12 14:00,216,646,70,932,0
신리→연산교차로,2023.9.12 14:00,476,264,50,790,0
안락→연산교차로,2023.9.12 14:00,421,0,138,559,0
연산터널→연산교차로,2023.9.12 14:00,235,276,51,562,0
교대→연산교차로,2023.9.12 15:00,352,0,443,795,0
부산시청→연산교차로,2023.9.12 15:00,607,454,278,1339,0
사직운동장→연산교차로,2023.9.12 15:00,220,609,68,897,0
신리→연산교차로,2023.9.12 15:00,469,267,54,790,0
안락→연산교차로,2023.9.12 15:00,412,0,113,525,0
연산터널→연산교차로,2023.9.12 15:00,229,284,35,548,0
교대→연산교차로,2023.9.12 16:00,354,0,468,822,0
부산시청→연산교차로,2023.9.12 16:00,588,518,293,1399,0
사직운동장→연산교차로,2023.9.12 16:00,219,656,66,941,0
신리→연산교차로,2023.9.12 16:00,509,276,60,845,0
안락→연산교차로,2023.9.12 16:00,430,0,81,511,0
연산터널→연산교차로,2023.9.12 16:00,252,261,40,553,0
교대→연산교차로,2023.9.12 17:00,371,0,492,863,0
부산시청→연산교차로,2023.9.12 17:00,643,557,336,1536,0
사직운동장→연산교차로,2023.9.12 17:00,212,715,50,977,0
신리→연산교차로,2023.9.12 17:00,497,300,51,848,0
안락→연산교차로,2023.9.12 17:00,439,0,91,530,0
연산터널→연산교차로,2023.9.12 17:00,232,268,27,527,0
교대→연산교차로,2023.9.12 18:00,359,0,581,940,0
부산시청→연산교차로,2023.9.12 18:00,607,586,342,1535,0
사직운동장→연산교차로,2023.9.12 18:00,240,682,45,967,0
신리→연산교차로,2023.9.12 18:00,474,294,36,804,0
안락→연산교차로,2023.9.12 18:00,458,0,89,547,0
연산터널→연산교차로,2023.9.12 18:00,240,277,64,581,0
교대→연산교차로,2023.9.12 19:00,343,0,442,785,0
부산시청→연산교차로,2023.9.12 19:00,529,445,276,1250,0
사직운동장→연산교차로,2023.9.12 19:00,230,582,54,866,0
신리→연산교차로,2023.9.12 19:00,365,189,39,593,0
안락→연산교차로,2023.9.12 19:00,417,0,85,502,0
연산터널→연산교차로,2023.9.12 19:00,199,257,58,514,0
교대→연산교차로,2023.9.12 20:00,316,0,335,651,0
부산시청→연산교차로,2023.9.12 20:00,460,365,256,1081,0
사직운동장→연산교차로,2023.9.12 20:00,166,528,56,750,0
신리→연산교차로,2023.9.12 20:00,310,185,35,530,0
안락→연산교차로,2023.9.12 20:00,396,0,91,487,0
연산터널→연산교차로,2023.9.12 20:00,221,259,58,538,0
교대→연산교차로,2023.9.12 21:00,277,0,325,602,0
부산시청→연산교차로,2023.9.12 21:00,487,318,220,1025,0
사직운동장→연산교차로,2023.9.12 21:00,184,470,71,725,0
신리→연산교차로,2023.9.12 21:00,319,201,36,556,0
안락→연산교차로,2023.9.12 21:00,396,0,111,507,0
연산터널→연산교차로,2023.9.12 21:00,211,269,68,548,0
교대→연산교차로,2023.9.12 22:00,250,0,244,494,0
부산시청→연산교차로,2023.9.12 22:00,437,263,185,885,0
사직운동장→연산교차로,2023.9.12 22:00,205,403,41,649,0
신리→연산교차로,2023.9.12 22:00,251,170,39,460,0
안락→연산교차로,2023.9.12 22:00,358,0,85,443,0
연산터널→연산교차로,2023.9.12 22:00,195,241,55,491,0
교대→연산교차로,2023.9.12 23:00,189,0,201,390,0
부산시청→연산교차로,2023.9.12 23:00,324,164,113,601,0
사직운동장→연산교차로,2023.9.12 23:00,131,325,36,492,0
신리→연산교차로,2023.9.12 23:00,201,116,19,336,0
안락→연산교차로,2023.9.12 23:00,229,0,72,301,0
연산터널→연산교차로,2023.9.12 23:00,156,198,81,435,0
교대→연산교차로,2023.9.13 00:00,128,0,202,330,0
부산시청→연산교차로,2023.9.13 00:00,252,148,119,519,0
사직운동장→연산교차로,2023.9.13 00:00,81,264,17,362,0
신리→연산교차로,2023.9.13 00:00,164,108,22,294,0
안락→연산교차로,2023.9.13 00:00,198,0,38,236,0
연산터널→연산교차로,2023.9.13 00:00,152,196,92,440,0
교대→연산교차로,2023.9.13 01:00,94,0,162,256,0
부산시청→연산교차로,2023.9.13 01:00,201,101,94,396,0
사직운동장→연산교차로,2023.9.13 01:00,47,182,12,241,0
신리→연산교차로,2023.9.13 01:00,128,71,20,219,0
안락→연산교차로,2023.9.13 01:00,153,0,46,199,0
연산터널→연산교차로,2023.9.13 01:00,112,143,57,312,0
교대→연산교차로,2023.9.13 02:00,77,0,141,218,0
부산시청→연산교차로,2023.9.13 02:00,149,100,60,309,0
사직운동장→연산교차로,2023.9.13 02:00,49,131,3,183,0
신리→연산교차로,2023.9.13 02:00,95,53,7,155,0
안락→연산교차로,2023.9.13 02:00,116,0,26,142,0
연산터널→연산교차로,2023.9.13 02:00,85,118,67,270,0
교대→연산교차로,2023.9.13 03:00,59,0,101,160,0
부산시청→연산교차로,2023.9.13 03:00,139,75,47,261,0
사직운동장→연산교차로,2023.9.13 03:00,36,131,2,169,0
신리→연산교차로,2023.9.13 03:00,67,49,10,126,0
안락→연산교차로,2023.9.13 03:00,91,0,34,125,0
연산터널→연산교차로,2023.9.13 03:00,73,100,42,215,0
교대→연산교차로,2023.9.13 04:00,57,0,93,150,0
부산시청→연산교차로,2023.9.13 04:00,151,62,42,255,0
사직운동장→연산교차로,2023.9.13 04:00,34,132,2,168,0
신리→연산교차로,2023.9.13 04:00,111,44,11,166,0
안락→연산교차로,2023.9.13 04:00,182,0,36,218,0
연산터널→연산교차로,2023.9.13 04:00,73,108,24,205,0
교대→연산교차로,2023.9.13 05:00,77,0,135,212,0
부산시청→연산교차로,2023.9.13 05:00,235,162,75,472,0
사직운동장→연산교차로,2023.9.13 05:00,43,185,10,238,0
신리→연산교차로,2023.9.13 05:00,205,114,11,330,0
안락→연산교차로,2023.9.13 05:00,313,0,67,380,0
연산터널→연산교차로,2023.9.13 05:00,137,149,35,321,0
교대→연산교차로,2023.9.13 06:00,172,0,213,385,0
부산시청→연산교차로,2023.9.13 06:00,388,264,112,764,0
사직운동장→연산교차로,2023.9.13 06:00,90,322,35,447,0
신리→연산교차로,2023.9.13 06:00,349,204,19,572,0
안락→연산교차로,2023.9.13 06:00,506,0,117,623,0
연산터널→연산교차로,2023.9.13 06:00,249,228,41,518,0
교대→연산교차로,2023.9.13 07:00,271,0,389,660,0
부산시청→연산교차로,2023.9.13 07:00,608,394,204,1206,0
사직운동장→연산교차로,2023.9.13 07:00,195,531,49,775,0
신리→연산교차로,2023.9.13 07:00,459,296,25,780,0
안락→연산교차로,2023.9.13 07:00,611,0,75,686,0
연산터널→연산교차로,2023.9.13 07:00,282,368,43,693,0
교대→연산교차로,2023.9.13 08:00,314,0,523,837,0
부산시청→연산교차로,2023.9.13 08:00,602,424,324,1350,0
사직운동장→연산교차로,2023.9.13 08:00,193,642,47,882,0
신리→연산교차로,2023.9.13 08:00,492,335,37,864,0
안락→연산교차로,2023.9.13 08:00,639,0,82,721,0
연산터널→연산교차로,2023.9.13 08:00,329,370,35,734,0
교대→연산교차로,2023.9.13 09:00,293,0,542,835,0
부산시청→연산교차로,2023.9.13 09:00,555,381,284,1220,0
사직운동장→연산교차로,2023.9.13 09:00,179,581,80,840,0
신리→연산교차로,2023.9.13 09:00,489,301,41,831,0
안락→연산교차로,2023.9.13 09:00,594,0,104,698,0
연산터널→연산교차로,2023.9.13 09:00,290,371,36,697,0
교대→연산교차로,2023.9.13 10:00,290,0,492,782,0
부산시청→연산교차로,2023.9.13 10:00,614,370,285,1269,0
사직운동장→연산교차로,2023.9.13 10:00,208,590,63,861,0
신리→연산교차로,2023.9.13 10:00,469,303,56,828,0
안락→연산교차로,2023.9.13 10:00,575,0,138,713,0
연산터널→연산교차로,2023.9.13 10:00,318,334,47,699,0
교대→연산교차로,2023.9.13 11:00,285,0,432,717,0
부산시청→연산교차로,2023.9.13 11:00,560,355,261,1176,0
사직운동장→연산교차로,2023.9.13 11:00,203,550,75,828,0
신리→연산교차로,2023.9.13 11:00,455,263,54,772,0
안락→연산교차로,2023.9.13 11:00,498,0,145,643,0
연산터널→연산교차로,2023.9.13 11:00,272,305,50,627,0
교대→연산교차로,2023.9.13 12:00,279,0,399,678,0
부산시청→연산교차로,2023.9.13 12:00,521,375,246,1142,0
사직운동장→연산교차로,2023.9.13 12:00,180,548,55,783,0
신리→연산교차로,2023.9.13 12:00,388,277,38,703,0
안락→연산교차로,2023.9.13 12:00,500,0,151,651,0
연산터널→연산교차로,2023.9.13 12:00,253,285,58,596,0
교대→연산교차로,2023.9.13 13:00,314,0,471,785,0
부산시청→연산교차로,2023.9.13 13:00,584,442,267,1293,0
사직운동장→연산교차로,2023.9.13 13:00,216,607,60,883,0
신리→연산교차로,2023.9.13 13:00,395,232,48,675,0
안락→연산교차로,2023.9.13 13:00,444,0,120,564,0
연산터널→연산교차로,2023.9.13 13:00,237,261,51,549,0
교대→연산교차로,2023.9.13 14:00,336,0,500,836,0
부산시청→연산교차로,2023.9.13 14:00,554,450,315,1319,0
사직운동장→연산교차로,2023.9.13 14:00,206,599,80,885,0
신리→연산교차로,2023.9.13 14:00,472,279,61,812,0
안락→연산교차로,2023.9.13 14:00,442,0,119,561,0
연산터널→연산교차로,2023.9.13 14:00,239,288,52,579,0
교대→연산교차로,2023.9.13 15:00,363,0,505,868,0
부산시청→연산교차로,2023.9.13 15:00,611,471,283,1365,0
사직운동장→연산교차로,2023.9.13 15:00,234,616,61,911,0
신리→연산교차로,2023.9.13 15:00,476,272,47,795,0
안락→연산교차로,2023.9.13 15:00,420,0,142,562,0
연산터널→연산교차로,2023.9.13 15:00,247,284,53,584,0
교대→연산교차로,2023.9.13 16:00,346,0,501,847,0
부산시청→연산교차로,2023.9.13 16:00,600,528,305,1433,0
사직운동장→연산교차로,2023.9.13 16:00,243,660,47,950,0
신리→연산교차로,2023.9.13 16:00,506,276,54,836,0
안락→연산교차로,2023.9.13 16:00,449,0,100,549,0
연산터널→연산교차로,2023.9.13 16:00,265,284,37,586,0
교대→연산교차로,2023.9.13 17:00,355,0,475,830,0
부산시청→연산교차로,2023.9.13 17:00,633,551,320,1504,0
사직운동장→연산교차로,2023.9.13 17:00,210,701,31,942,0
신리→연산교차로,2023.9.13 17:00,539,297,42,878,0
안락→연산교차로,2023.9.13 17:00,485,0,72,557,0
연산터널→연산교차로,2023.9.13 17:00,252,280,43,575,0
교대→연산교차로,2023.9.13 18:00,352,0,590,942,0
부산시청→연산교차로,2023.9.13 18:00,596,580,308,1484,0
사직운동장→연산교차로,2023.9.13 18:00,243,650,49,942,0
신리→연산교차로,2023.9.13 18:00,545,272,43,860,0
안락→연산교차로,2023.9.13 18:00,451,0,79,530,0
연산터널→연산교차로,2023.9.13 18:00,230,268,54,552,0
교대→연산교차로,2023.9.13 19:00,325,0,418,743,0
부산시청→연산교차로,2023.9.13 19:00,573,440,280,1293,0
사직운동장→연산교차로,2023.9.13 19:00,208,559,65,832,0
신리→연산교차로,2023.9.13 19:00,396,240,35,671,0
안락→연산교차로,2023.9.13 19:00,426,0,87,513,0
연산터널→연산교차로,2023.9.13 19:00,230,260,50,540,0
교대→연산교차로,2023.9.13 20:00,324,0,389,713,0
부산시청→연산교차로,2023.9.13 20:00,501,373,237,1111,0
사직운동장→연산교차로,2023.9.13 20:00,167,514,82,763,0
신리→연산교차로,2023.9.13 20:00,333,187,35,555,0
안락→연산교차로,2023.9.13 20:00,428,0,86,514,0
연산터널→연산교차로,2023.9.13 20:00,223,280,48,551,0
교대→연산교차로,2023.9.13 21:00,289,0,272,561,0
부산시청→연산교차로,2023.9.13 21:00,466,336,212,1014,0
사직운동장→연산교차로,2023.9.13 21:00,193,437,21,651,0
신리→연산교차로,2023.9.13 21:00,305,214,34,553,0
안락→연산교차로,2023.9.13 21:00,428,0,89,517,0
연산터널→연산교차로,2023.9.13 21:00,217,274,49,540,0
교대→연산교차로,2023.9.13 22:00,271,0,234,505,0
부산시청→연산교차로,2023.9.13 22:00,381,287,174,842,0
사직운동장→연산교차로,2023.9.13 22:00,156,358,4,518,0
신리→연산교차로,2023.9.13 22:00,248,184,21,453,0
안락→연산교차로,2023.9.13 22:00,323,0,96,419,0
연산터널→연산교차로,2023.9.13 22:00,199,242,42,483,0
교대→연산교차로,2023.9.13 23:00,195,0,179,374,0
부산시청→연산교차로,2023.9.13 23:00,338,195,112,645,0
사직운동장→연산교차로,2023.9.13 23:00,95,269,22,386,0
신리→연산교차로,2023.9.13 23:00,213,135,24,372,0
안락→연산교차로,2023.9.13 23:00,272,0,76,348,0
연산터널→연산교차로,2023.9.13 23:00,134,173,28,335,0
교대→연산교차로,2023.9.14 00:00,116,0,202,318,0
부산시청→연산교차로,2023.9.14 00:00,242,136,107,485,0
사직운동장→연산교차로,2023.9.14 00:00,73,232,20,325,0
신리→연산교차로,2023.9.14 00:00,140,105,13,258,0
안락→연산교차로,2023.9.14 00:00,216,0,45,261,0
연산터널→연산교차로,2023.9.14 00:00,114,162,51,327,0
교대→연산교차로,2023.9.14 01:00,94,0,165,259,0
부산시청→연산교차로,2023.9.14 01:00,198,122,81,401,0
사직운동장→연산교차로,2023.9.14 01:00,61,179,8,248,0
신리→연산교차로,2023.9.14 01:00,134,69,27,230,0
안락→연산교차로,2023.9.14 01:00,152,0,42,194,0
연산터널→연산교차로,2023.9.14 01:00,109,144,47,300,0
교대→연산교차로,2023.9.14 02:00,77,0,133,210,0
부산시청→연산교차로,2023.9.14 02:00,155,82,57,294,0
사직운동장→연산교차로,2023.9.14 02:00,42,139,4,185,0
신리→연산교차로,2023.9.14 02:00,67,45,8,120,0
안락→연산교차로,2023.9.14 02:00,110,0,33,143,0
연산터널→연산교차로,2023.9.14 02:00,74,94,41,209,0
교대→연산교차로,2023.9.14 03:00,55,0,94,149,0
부산시청→연산교차로,2023.9.14 03:00,138,82,52,272,0
사직운동장→연산교차로,2023.9.14 03:00,42,142,3,187,0
신리→연산교차로,2023.9.14 03:00,74,41,10,125,0
안락→연산교차로,2023.9.14 03:00,108,0,34,142,0
연산터널→연산교차로,2023.9.14 03:00,85,112,30,227,0
교대→연산교차로,2023.9.14 04:00,63,0,59,122,0
부산시청→연산교차로,2023.9.14 04:00,141,79,39,259,0
사직운동장→연산교차로,2023.9.14 04:00,18,104,3,125,0
신리→연산교차로,2023.9.14 04:00,96,39,5,140,0
안락→연산교차로,2023.9.14 04:00,162,0,36,198,0
연산터널→연산교차로,2023.9.14 04:00,83,92,19,194,0
교대→연산교차로,2023.9.14 05:00,82,0,115,197,0
부산시청→연산교차로,2023.9.14 05:00,222,127,82,431,0
사직운동장→연산교차로,2023.9.14 05:00,49,171,7,227,0
신리→연산교차로,2023.9.14 05:00,211,93,9,313,0
안락→연산교차로,2023.9.14 05:00,306,0,41,347,0
연산터널→연산교차로,2023.9.14 05:00,123,127,25,275,0
교대→연산교차로,2023.9.14 06:00,158,0,217,375,0
부산시청→연산교차로,2023.9.14 06:00,374,254,114,742,0
사직운동장→연산교차로,2023.9.14 06:00,94,289,37,420,0
신리→연산교차로,2023.9.14 06:00,327,196,18,541,0
안락→연산교차로,2023.9.14 06:00,448,0,105,553,0
연산터널→연산교차로,2023.9.14 06:00,223,213,32,468,0
교대→연산교차로,2023.9.14 07:00,265,0,371,636,0
부산시청→연산교차로,2023.9.14 07:00,580,363,200,1143,0
사직운동장→연산교차로,2023.9.14 07:00,188,513,50,751,0
신리→연산교차로,2023.9.14 07:00,451,302,22,775,0
안락→연산교차로,2023.9.14 07:00,626,0,90,716,0
연산터널→연산교차로,2023.9.14 07:00,275,393,41,709,0
교대→연산교차로,2023.9.14 08:00,327,0,473,800,0
부산시청→연산교차로,2023.9.14 08:00,571,437,384,1392,0
사직운동장→연산교차로,2023.9.14 08:00,203,648,42,893,0
신리→연산교차로,2023.9.14 08:00,518,346,23,887,0
안락→연산교차로,2023.9.14 08:00,618,0,92,710,0
연산터널→연산교차로,2023.9.14 08:00,318,395,31,744,0
교대→연산교차로,2023.9.14 09:00,303,0,470,773,0
부산시청→연산교차로,2023.9.14 09:00,540,376,285,1201,0
사직운동장→연산교차로,2023.9.14 09:00,195,585,71,851,0
신리→연산교차로,2023.9.14 09:00,440,359,45,844,0
안락→연산교차로,2023.9.14 09:00,576,0,113,689,0
연산터널→연산교차로,2023.9.14 09:00,328,362,40,730,0
교대→연산교차로,2023.9.14 10:00,289,0,499,788,0
부산시청→연산교차로,2023.9.14 10:00,543,371,261,1175,0
사직운동장→연산교차로,2023.9.14 10:00,173,568,77,818,0
신리→연산교차로,2023.9.14 10:00,472,303,54,829,0
안락→연산교차로,2023.9.14 10:00,557,0,122,679,0
연산터널→연산교차로,2023.9.14 10:00,303,342,45,690,0
교대→연산교차로,2023.9.14 11:00,284,0,415,699,0
부산시청→연산교차로,2023.9.14 11:00,586,354,281,1221,0
사직운동장→연산교차로,2023.9.14 11:00,195,554,79,828,0
신리→연산교차로,2023.9.14 11:00,438,243,59,740,0
안락→연산교차로,2023.9.14 11:00,549,0,118,667,0
연산터널→연산교차로,2023.9.14 11:00,233,322,52,607,0
교대→연산교차로,2023.9.14 12:00,305,0,401,706,0
부산시청→연산교차로,2023.9.14 12:00,567,369,268,1204,0
사직운동장→연산교차로,2023.9.14 12:00,187,557,53,797,0
신리→연산교차로,2023.9.14 12:00,375,256,56,687,0
안락→연산교차로,2023.9.14 12:00,494,0,162,656,0
연산터널→연산교차로,2023.9.14 12:00,269,280,36,585,0
교대→연산교차로,2023.9.14 13:00,318,0,375,693,0
부산시청→연산교차로,2023.9.14 13:00,563,484,257,1304,0
사직운동장→연산교차로,2023.9.14 13:00,208,582,62,852,0
신리→연산교차로,2023.9.14 13:00,418,285,56,759,0
안락→연산교차로,2023.9.14 13:00,435,0,114,549,0
연산터널→연산교차로,2023.9.14 13:00,236,273,37,546,0
교대→연산교차로,2023.9.14 14:00,316,0,499,815,0
부산시청→연산교차로,2023.9.14 14:00,602,494,289,1385,0
사직운동장→연산교차로,2023.9.14 14:00,205,633,88,926,0
신리→연산교차로,2023.9.14 14:00,463,303,48,814,0
안락→연산교차로,2023.9.14 14:00,436,0,123,559,0
연산터널→연산교차로,2023.9.14 14:00,226,275,45,546,0
교대→연산교차로,2023.9.14 15:00,344,0,440,784,0
부산시청→연산교차로,2023.9.14 15:00,582,502,293,1377,0
사직운동장→연산교차로,2023.9.14 15:00,235,624,51,910,0
신리→연산교차로,2023.9.14 15:00,467,280,54,801,0
안락→연산교차로,2023.9.14 15:00,406,0,111,517,0
연산터널→연산교차로,2023.9.14 15:00,240,241,38,519,0
교대→연산교차로,2023.9.14 16:00,330,0,468,798,0
부산시청→연산교차로,2023.9.14 16:00,573,497,273,1343,0
사직운동장→연산교차로,2023.9.14 16:00,204,651,39,894,0
신리→연산교차로,2023.9.14 16:00,459,271,44,774,0
안락→연산교차로,2023.9.14 16:00,400,0,95,495,0
연산터널→연산교차로,2023.9.14 16:00,208,271,52,531,0
교대→연산교차로,2023.9.14 17:00,359,0,513,872,0
부산시청→연산교차로,2023.9.14 17:00,592,534,314,1440,0
사직운동장→연산교차로,2023.9.14 17:00,226,699,34,959,0
신리→연산교차로,2023.9.14 17:00,521,294,50,865,0
안락→연산교차로,2023.9.14 17:00,433,0,96,529,0
연산터널→연산교차로,2023.9.14 17:00,247,270,41,558,0
교대→연산교차로,2023.9.14 18:00,353,0,557,910,0
부산시청→연산교차로,2023.9.14 18:00,590,574,296,1460,0
사직운동장→연산교차로,2023.9.14 18:00,204,643,59,906,0
신리→연산교차로,2023.9.14 18:00,483,240,45,768,0
안락→연산교차로,2023.9.14 18:00,432,0,90,522,0
연산터널→연산교차로,2023.9.14 18:00,233,270,34,537,0
교대→연산교차로,2023.9.14 19:00,336,0,398,734,0
부산시청→연산교차로,2023.9.14 19:00,533,431,318,1282,0
사직운동장→연산교차로,2023.9.14 19:00,193,618,43,854,0
신리→연산교차로,2023.9.14 19:00,393,184,25,602,0
안락→연산교차로,2023.9.14 19:00,396,0,87,483,0
연산터널→연산교차로,2023.9.14 19:00,192,282,54,528,0
교대→연산교차로,2023.9.14 20:00,308,0,355,663,0
부산시청→연산교차로,2023.9.14 20:00,535,397,269,1201,0
사직운동장→연산교차로,2023.9.14 20:00,165,510,69,744,0
신리→연산교차로,2023.9.14 20:00,306,175,35,516,0
안락→연산교차로,2023.9.14 20:00,377,0,81,458,0
연산터널→연산교차로,2023.9.14 20:00,207,261,57,525,0
교대→연산교차로,2023.9.14 21:00,278,0,320,598,0
부산시청→연산교차로,2023.9.14 21:00,485,345,218,1048,0
사직운동장→연산교차로,2023.9.14 21:00,181,428,66,675,0
신리→연산교차로,2023.9.14 21:00,289,178,19,486,0
안락→연산교차로,2023.9.14 21:00,348,0,91,439,0
연산터널→연산교차로,2023.9.14 21:00,239,290,57,586,0
교대→연산교차로,2023.9.14 22:00,252,0,260,512,0
부산시청→연산교차로,2023.9.14 22:00,414,277,176,867,0
사직운동장→연산교차로,2023.9.14 22:00,135,365,71,571,0
신리→연산교차로,2023.9.14 22:00,247,155,20,422,0
안락→연산교차로,2023.9.14 22:00,357,0,97,454,0
연산터널→연산교차로,2023.9.14 22:00,228,246,43,517,0
교대→연산교차로,2023.9.14 23:00,189,0,201,390,0
부산시청→연산교차로,2023.9.14 23:00,321,187,128,636,0
사직운동장→연산교차로,2023.9.14 23:00,101,307,55,463,0
신리→연산교차로,2023.9.14 23:00,209,135,19,363,0
안락→연산교차로,2023.9.14 23:00,266,0,63,329,0
연산터널→연산교차로,2023.9.14 23:00,155,205,54,414,0
교대→연산교차로,2023.9.15 00:00,153,0,168,321,0
부산시청→연산교차로,2023.9.15 00:00,252,136,107,495,0
사직운동장→연산교차로,2023.9.15 00:00,62,215,41,318,0
신리→연산교차로,2023.9.15 00:00,171,107,16,294,0
안락→연산교차로,2023.9.15 00:00,225,0,49,274,0
연산터널→연산교차로,2023.9.15 00:00,133,160,46,339,0
교대→연산교차로,2023.9.15 01:00,91,0,154,245,0
부산시청→연산교차로,2023.9.15 01:00,166,117,74,357,0
사직운동장→연산교차로,2023.9.15 01:00,43,187,34,264,0
신리→연산교차로,2023.9.15 01:00,133,77,18,228,0
안락→연산교차로,2023.9.15 01:00,144,0,32,176,0
연산터널→연산교차로,2023.9.15 01:00,98,130,36,264,0
교대→연산교차로,2023.9.15 02:00,75,0,133,208,0
부산시청→연산교차로,2023.9.15 02:00,157,99,58,314,0
사직운동장→연산교차로,2023.9.15 02:00,56,155,20,231,0
신리→연산교차로,2023.9.15 02:00,82,51,10,143,0
안락→연산교차로,2023.9.15 02:00,114,0,33,147,0
연산터널→연산교차로,2023.9.15 02:00,83,118,29,230,0
교대→연산교차로,2023.9.15 03:00,75,0,130,205,0
부산시청→연산교차로,2023.9.15 03:00,162,87,53,302,0
사직운동장→연산교차로,2023.9.15 03:00,31,136,23,190,0
신리→연산교차로,2023.9.15 03:00,73,52,11,136,0
안락→연산교차로,2023.9.15 03:00,111,0,31,142,0
연산터널→연산교차로,2023.9.15 03:00,96,96,49,241,0
교대→연산교차로,2023.9.15 04:00,54,0,76,130,0
부산시청→연산교차로,2023.9.15 04:00,155,71,42,268,0
사직운동장→연산교차로,2023.9.15 04:00,33,132,14,179,0
신리→연산교차로,2023.9.15 04:00,91,56,7,154,0
안락→연산교차로,2023.9.15 04:00,166,0,42,208,0
연산터널→연산교차로,2023.9.15 04:00,75,79,25,179,0
교대→연산교차로,2023.9.15 05:00,90,0,125,215,0
부산시청→연산교차로,2023.9.15 05:00,223,146,79,448,0
사직운동장→연산교차로,2023.9.15 05:00,45,183,19,247,0
신리→연산교차로,2023.9.15 05:00,192,102,10,304,0
안락→연산교차로,2023.9.15 05:00,308,0,46,354,0
연산터널→연산교차로,2023.9.15 05:00,123,165,26,314,0
교대→연산교차로,2023.9.15 06:00,167,0,219,386,0
부산시청→연산교차로,2023.9.15 06:00,353,256,95,704,0
사직운동장→연산교차로,2023.9.15 06:00,83,294,42,419,0
신리→연산교차로,2023.9.15 06:00,328,203,18,549,0
안락→연산교차로,2023.9.15 06:00,512,0,100,612,0
연산터널→연산교차로,2023.9.15 06:00,241,240,49,530,0
교대→연산교차로,2023.9.15 07:00,276,0,380,656,0
부산시청→연산교차로,2023.9.15 07:00,545,383,207,1135,0
사직운동장→연산교차로,2023.9.15 07:00,173,520,57,750,0
신리→연산교차로,2023.9.15 07:00,466,287,23,776,0
안락→연산교차로,2023.9.15 07:00,628,0,104,732,0
연산터널→연산교차로,2023.9.15 07:00,286,373,30,689,0
교대→연산교차로,2023.9.15 08:00,319,0,535,854,0
부산시청→연산교차로,2023.9.15 08:00,602,441,331,1374,0
사직운동장→연산교차로,2023.9.15 08:00,202,656,54,912,0
신리→연산교차로,2023.9.15 08:00,515,333,35,883,0
안락→연산교차로,2023.9.15 08:00,582,0,86,668,0
연산터널→연산교차로,2023.9.15 08:00,310,400,33,743,0
교대→연산교차로,2023.9.15 09:00,301,0,503,804,0
부산시청→연산교차로,2023.9.15 09:00,517,370,312,1199,0
사직운동장→연산교차로,2023.9.15 09:00,189,602,86,877,0
신리→연산교차로,2023.9.15 09:00,441,326,54,821,0
안락→연산교차로,2023.9.15 09:00,561,0,129,690,0
연산터널→연산교차로,2023.9.15 09:00,321,350,48,719,0
교대→연산교차로,2023.9.15 10:00,305,0,476,781,0
부산시청→연산교차로,2023.9.15 10:00,577,357,267,1201,0
사직운동장→연산교차로,2023.9.15 10:00,201,593,52,846,0
신리→연산교차로,2023.9.15 10:00,462,264,65,791,0
안락→연산교차로,2023.9.15 10:00,561,0,129,690,0
연산터널→연산교차로,2023.9.15 10:00,306,336,62,704,0
교대→연산교차로,2023.9.15 11:00,288,0,480,768,0
부산시청→연산교차로,2023.9.15 11:00,537,364,280,1181,0
사직운동장→연산교차로,2023.9.15 11:00,209,553,49,811,0
신리→연산교차로,2023.9.15 11:00,470,253,63,786,0
안락→연산교차로,2023.9.15 11:00,517,0,145,662,0
연산터널→연산교차로,2023.9.15 11:00,277,311,61,649,0
교대→연산교차로,2023.9.15 12:00,288,0,443,731,0
부산시청→연산교차로,2023.9.15 12:00,555,360,255,1170,0
사직운동장→연산교차로,2023.9.15 12:00,207,537,59,803,0
신리→연산교차로,2023.9.15 12:00,403,262,53,718,0
안락→연산교차로,2023.9.15 12:00,484,0,151,635,0
연산터널→연산교차로,2023.9.15 12:00,275,269,50,594,0
교대→연산교차로,2023.9.15 13:00,312,0,450,762,0
부산시청→연산교차로,2023.9.15 13:00,578,456,249,1283,0
사직운동장→연산교차로,2023.9.15 13:00,210,616,71,897,0
신리→연산교차로,2023.9.15 13:00,426,266,57,749,0
안락→연산교차로,2023.9.15 13:00,461,0,120,581,0
연산터널→연산교차로,2023.9.15 13:00,246,287,38,571,0
교대→연산교차로,2023.9.15 14:00,105,0,164,269,0
부산시청→연산교차로,2023.9.15 14:00,203,151,86,440,0
사직운동장→연산교차로,2023.9.15 14:00,62,188,18,268,0
신리→연산교차로,2023.9.15 14:00,163,100,17,280,0
안락→연산교차로,2023.9.15 14:00,137,0,32,169,0
연산터널→연산교차로,2023.9.15 14:00,70,77,14,161,0
교대→연산교차로,2023.9.15 15:00,345,0,526,871,0
부산시청→연산교차로,2023.9.15 15:00,591,499,326,1416,0
사직운동장→연산교차로,2023.9.15 15:00,220,629,59,908,0
신리→연산교차로,2023.9.15 15:00,498,258,60,816,0
안락→연산교차로,2023.9.15 15:00,430,0,126,556,0
연산터널→연산교차로,2023.9.15 15:00,245,267,38,550,0
교대→연산교차로,2023.9.15 16:00,355,0,526,881,0
부산시청→연산교차로,2023.9.15 16:00,605,559,316,1480,0
사직운동장→연산교차로,2023.9.15 16:00,217,671,52,940,0
신리→연산교차로,2023.9.15 16:00,498,297,49,844,0
안락→연산교차로,2023.9.15 16:00,459,0,103,562,0
연산터널→연산교차로,2023.9.15 16:00,258,280,43,581,0
교대→연산교차로,2023.9.15 17:00,367,0,511,878,0
부산시청→연산교차로,2023.9.15 17:00,591,556,323,1470,0
사직운동장→연산교차로,2023.9.15 17:00,225,676,39,940,0
신리→연산교차로,2023.9.15 17:00,526,299,53,878,0
안락→연산교차로,2023.9.15 17:00,452,0,102,554,0
연산터널→연산교차로,2023.9.15 17:00,244,275,57,576,0
교대→연산교차로,2023.9.15 18:00,361,0,526,887,0
부산시청→연산교차로,2023.9.15 18:00,593,581,347,1521,0
사직운동장→연산교차로,2023.9.15 18:00,230,690,46,966,0
신리→연산교차로,2023.9.15 18:00,524,256,42,822,0
안락→연산교차로,2023.9.15 18:00,435,0,90,525,0
연산터널→연산교차로,2023.9.15 18:00,219,292,58,569,0
교대→연산교차로,2023.9.15 19:00,333,0,417,750,0
부산시청→연산교차로,2023.9.15 19:00,553,460,292,1305,0
사직운동장→연산교차로,2023.9.15 19:00,202,574,68,844,0
신리→연산교차로,2023.9.15 19:00,384,248,24,656,0
안락→연산교차로,2023.9.15 19:00,451,0,89,540,0
연산터널→연산교차로,2023.9.15 19:00,239,245,54,538,0
교대→연산교차로,2023.9.15 20:00,319,0,413,732,0
부산시청→연산교차로,2023.9.15 20:00,521,353,257,1131,0
사직운동장→연산교차로,2023.9.15 20:00,173,526,78,777,0
신리→연산교차로,2023.9.15 20:00,352,209,37,598,0
안락→연산교차로,2023.9.15 20:00,425,0,86,511,0
연산터널→연산교차로,2023.9.15 20:00,210,275,56,541,0
교대→연산교차로,2023.9.15 21:00,297,0,345,642,0
부산시청→연산교차로,2023.9.15 21:00,526,345,241,1112,0
사직운동장→연산교차로,2023.9.15 21:00,148,481,83,712,0
신리→연산교차로,2023.9.15 21:00,351,222,42,615,0
안락→연산교차로,2023.9.15 21:00,436,0,102,538,0
연산터널→연산교차로,2023.9.15 21:00,264,292,70,626,0
교대→연산교차로,2023.9.15 22:00,270,0,335,605,0
부산시청→연산교차로,2023.9.15 22:00,440,283,201,924,0
사직운동장→연산교차로,2023.9.15 22:00,183,429,70,682,0
신리→연산교차로,2023.9.15 22:00,293,170,30,493,0
안락→연산교차로,2023.9.15 22:00,340,0,111,451,0
연산터널→연산교차로,2023.9.15 22:00,241,286,75,602,0
교대→연산교차로,2023.9.15 23:00,241,0,233,474,0
부산시청→연산교차로,2023.9.15 23:00,382,249,127,758,0
사직운동장→연산교차로,2023.9.15 23:00,138,330,47,515,0
신리→연산교차로,2023.9.15 23:00,250,144,17,411,0
안락→연산교차로,2023.9.15 23:00,307,0,88,395,0
연산터널→연산교차로,2023.9.15 23:00,164,201,59,424,0
교대→연산교차로,2023.9.16 00:00,190,0,200,390,0
부산시청→연산교차로,2023.9.16 00:00,347,214,121,682,0
사직운동장→연산교차로,2023.9.16 00:00,93,303,44,440,0
신리→연산교차로,2023.9.16 00:00,240,171,21,432,0
안락→연산교차로,2023.9.16 00:00,277,0,77,354,0
연산터널→연산교차로,2023.9.16 00:00,147,206,36,389,0
교대→연산교차로,2023.9.16 01:00,147,0,247,394,0
부산시청→연산교차로,2023.9.16 01:00,255,155,97,507,0
사직운동장→연산교차로,2023.9.16 01:00,75,209,30,314,0
신리→연산교차로,2023.9.16 01:00,162,102,16,280,0
안락→연산교차로,2023.9.16 01:00,233,0,53,286,0
연산터널→연산교차로,2023.9.16 01:00,114,158,32,304,0
교대→연산교차로,2023.9.16 02:00,128,0,213,341,0
부산시청→연산교차로,2023.9.16 02:00,239,158,92,489,0
사직운동장→연산교차로,2023.9.16 02:00,49,207,23,279,0
신리→연산교차로,2023.9.16 02:00,138,82,8,228,0
안락→연산교차로,2023.9.16 02:00,184,0,50,234,0
연산터널→연산교차로,2023.9.16 02:00,110,169,42,321,0
교대→연산교차로,2023.9.16 03:00,106,0,171,277,0
부산시청→연산교차로,2023.9.16 03:00,216,109,68,393,0
사직운동장→연산교차로,2023.9.16 03:00,41,154,10,205,0
신리→연산교차로,2023.9.16 03:00,104,72,9,185,0
안락→연산교차로,2023.9.16 03:00,122,0,45,167,0
연산터널→연산교차로,2023.9.16 03:00,102,112,30,244,0
교대→연산교차로,2023.9.16 04:00,77,0,116,193,0
부산시청→연산교차로,2023.9.16 04:00,204,90,65,359,0
사직운동장→연산교차로,2023.9.16 04:00,44,118,12,174,0
신리→연산교차로,2023.9.16 04:00,108,45,6,159,0
안락→연산교차로,2023.9.16 04:00,201,0,52,253,0
연산터널→연산교차로,2023.9.16 04:00,88,129,26,243,0
교대→연산교차로,2023.9.16 05:00,82,0,137,219,0
부산시청→연산교차로,2023.9.16 05:00,256,184,74,514,0
사직운동장→연산교차로,2023.9.16 05:00,68,141,17,226,0
신리→연산교차로,2023.9.16 05:00,200,102,8,310,0
안락→연산교차로,2023.9.16 05:00,276,0,64,340,0
연산터널→연산교차로,2023.9.16 05:00,148,153,25,326,0
교대→연산교차로,2023.9.16 06:00,169,0,188,357,0
부산시청→연산교차로,2023.9.16 06:00,332,260,95,687,0
사직운동장→연산교차로,2023.9.16 06:00,89,238,55,382,0
신리→연산교차로,2023.9.16 06:00,323,181,14,518,0
안락→연산교차로,2023.9.16 06:00,368,0,82,450,0
연산터널→연산교차로,2023.9.16 06:00,214,161,32,407,0
교대→연산교차로,2023.9.16 07:00,201,0,216,417,0
부산시청→연산교차로,2023.9.16 07:00,430,282,129,841,0
사직운동장→연산교차로,2023.9.16 07:00,132,339,37,508,0
신리→연산교차로,2023.9.16 07:00,331,165,28,524,0
안락→연산교차로,2023.9.16 07:00,430,0,88,518,0
연산터널→연산교차로,2023.9.16 07:00,202,218,50,470,0
교대→연산교차로,2023.9.16 08:00,252,0,377,629,0
부산시청→연산교차로,2023.9.16 08:00,476,331,231,1038,0
사직운동장→연산교차로,2023.9.16 08:00,180,549,40,769,0
신리→연산교차로,2023.9.16 08:00,466,265,34,765,0
안락→연산교차로,2023.9.16 08:00,525,0,119,644,0
연산터널→연산교차로,2023.9.16 08:00,286,300,54,640,0
교대→연산교차로,2023.9.16 09:00,280,0,358,638,0
부산시청→연산교차로,2023.9.16 09:00,523,367,272,1162,0
사직운동장→연산교차로,2023.9.16 09:00,185,589,55,829,0
신리→연산교차로,2023.9.16 09:00,472,276,64,812,0
안락→연산교차로,2023.9.16 09:00,572,0,112,684,0
연산터널→연산교차로,2023.9.16 09:00,299,330,56,685,0
교대→연산교차로,2023.9.16 10:00,273,0,422,695,0
부산시청→연산교차로,2023.9.16 10:00,578,356,269,1203,0
사직운동장→연산교차로,2023.9.16 10:00,196,577,41,814,0
신리→연산교차로,2023.9.16 10:00,473,280,69,822,0
안락→연산교차로,2023.9.16 10:00,527,0,145,672,0
연산터널→연산교차로,2023.9.16 10:00,267,321,51,639,0
교대→연산교차로,2023.9.16 11:00,291,0,434,725,0
부산시청→연산교차로,2023.9.16 11:00,482,367,268,1117,0
사직운동장→연산교차로,2023.9.16 11:00,180,567,40,787,0
신리→연산교차로,2023.9.16 11:00,415,265,81,761,0
안락→연산교차로,2023.9.16 11:00,485,0,131,616,0
연산터널→연산교차로,2023.9.16 11:00,266,322,61,649,0
교대→연산교차로,2023.9.16 12:00,274,0,397,671,0
부산시청→연산교차로,2023.9.16 12:00,543,361,319,1223,0
사직운동장→연산교차로,2023.9.16 12:00,187,608,28,823,0
신리→연산교차로,2023.9.16 12:00,425,242,95,762,0
안락→연산교차로,2023.9.16 12:00,506,0,198,704,0
연산터널→연산교차로,2023.9.16 12:00,275,321,61,657,0
교대→연산교차로,2023.9.16 13:00,355,0,478,833,0
부산시청→연산교차로,2023.9.16 13:00,571,490,315,1376,0
사직운동장→연산교차로,2023.9.16 13:00,215,657,26,898,0
신리→연산교차로,2023.9.16 13:00,517,258,64,839,0
안락→연산교차로,2023.9.16 13:00,454,0,119,573,0
연산터널→연산교차로,2023.9.16 13:00,224,276,53,553,0
교대→연산교차로,2023.9.16 14:00,358,0,466,824,0
부산시청→연산교차로,2023.9.16 14:00,574,488,342,1404,0
사직운동장→연산교차로,2023.9.16 14:00,198,658,25,881,0
신리→연산교차로,2023.9.16 14:00,444,268,63,775,0
안락→연산교차로,2023.9.16 14:00,456,0,88,544,0
연산터널→연산교차로,2023.9.16 14:00,211,275,51,537,0
교대→연산교차로,2023.9.16 15:00,359,0,507,866,0
부산시청→연산교차로,2023.9.16 15:00,587,488,323,1398,0
사직운동장→연산교차로,2023.9.16 15:00,243,658,27,928,0
신리→연산교차로,2023.9.16 15:00,461,275,65,801,0
안락→연산교차로,2023.9.16 15:00,439,0,95,534,0
연산터널→연산교차로,2023.9.16 15:00,242,269,26,537,0
교대→연산교차로,2023.9.16 16:00,339,0,445,784,0
부산시청→연산교차로,2023.9.16 16:00,590,499,309,1398,0
사직운동장→연산교차로,2023.9.16 16:00,244,639,21,904,0
신리→연산교차로,2023.9.16 16:00,466,277,43,786,0
안락→연산교차로,2023.9.16 16:00,433,0,86,519,0
연산터널→연산교차로,2023.9.16 16:00,236,262,47,545,0
교대→연산교차로,2023.9.16 17:00,322,0,418,740,0
부산시청→연산교차로,2023.9.16 17:00,566,503,330,1399,0
사직운동장→연산교차로,2023.9.16 17:00,228,622,29,879,0
신리→연산교차로,2023.9.16 17:00,404,257,43,704,0
안락→연산교차로,2023.9.16 17:00,422,0,121,543,0
연산터널→연산교차로,2023.9.16 17:00,214,265,38,517,0
교대→연산교차로,2023.9.16 18:00,341,0,427,768,0
부산시청→연산교차로,2023.9.16 18:00,550,480,271,1301,0
사직운동장→연산교차로,2023.9.16 18:00,225,593,28,846,0
신리→연산교차로,2023.9.16 18:00,410,263,21,694,0
안락→연산교차로,2023.9.16 18:00,431,0,89,520,0
연산터널→연산교차로,2023.9.16 18:00,232,258,43,533,0
교대→연산교차로,2023.9.16 19:00,289,0,343,632,0
부산시청→연산교차로,2023.9.16 19:00,493,368,209,1070,0
사직운동장→연산교차로,2023.9.16 19:00,167,488,45,700,0
신리→연산교차로,2023.9.16 19:00,344,232,14,590,0
안락→연산교차로,2023.9.16 19:00,437,0,94,531,0
연산터널→연산교차로,2023.9.16 19:00,220,260,29,509,0
교대→연산교차로,2023.9.16 20:00,286,0,281,567,0
부산시청→연산교차로,2023.9.16 20:00,480,350,190,1020,0
사직운동장→연산교차로,2023.9.16 20:00,171,421,78,670,0
신리→연산교차로,2023.9.16 20:00,311,164,29,504,0
안락→연산교차로,2023.9.16 20:00,359,0,118,477,0
연산터널→연산교차로,2023.9.16 20:00,203,269,55,527,0
교대→연산교차로,2023.9.16 21:00,281,0,283,564,0
부산시청→연산교차로,2023.9.16 21:00,487,304,148,939,0
사직운동장→연산교차로,2023.9.16 21:00,158,403,59,620,0
신리→연산교차로,2023.9.16 21:00,323,216,19,558,0
안락→연산교차로,2023.9.16 21:00,374,0,74,448,0
연산터널→연산교차로,2023.9.16 21:00,206,251,52,509,0
교대→연산교차로,2023.9.16 22:00,203,0,250,453,0
부산시청→연산교차로,2023.9.16 22:00,368,261,157,786,0
사직운동장→연산교차로,2023.9.16 22:00,130,343,49,522,0
신리→연산교차로,2023.9.16 22:00,262,168,16,446,0
안락→연산교차로,2023.9.16 22:00,328,0,76,404,0
연산터널→연산교차로,2023.9.16 22:00,186,215,34,435,0
교대→연산교차로,2023.9.16 23:00,205,0,205,410,0
부산시청→연산교차로,2023.9.16 23:00,321,178,111,610,0
사직운동장→연산교차로,2023.9.16 23:00,87,275,50,412,0
신리→연산교차로,2023.9.16 23:00,240,132,14,386,0
안락→연산교차로,2023.9.16 23:00,259,0,84,343,0
연산터널→연산교차로,2023.9.16 23:00,152,179,41,372,0
교대→연산교차로,2023.9.17 00:00,137,0,200,337,1
부산시청→연산교차로,2023.9.17 00:00,261,177,100,538,1
사직운동장→연산교차로,2023.9.17 00:00,68,221,29,318,1
신리→연산교차로,2023.9.17 00:00,193,103,17,313,1
안락→연산교차로,2023.9.17 00:00,199,0,62,261,1
연산터널→연산교차로,2023.9.17 00:00,136,144,34,314,1
교대→연산교차로,2023.9.17 01:00,131,0,174,305,1
부산시청→연산교차로,2023.9.17 01:00,240,159,76,475,1
사직운동장→연산교차로,2023.9.17 01:00,76,178,14,268,1
신리→연산교차로,2023.9.17 01:00,151,112,9,272,1
안락→연산교차로,2023.9.17 01:00,205,0,46,251,1
연산터널→연산교차로,2023.9.17 01:00,99,163,29,291,1
교대→연산교차로,2023.9.17 02:00,116,0,155,271,1
부산시청→연산교차로,2023.9.17 02:00,231,137,106,474,1
사직운동장→연산교차로,2023.9.17 02:00,45,150,4,199,1
신리→연산교차로,2023.9.17 02:00,119,78,13,210,1
안락→연산교차로,2023.9.17 02:00,173,0,44,217,1
연산터널→연산교차로,2023.9.17 02:00,88,139,13,240,1
교대→연산교차로,2023.9.17 03:00,86,0,140,226,1
부산시청→연산교차로,2023.9.17 03:00,181,117,62,360,1
사직운동장→연산교차로,2023.9.17 03:00,48,127,16,191,1
신리→연산교차로,2023.9.17 03:00,85,58,8,151,1
안락→연산교차로,2023.9.17 03:00,114,0,33,147,1
연산터널→연산교차로,2023.9.17 03:00,96,107,14,217,1
교대→연산교차로,2023.9.17 04:00,86,0,103,189,1
부산시청→연산교차로,2023.9.17 04:00,145,90,44,279,1
사직운동장→연산교차로,2023.9.17 04:00,46,115,8,169,1
신리→연산교차로,2023.9.17 04:00,107,50,8,165,1
안락→연산교차로,2023.9.17 04:00,120,0,32,152,1
연산터널→연산교차로,2023.9.17 04:00,76,119,7,202,1
교대→연산교차로,2023.9.17 05:00,56,0,97,153,1
부산시청→연산교차로,2023.9.17 05:00,162,118,43,323,1
사직운동장→연산교차로,2023.9.17 05:00,28,133,3,164,1
신리→연산교차로,2023.9.17 05:00,138,62,4,204,1
안락→연산교차로,2023.9.17 05:00,171,0,41,212,1
연산터널→연산교차로,2023.9.17 05:00,98,82,6,186,1
교대→연산교차로,2023.9.17 06:00,76,0,123,199,1
부산시청→연산교차로,2023.9.17 06:00,189,156,63,408,1
사직운동장→연산교차로,2023.9.17 06:00,38,161,13,212,1
신리→연산교차로,2023.9.17 06:00,202,79,3,284,1
안락→연산교차로,2023.9.17 06:00,196,0,51,247,1
연산터널→연산교차로,2023.9.17 06:00,116,103,15,234,1
교대→연산교차로,2023.9.17 07:00,128,0,151,279,1
부산시청→연산교차로,2023.9.17 07:00,234,181,72,487,1
사직운동장→연산교차로,2023.9.17 07:00,59,181,24,264,1
신리→연산교차로,2023.9.17 07:00,199,84,8,291,1
안락→연산교차로,2023.9.17 07:00,241,0,47,288,1
연산터널→연산교차로,2023.9.17 07:00,112,117,16,245,1
교대→연산교차로,2023.9.17 08:00,174,0,167,341,1
부산시청→연산교차로,2023.9.17 08:00,298,206,105,609,1
사직운동장→연산교차로,2023.9.17 08:00,103,275,32,410,1
신리→연산교차로,2023.9.17 08:00,257,157,15,429,1
안락→연산교차로,2023.9.17 08:00,320,0,67,387,1
연산터널→연산교차로,2023.9.17 08:00,157,148,25,330,1
교대→연산교차로,2023.9.17 09:00,249,0,242,491,1
부산시청→연산교차로,2023.9.17 09:00,355,291,150,796,1
사직운동장→연산교차로,2023.9.17 09:00,121,358,29,508,1
신리→연산교차로,2023.9.17 09:00,340,241,23,604,1
안락→연산교차로,2023.9.17 09:00,374,0,135,509,1
연산터널→연산교차로,2023.9.17 09:00,250,206,38,494,1
교대→연산교차로,2023.9.17 10:00,269,0,312,581,1
부산시청→연산교차로,2023.9.17 10:00,444,312,158,914,1
사직운동장→연산교차로,2023.9.17 10:00,170,519,57,746,1
신리→연산교차로,2023.9.17 10:00,382,207,27,616,1
안락→연산교차로,2023.9.17 10:00,485,0,100,585,1
연산터널→연산교차로,2023.9.17 10:00,239,273,32,544,1
교대→연산교차로,2023.9.17 11:00,266,0,338,604,1
부산시청→연산교차로,2023.9.17 11:00,469,340,209,1018,1
사직운동장→연산교차로,2023.9.17 11:00,195,543,58,796,1
신리→연산교차로,2023.9.17 11:00,411,200,23,634,1
안락→연산교차로,2023.9.17 11:00,546,0,122,668,1
연산터널→연산교차로,2023.9.17 11:00,249,257,59,565,1
교대→연산교차로,2023.9.17 12:00,279,0,330,609,1
부산시청→연산교차로,2023.9.17 12:00,552,356,221,1129,1
사직운동장→연산교차로,2023.9.17 12:00,206,590,48,844,1
신리→연산교차로,2023.9.17 12:00,455,254,41,750,1
안락→연산교차로,2023.9.17 12:00,520,0,114,634,1
연산터널→연산교차로,2023.9.17 12:00,279,288,39,606,1
교대→연산교차로,2023.9.17 13:00,302,0,385,687,1
부산시청→연산교차로,2023.9.17 13:00,579,380,237,1196,1
사직운동장→연산교차로,2023.9.17 13:00,209,617,29,855,1
신리→연산교차로,2023.9.17 13:00,397,223,45,665,1
안락→연산교차로,2023.9.17 13:00,561,0,122,683,1
연산터널→연산교차로,2023.9.17 13:00,274,291,49,614,1
교대→연산교차로,2023.9.17 14:00,299,0,430,729,1
부산시청→연산교차로,2023.9.17 14:00,570,370,230,1170,1
사직운동장→연산교차로,2023.9.17 14:00,210,590,24,824,1
신리→연산교차로,2023.9.17 14:00,425,238,37,700,1
안락→연산교차로,2023.9.17 14:00,528,0,163,691,1
연산터널→연산교차로,2023.9.17 14:00,265,297,41,603,1
교대→연산교차로,2023.9.17 15:00,307,0,362,669,1
부산시청→연산교차로,2023.9.17 15:00,609,389,261,1259,1
사직운동장→연산교차로,2023.9.17 15:00,204,607,35,846,1
신리→연산교차로,2023.9.17 15:00,473,205,43,721,1
안락→연산교차로,2023.9.17 15:00,521,0,102,623,1
연산터널→연산교차로,2023.9.17 15:00,254,271,43,568,1
교대→연산교차로,2023.9.17 16:00,303,0,328,631,1
부산시청→연산교차로,2023.9.17 16:00,607,385,241,1233,1
사직운동장→연산교차로,2023.9.17 16:00,227,569,32,828,1
신리→연산교차로,2023.9.17 16:00,428,216,38,682,1
안락→연산교차로,2023.9.17 16:00,568,0,145,713,1
연산터널→연산교차로,2023.9.17 16:00,253,295,43,591,1
교대→연산교차로,2023.9.17 17:00,313,0,300,613,1
부산시청→연산교차로,2023.9.17 17:00,595,364,265,1224,1
사직운동장→연산교차로,2023.9.17 17:00,201,558,50,809,1
신리→연산교차로,2023.9.17 17:00,383,214,40,637,1
안락→연산교차로,2023.9.17 17:00,511,0,158,669,1
연산터널→연산교차로,2023.9.17 17:00,256,289,46,591,1
교대→연산교차로,2023.9.17 18:00,298,0,288,586,1
부산시청→연산교차로,2023.9.17 18:00,501,343,228,1072,1
사직운동장→연산교차로,2023.9.17 18:00,184,470,57,711,1
신리→연산교차로,2023.9.17 18:00,356,202,30,588,1
안락→연산교차로,2023.9.17 18:00,432,0,125,557,1
연산터널→연산교차로,2023.9.17 18:00,225,262,45,532,1
교대→연산교차로,2023.9.17 19:00,264,0,275,539,1
부산시청→연산교차로,2023.9.17 19:00,409,285,171,865,1
사직운동장→연산교차로,2023.9.17 19:00,167,434,52,653,1
신리→연산교차로,2023.9.17 19:00,316,200,23,539,1
안락→연산교차로,2023.9.17 19:00,403,0,89,492,1
연산터널→연산교차로,2023.9.17 19:00,234,253,36,523,1
교대→연산교차로,2023.9.17 20:00,267,0,253,520,1
부산시청→연산교차로,2023.9.17 20:00,389,244,175,808,1
사직운동장→연산교차로,2023.9.17 20:00,146,378,60,584,1
신리→연산교차로,2023.9.17 20:00,292,175,18,485,1
안락→연산교차로,2023.9.17 20:00,369,0,114,483,1
연산터널→연산교차로,2023.9.17 20:00,199,211,27,437,1
교대→연산교차로,2023.9.17 21:00,221,0,215,436,1
부산시청→연산교차로,2023.9.17 21:00,395,241,148,784,1
사직운동장→연산교차로,2023.9.17 21:00,106,344,49,499,1
신리→연산교차로,2023.9.17 21:00,312,130,15,457,1
안락→연산교차로,2023.9.17 21:00,321,0,78,399,1
연산터널→연산교차로,2023.9.17 21:00,180,191,50,421,1
교대→연산교차로,2023.9.17 22:00,173,0,173,346,1
부산시청→연산교차로,2023.9.17 22:00,327,198,133,658,1
사직운동장→연산교차로,2023.9.17 22:00,92,265,50,407,1
신리→연산교차로,2023.9.17 22:00,229,114,22,365,1
안락→연산교차로,2023.9.17 22:00,279,0,66,345,1
연산터널→연산교차로,2023.9.17 22:00,147,161,51,359,1
교대→연산교차로,2023.9.17 23:00,151,0,137,288,1
부산시청→연산교차로,2023.9.17 23:00,245,148,99,492,1
사직운동장→연산교차로,2023.9.17 23:00,66,201,45,312,1
신리→연산교차로,2023.9.17 23:00,195,87,17,299,1
안락→연산교차로,2023.9.17 23:00,199,0,43,242,1
연산터널→연산교차로,2023.9.17 23:00,111,136,43,290,1
교대→연산교차로,2023.9.18 00:00,109,0,147,256,0
부산시청→연산교차로,2023.9.18 00:00,202,118,78,398,0
사직운동장→연산교차로,2023.9.18 00:00,61,159,24,244,0
신리→연산교차로,2023.9.18 00:00,128,66,21,215,0
안락→연산교차로,2023.9.18 00:00,156,0,37,193,0
연산터널→연산교차로,2023.9.18 00:00,96,116,65,277,0
교대→연산교차로,2023.9.18 01:00,83,0,106,189,0
부산시청→연산교차로,2023.9.18 01:00,129,97,56,282,0
사직운동장→연산교차로,2023.9.18 01:00,38,123,22,183,0
신리→연산교차로,2023.9.18 01:00,73,39,7,119,0
안락→연산교차로,2023.9.18 01:00,115,0,31,146,0
연산터널→연산교차로,2023.9.18 01:00,68,89,33,190,0
교대→연산교차로,2023.9.18 02:00,67,0,119,186,0
부산시청→연산교차로,2023.9.18 02:00,107,66,36,209,0
사직운동장→연산교차로,2023.9.18 02:00,29,119,17,165,0
신리→연산교차로,2023.9.18 02:00,75,44,6,125,0
안락→연산교차로,2023.9.18 02:00,94,0,22,116,0
연산터널→연산교차로,2023.9.18 02:00,57,68,26,151,0
교대→연산교차로,2023.9.18 03:00,39,0,84,123,0
부산시청→연산교차로,2023.9.18 03:00,128,56,49,233,0
사직운동장→연산교차로,2023.9.18 03:00,28,98,15,141,0
신리→연산교차로,2023.9.18 03:00,74,31,11,116,0
안락→연산교차로,2023.9.18 03:00,91,0,25,116,0
연산터널→연산교차로,2023.9.18 03:00,56,94,33,183,0
교대→연산교차로,2023.9.18 04:00,48,0,60,108,0
부산시청→연산교차로,2023.9.18 04:00,139,68,33,240,0
사직운동장→연산교차로,2023.9.18 04:00,22,111,7,140,0
신리→연산교차로,2023.9.18 04:00,80,46,3,129,0
안락→연산교차로,2023.9.18 04:00,179,0,23,202,0
연산터널→연산교차로,2023.9.18 04:00,69,91,13,173,0
교대→연산교차로,2023.9.18 05:00,64,0,112,176,0
부산시청→연산교차로,2023.9.18 05:00,240,158,83,481,0
사직운동장→연산교차로,2023.9.18 05:00,48,160,13,221,0
신리→연산교차로,2023.9.18 05:00,229,89,3,321,0
안락→연산교차로,2023.9.18 05:00,299,0,37,336,0
연산터널→연산교차로,2023.9.18 05:00,145,143,9,297,0
교대→연산교차로,2023.9.18 06:00,161,0,219,380,0
부산시청→연산교차로,2023.9.18 06:00,417,279,122,818,0
사직운동장→연산교차로,2023.9.18 06:00,90,290,38,418,0
신리→연산교차로,2023.9.18 06:00,338,200,18,556,0
안락→연산교차로,2023.9.18 06:00,514,0,116,630,0
연산터널→연산교차로,2023.9.18 06:00,223,240,34,497,0
교대→연산교차로,2023.9.18 07:00,265,0,407,672,0
부산시청→연산교차로,2023.9.18 07:00,584,385,202,1171,0
사직운동장→연산교차로,2023.9.18 07:00,202,496,39,737,0
신리→연산교차로,2023.9.18 07:00,484,316,29,829,0
안락→연산교차로,2023.9.18 07:00,636,0,75,711,0
연산터널→연산교차로,2023.9.18 07:00,305,394,34,733,0
교대→연산교차로,2023.9.18 08:00,324,0,521,845,0
부산시청→연산교차로,2023.9.18 08:00,584,433,342,1359,0
사직운동장→연산교차로,2023.9.18 08:00,203,671,46,920,0
신리→연산교차로,2023.9.18 08:00,527,351,20,898,0
안락→연산교차로,2023.9.18 08:00,621,0,116,737,0
연산터널→연산교차로,2023.9.18 08:00,316,389,34,739,0
교대→연산교차로,2023.9.18 09:00,288,0,517,805,0
부산시청→연산교차로,2023.9.18 09:00,528,378,290,1196,0
사직운동장→연산교차로,2023.9.18 09:00,201,604,79,884,0
신리→연산교차로,2023.9.18 09:00,479,344,40,863,0
안락→연산교차로,2023.9.18 09:00,571,0,95,666,0
연산터널→연산교차로,2023.9.18 09:00,309,355,53,717,0
교대→연산교차로,2023.9.18 10:00,305,0,479,784,0
부산시청→연산교차로,2023.9.18 10:00,537,365,270,1172,0
사직운동장→연산교차로,2023.9.18 10:00,224,558,67,849,0
신리→연산교차로,2023.9.18 10:00,489,282,71,842,0
안락→연산교차로,2023.9.18 10:00,554,0,121,675,0
연산터널→연산교차로,2023.9.18 10:00,310,338,56,704,0
교대→연산교차로,2023.9.18 11:00,284,0,441,725,0
부산시청→연산교차로,2023.9.18 11:00,588,356,251,1195,0
사직운동장→연산교차로,2023.9.18 11:00,221,551,47,819,0
신리→연산교차로,2023.9.18 11:00,455,250,56,761,0
안락→연산교차로,2023.9.18 11:00,521,0,173,694,0
연산터널→연산교차로,2023.9.18 11:00,282,318,40,640,0
교대→연산교차로,2023.9.18 12:00,296,0,359,655,0
부산시청→연산교차로,2023.9.18 12:00,566,356,259,1181,0
사직운동장→연산교차로,2023.9.18 12:00,183,559,66,808,0
신리→연산교차로,2023.9.18 12:00,402,245,55,702,0
안락→연산교차로,2023.9.18 12:00,481,0,137,618,0
연산터널→연산교차로,2023.9.18 12:00,244,259,38,541,0
교대→연산교차로,2023.9.18 13:00,326,0,413,739,0
부산시청→연산교차로,2023.9.18 13:00,628,429,274,1331,0
사직운동장→연산교차로,2023.9.18 13:00,187,604,68,859,0
신리→연산교차로,2023.9.18 13:00,457,281,35,773,0
안락→연산교차로,2023.9.18 13:00,448,0,108,556,0
연산터널→연산교차로,2023.9.18 13:00,253,268,34,555,0
교대→연산교차로,2023.9.18 14:00,376,0,521,897,0
부산시청→연산교차로,2023.9.18 14:00,625,439,303,1367,0
사직운동장→연산교차로,2023.9.18 14:00,223,625,81,929,0
신리→연산교차로,2023.9.18 14:00,452,257,74,783,0
안락→연산교차로,2023.9.18 14:00,419,0,96,515,0
연산터널→연산교차로,2023.9.18 14:00,237,272,35,544,0
교대→연산교차로,2023.9.18 15:00,365,0,489,854,0
부산시청→연산교차로,2023.9.18 15:00,600,506,314,1420,0
사직운동장→연산교차로,2023.9.18 15:00,226,655,89,970,0
신리→연산교차로,2023.9.18 15:00,469,290,58,817,0
안락→연산교차로,2023.9.18 15:00,438,0,106,544,0
연산터널→연산교차로,2023.9.18 15:00,246,277,50,573,0
교대→연산교차로,2023.9.18 16:00,334,0,542,876,0
부산시청→연산교차로,2023.9.18 16:00,594,512,321,1427,0
사직운동장→연산교차로,2023.9.18 16:00,236,667,71,974,0
신리→연산교차로,2023.9.18 16:00,426,285,75,786,0
안락→연산교차로,2023.9.18 16:00,431,0,98,529,0
연산터널→연산교차로,2023.9.18 16:00,226,291,49,566,0
교대→연산교차로,2023.9.18 17:00,361,0,526,887,0
부산시청→연산교차로,2023.9.18 17:00,638,519,316,1473,0
사직운동장→연산교차로,2023.9.18 17:00,220,693,35,948,0
신리→연산교차로,2023.9.18 17:00,481,305,67,853,0
안락→연산교차로,2023.9.18 17:00,440,0,106,546,0
연산터널→연산교차로,2023.9.18 17:00,232,284,44,560,0
교대→연산교차로,2023.9.18 18:00,364,0,548,912,0
부산시청→연산교차로,2023.9.18 18:00,575,573,339,1487,0
사직운동장→연산교차로,2023.9.18 18:00,254,654,64,972,0
신리→연산교차로,2023.9.18 18:00,513,275,45,833,0
안락→연산교차로,2023.9.18 18:00,431,0,94,525,0
연산터널→연산교차로,2023.9.18 18:00,222,284,51,557,0
교대→연산교차로,2023.9.18 19:00,351,0,443,794,0
부산시청→연산교차로,2023.9.18 19:00,553,437,279,1269,0
사직운동장→연산교차로,2023.9.18 19:00,194,582,74,850,0
신리→연산교차로,2023.9.18 19:00,390,235,34,659,0
안락→연산교차로,2023.9.18 19:00,454,0,101,555,0
연산터널→연산교차로,2023.9.18 19:00,218,267,36,521,0
교대→연산교차로,2023.9.18 20:00,286,0,348,634,0
부산시청→연산교차로,2023.9.18 20:00,477,349,259,1085,0
사직운동장→연산교차로,2023.9.18 20:00,176,512,84,772,0
신리→연산교차로,2023.9.18 20:00,309,165,33,507,0
안락→연산교차로,2023.9.18 20:00,385,0,88,473,0
연산터널→연산교차로,2023.9.18 20:00,198,272,45,515,0
교대→연산교차로,2023.9.18 21:00,287,0,316,603,0
부산시청→연산교차로,2023.9.18 21:00,436,321,229,986,0
사직운동장→연산교차로,2023.9.18 21:00,161,446,81,688,0
신리→연산교차로,2023.9.18 21:00,290,176,42,508,0
안락→연산교차로,2023.9.18 21:00,413,0,108,521,0
연산터널→연산교차로,2023.9.18 21:00,237,300,73,610,0
교대→연산교차로,2023.9.18 22:00,243,0,236,479,0
부산시청→연산교차로,2023.9.18 22:00,404,280,171,855,0
사직운동장→연산교차로,2023.9.18 22:00,140,369,77,586,0
신리→연산교차로,2023.9.18 22:00,245,151,26,422,0
안락→연산교차로,2023.9.18 22:00,367,0,89,456,0
연산터널→연산교차로,2023.9.18 22:00,205,249,82,536,0
교대→연산교차로,2023.9.18 23:00,181,0,193,374,0
부산시청→연산교차로,2023.9.18 23:00,298,181,114,593,0
사직운동장→연산교차로,2023.9.18 23:00,101,258,62,421,0
신리→연산교차로,2023.9.18 23:00,210,123,21,354,0
안락→연산교차로,2023.9.18 23:00,231,0,57,288,0
연산터널→연산교차로,2023.9.18 23:00,130,188,60,378,0
교대→연산교차로,2023.9.19 00:00,120,0,179,299,0
부산시청→연산교차로,2023.9.19 00:00,232,159,90,481,0
사직운동장→연산교차로,2023.9.19 00:00,63,211,39,313,0
신리→연산교차로,2023.9.19 00:00,141,99,14,254,0
안락→연산교차로,2023.9.19 00:00,188,0,45,233,0
연산터널→연산교차로,2023.9.19 00:00,130,162,55,347,0
교대→연산교차로,2023.9.19 01:00,89,0,141,230,0
부산시청→연산교차로,2023.9.19 01:00,188,96,85,369,0
사직운동장→연산교차로,2023.9.19 01:00,42,183,23,248,0
신리→연산교차로,2023.9.19 01:00,108,58,15,181,0
안락→연산교차로,2023.9.19 01:00,129,0,42,171,0
연산터널→연산교차로,2023.9.19 01:00,91,119,63,273,0
교대→연산교차로,2023.9.19 02:00,79,0,119,198,0
부산시청→연산교차로,2023.9.19 02:00,142,89,61,292,0
사직운동장→연산교차로,2023.9.19 02:00,34,137,24,195,0
신리→연산교차로,2023.9.19 02:00,72,48,15,135,0
안락→연산교차로,2023.9.19 02:00,122,0,32,154,0
연산터널→연산교차로,2023.9.19 02:00,91,112,52,255,0
교대→연산교차로,2023.9.19 03:00,43,0,113,156,0
부산시청→연산교차로,2023.9.19 03:00,135,82,43,260,0
사직운동장→연산교차로,2023.9.19 03:00,36,142,20,198,0
신리→연산교차로,2023.9.19 03:00,68,39,12,119,0
안락→연산교차로,2023.9.19 03:00,127,0,30,157,0
연산터널→연산교차로,2023.9.19 03:00,77,83,47,207,0
교대→연산교차로,2023.9.19 04:00,62,0,79,141,0
부산시청→연산교차로,2023.9.19 04:00,146,66,47,259,0
사직운동장→연산교차로,2023.9.19 04:00,27,119,9,155,0
신리→연산교차로,2023.9.19 04:00,103,45,7,155,0
안락→연산교차로,2023.9.19 04:00,165,0,37,202,0
연산터널→연산교차로,2023.9.19 04:00,73,105,30,208,0
교대→연산교차로,2023.9.19 05:00,91,0,128,219,0
부산시청→연산교차로,2023.9.19 05:00,227,161,96,484,0
사직운동장→연산교차로,2023.9.19 05:00,41,206,19,266,0
신리→연산교차로,2023.9.19 05:00,223,96,13,332,0
안락→연산교차로,2023.9.19 05:00,313,0,68,381,0
연산터널→연산교차로,2023.9.19 05:00,149,137,18,304,0
교대→연산교차로,2023.9.19 06:00,187,0,245,432,0
부산시청→연산교차로,2023.9.19 06:00,395,287,153,835,0
사직운동장→연산교차로,2023.9.19 06:00,95,314,30,439,0
신리→연산교차로,2023.9.19 06:00,345,205,22,572,0
안락→연산교차로,2023.9.19 06:00,536,0,98,634,0
연산터널→연산교차로,2023.9.19 06:00,243,236,44,523,0
교대→연산교차로,2023.9.19 07:00,267,0,373,640,0
부산시청→연산교차로,2023.9.19 07:00,598,403,204,1205,0
사직운동장→연산교차로,2023.9.19 07:00,177,515,69,761,0
신리→연산교차로,2023.9.19 07:00,478,298,25,801,0
안락→연산교차로,2023.9.19 07:00,625,0,75,700,0
연산터널→연산교차로,2023.9.19 07:00,280,397,37,714,0
교대→연산교차로,2023.9.19 08:00,322,0,515,837,0
부산시청→연산교차로,2023.9.19 08:00,557,443,320,1320,0
사직운동장→연산교차로,2023.9.19 08:00,206,656,45,907,0
신리→연산교차로,2023.9.19 08:00,494,336,22,852,0
안락→연산교차로,2023.9.19 08:00,626,0,80,706,0
연산터널→연산교차로,2023.9.19 08:00,330,382,26,738,0
교대→연산교차로,2023.9.19 09:00,297,0,507,804,0
부산시청→연산교차로,2023.9.19 09:00,567,377,293,1237,0
사직운동장→연산교차로,2023.9.19 09:00,177,584,62,823,0
신리→연산교차로,2023.9.19 09:00,466,348,35,849,0
안락→연산교차로,2023.9.19 09:00,606,0,86,692,0
연산터널→연산교차로,2023.9.19 09:00,345,346,41,732,0
교대→연산교차로,2023.9.19 10:00,282,0,485,767,0
부산시청→연산교차로,2023.9.19 10:00,600,363,295,1258,0
사직운동장→연산교차로,2023.9.19 10:00,172,591,58,821,0
신리→연산교차로,2023.9.19 10:00,464,258,65,787,0
안락→연산교차로,2023.9.19 10:00,565,0,106,671,0
연산터널→연산교차로,2023.9.19 10:00,314,357,38,709,0
교대→연산교차로,2023.9.19 11:00,289,0,415,704,0
부산시청→연산교차로,2023.9.19 11:00,635,378,342,1355,0
사직운동장→연산교차로,2023.9.19 11:00,212,563,64,839,0
신리→연산교차로,2023.9.19 11:00,418,267,63,748,0
안락→연산교차로,2023.9.19 11:00,531,0,151,682,0
연산터널→연산교차로,2023.9.19 11:00,291,297,59,647,0
교대→연산교차로,2023.9.19 12:00,291,0,373,664,0
부산시청→연산교차로,2023.9.19 12:00,578,376,260,1214,0
사직운동장→연산교차로,2023.9.19 12:00,183,528,69,780,0
신리→연산교차로,2023.9.19 12:00,408,216,70,694,0
안락→연산교차로,2023.9.19 12:00,510,0,137,647,0
연산터널→연산교차로,2023.9.19 12:00,280,248,50,578,0
교대→연산교차로,2023.9.19 13:00,292,0,362,654,0
부산시청→연산교차로,2023.9.19 13:00,478,327,233,1038,0
사직운동장→연산교차로,2023.9.19 13:00,184,574,50,808,0
신리→연산교차로,2023.9.19 13:00,391,217,47,655,0
안락→연산교차로,2023.9.19 13:00,353,0,84,437,0
연산터널→연산교차로,2023.9.19 13:00,215,246,30,491,0
교대→연산교차로,2023.9.19 14:00,312,0,480,792,0
부산시청→연산교차로,2023.9.19 14:00,567,470,304,1341,0
사직운동장→연산교차로,2023.9.19 14:00,211,644,85,940,0
신리→연산교차로,2023.9.19 14:00,498,271,56,825,0
안락→연산교차로,2023.9.19 14:00,411,0,109,520,0
연산터널→연산교차로,2023.9.19 14:00,233,280,47,560,0
교대→연산교차로,2023.9.19 15:00,353,0,500,853,0
부산시청→연산교차로,2023.9.19 15:00,602,491,343,1436,0
사직운동장→연산교차로,2023.9.19 15:00,219,639,67,925,0
신리→연산교차로,2023.9.19 15:00,478,265,77,820,0
안락→연산교차로,2023.9.19 15:00,423,0,94,517,0
연산터널→연산교차로,2023.9.19 15:00,247,278,43,568,0
교대→연산교차로,2023.9.19 16:00,347,0,474,821,0
부산시청→연산교차로,2023.9.19 16:00,614,534,398,1546,0
사직운동장→연산교차로,2023.9.19 16:00,243,657,55,955,0
신리→연산교차로,2023.9.19 16:00,478,304,75,857,0
안락→연산교차로,2023.9.19 16:00,440,0,120,560,0
연산터널→연산교차로,2023.9.19 16:00,226,298,37,561,0
교대→연산교차로,2023.9.19 17:00,364,0,515,879,0
부산시청→연산교차로,2023.9.19 17:00,661,533,325,1519,0
사직운동장→연산교차로,2023.9.19 17:00,212,718,49,979,0
신리→연산교차로,2023.9.19 17:00,524,318,48,890,0
안락→연산교차로,2023.9.19 17:00,457,0,93,550,0
연산터널→연산교차로,2023.9.19 17:00,231,274,34,539,0
교대→연산교차로,2023.9.19 18:00,367,0,550,917,0
부산시청→연산교차로,2023.9.19 18:00,603,547,346,1496,0
사직운동장→연산교차로,2023.9.19 18:00,221,703,43,967,0
신리→연산교차로,2023.9.19 18:00,539,277,52,868,0
안락→연산교차로,2023.9.19 18:00,429,0,91,520,0
연산터널→연산교차로,2023.9.19 18:00,222,296,42,560,0
교대→연산교차로,2023.9.19 19:00,333,0,453,786,0
부산시청→연산교차로,2023.9.19 19:00,577,450,301,1328,0
사직운동장→연산교차로,2023.9.19 19:00,206,592,63,861,0
신리→연산교차로,2023.9.19 19:00,391,228,37,656,0
안락→연산교차로,2023.9.19 19:00,431,0,98,529,0
연산터널→연산교차로,2023.9.19 19:00,212,277,44,533,0
교대→연산교차로,2023.9.19 20:00,313,0,349,662,0
부산시청→연산교차로,2023.9.19 20:00,475,375,271,1121,0
사직운동장→연산교차로,2023.9.19 20:00,177,505,76,758,0
신리→연산교차로,2023.9.19 20:00,322,182,44,548,0
안락→연산교차로,2023.9.19 20:00,386,0,83,469,0
연산터널→연산교차로,2023.9.19 20:00,204,279,47,530,0
교대→연산교차로,2023.9.19 21:00,282,0,373,655,0
부산시청→연산교차로,2023.9.19 21:00,483,296,239,1018,0
사직운동장→연산교차로,2023.9.19 21:00,178,476,73,727,0
신리→연산교차로,2023.9.19 21:00,316,184,38,538,0
안락→연산교차로,2023.9.19 21:00,388,0,97,485,0
연산터널→연산교차로,2023.9.19 21:00,244,254,53,551,0
교대→연산교차로,2023.9.19 22:00,266,0,238,504,0
부산시청→연산교차로,2023.9.19 22:00,414,289,171,874,0
사직운동장→연산교차로,2023.9.19 22:00,167,413,74,654,0
신리→연산교차로,2023.9.19 22:00,259,156,31,446,0
안락→연산교차로,2023.9.19 22:00,334,0,86,420,0
연산터널→연산교차로,2023.9.19 22:00,181,253,47,481,0
교대→연산교차로,2023.9.19 23:00,170,0,211,381,0
부산시청→연산교차로,2023.9.19 23:00,316,203,129,648,0
사직운동장→연산교차로,2023.9.19 23:00,106,286,66,458,0
신리→연산교차로,2023.9.19 23:00,200,116,31,347,0
안락→연산교차로,2023.9.19 23:00,260,0,73,333,0
연산터널→연산교차로,2023.9.19 23:00,150,190,67,407,0
교대→연산교차로,2023.9.20 00:00,152,0,193,345,0
부산시청→연산교차로,2023.9.20 00:00,257,155,98,510,0
사직운동장→연산교차로,2023.9.20 00:00,76,216,50,342,0
신리→연산교차로,2023.9.20 00:00,152,108,25,285,0
안락→연산교차로,2023.9.20 00:00,190,0,52,242,0
연산터널→연산교차로,2023.9.20 00:00,154,162,64,380,0
교대→연산교차로,2023.9.20 01:00,113,0,179,292,0
부산시청→연산교차로,2023.9.20 01:00,184,136,69,389,0
사직운동장→연산교차로,2023.9.20 01:00,56,185,28,269,0
신리→연산교차로,2023.9.20 01:00,92,64,18,174,0
안락→연산교차로,2023.9.20 01:00,138,0,41,179,0
연산터널→연산교차로,2023.9.20 01:00,101,133,54,288,0
교대→연산교차로,2023.9.20 02:00,78,0,137,215,0
부산시청→연산교차로,2023.9.20 02:00,170,88,63,321,0
사직운동장→연산교차로,2023.9.20 02:00,37,169,28,234,0
신리→연산교차로,2023.9.20 02:00,98,52,17,167,0
안락→연산교차로,2023.9.20 02:00,127,0,45,172,0
연산터널→연산교차로,2023.9.20 02:00,96,120,36,252,0
교대→연산교차로,2023.9.20 03:00,58,0,117,175,0
부산시청→연산교차로,2023.9.20 03:00,155,74,49,278,0
사직운동장→연산교차로,2023.9.20 03:00,31,158,24,213,0
신리→연산교차로,2023.9.20 03:00,78,29,15,122,0
안락→연산교차로,2023.9.20 03:00,112,0,26,138,0
연산터널→연산교차로,2023.9.20 03:00,83,84,52,219,0
교대→연산교차로,2023.9.20 04:00,43,0,91,134,0
부산시청→연산교차로,2023.9.20 04:00,159,91,39,289,0
사직운동장→연산교차로,2023.9.20 04:00,33,119,19,171,0
신리→연산교차로,2023.9.20 04:00,109,48,8,165,0
안락→연산교차로,2023.9.20 04:00,187,0,45,232,0
연산터널→연산교차로,2023.9.20 04:00,83,99,40,222,0
교대→연산교차로,2023.9.20 05:00,87,0,143,230,0
부산시청→연산교차로,2023.9.20 05:00,245,157,97,499,0
사직운동장→연산교차로,2023.9.20 05:00,54,179,12,245,0
신리→연산교차로,2023.9.20 05:00,217,107,12,336,0
안락→연산교차로,2023.9.20 05:00,328,0,41,369,0
연산터널→연산교차로,2023.9.20 05:00,129,140,21,290,0
교대→연산교차로,2023.9.20 06:00,156,0,239,395,0
부산시청→연산교차로,2023.9.20 06:00,380,270,123,773,0
사직운동장→연산교차로,2023.9.20 06:00,99,298,40,437,0
신리→연산교차로,2023.9.20 06:00,321,199,24,544,0
안락→연산교차로,2023.9.20 06:00,520,0,114,634,0
연산터널→연산교차로,2023.9.20 06:00,231,243,51,525,0
교대→연산교차로,2023.9.20 07:00,271,0,382,653,0
부산시청→연산교차로,2023.9.20 07:00,580,377,205,1162,0
사직운동장→연산교차로,2023.9.20 07:00,186,525,32,743,0
신리→연산교차로,2023.9.20 07:00,518,292,29,839,0
안락→연산교차로,2023.9.20 07:00,649,0,81,730,0
연산터널→연산교차로,2023.9.20 07:00,295,372,35,702,0
교대→연산교차로,2023.9.20 08:00,322,0,493,815,0
부산시청→연산교차로,2023.9.20 08:00,623,424,325,1372,0
사직운동장→연산교차로,2023.9.20 08:00,199,668,51,918,0
신리→연산교차로,2023.9.20 08:00,499,365,27,891,0
안락→연산교차로,2023.9.20 08:00,623,0,98,721,0
연산터널→연산교차로,2023.9.20 08:00,316,381,31,728,0
교대→연산교차로,2023.9.20 09:00,289,0,533,822,0
부산시청→연산교차로,2023.9.20 09:00,551,379,281,1211,0
사직운동장→연산교차로,2023.9.20 09:00,182,615,76,873,0
신리→연산교차로,2023.9.20 09:00,509,316,40,865,0
안락→연산교차로,2023.9.20 09:00,552,0,104,656,0
연산터널→연산교차로,2023.9.20 09:00,287,376,49,712,0
교대→연산교차로,2023.9.20 10:00,266,0,476,742,0
부산시청→연산교차로,2023.9.20 10:00,546,367,303,1216,0
사직운동장→연산교차로,2023.9.20 10:00,192,573,40,805,0
신리→연산교차로,2023.9.20 10:00,435,294,50,779,0
안락→연산교차로,2023.9.20 10:00,522,0,125,647,0
연산터널→연산교차로,2023.9.20 10:00,306,351,48,705,0
교대→연산교차로,2023.9.20 11:00,295,0,476,771,0
부산시청→연산교차로,2023.9.20 11:00,588,358,264,1210,0
사직운동장→연산교차로,2023.9.20 11:00,211,571,53,835,0
신리→연산교차로,2023.9.20 11:00,440,251,52,743,0
안락→연산교차로,2023.9.20 11:00,526,0,128,654,0
연산터널→연산교차로,2023.9.20 11:00,289,308,47,644,0
교대→연산교차로,2023.9.20 12:00,295,0,426,721,0
부산시청→연산교차로,2023.9.20 12:00,573,381,279,1233,0
사직운동장→연산교차로,2023.9.20 12:00,214,582,59,855,0
신리→연산교차로,2023.9.20 12:00,434,237,51,722,0
안락→연산교차로,2023.9.20 12:00,504,0,157,661,0
연산터널→연산교차로,2023.9.20 12:00,259,285,53,597,0
교대→연산교차로,2023.9.20 13:00,320,0,438,758,0
부산시청→연산교차로,2023.9.20 13:00,564,451,338,1353,0
사직운동장→연산교차로,2023.9.20 13:00,195,572,68,835,0
신리→연산교차로,2023.9.20 13:00,460,288,49,797,0
안락→연산교차로,2023.9.20 13:00,436,0,119,555,0
연산터널→연산교차로,2023.9.20 13:00,229,263,59,551,0
교대→연산교차로,2023.9.20 14:00,356,0,495,851,0
부산시청→연산교차로,2023.9.20 14:00,570,491,339,1400,0
사직운동장→연산교차로,2023.9.20 14:00,207,601,56,864,0
신리→연산교차로,2023.9.20 14:00,473,280,68,821,0
안락→연산교차로,2023.9.20 14:00,419,0,105,524,0
연산터널→연산교차로,2023.9.20 14:00,219,293,50,562,0
교대→연산교차로,2023.9.20 15:00,348,0,513,861,0
부산시청→연산교차로,2023.9.20 15:00,609,511,311,1431,0
사직운동장→연산교차로,2023.9.20 15:00,225,636,63,924,0
신리→연산교차로,2023.9.20 15:00,515,277,46,838,0
안락→연산교차로,2023.9.20 15:00,434,0,102,536,0
연산터널→연산교차로,2023.9.20 15:00,238,291,39,568,0
교대→연산교차로,2023.9.20 16:00,350,0,441,791,0
부산시청→연산교차로,2023.9.20 16:00,579,539,309,1427,0
사직운동장→연산교차로,2023.9.20 16:00,228,648,38,914,0
신리→연산교차로,2023.9.20 16:00,512,291,51,854,0
안락→연산교차로,2023.9.20 16:00,433,0,102,535,0
연산터널→연산교차로,2023.9.20 16:00,245,267,36,548,0
교대→연산교차로,2023.9.20 17:00,308,0,510,818,0
부산시청→연산교차로,2023.9.20 17:00,586,520,295,1401,0
사직운동장→연산교차로,2023.9.20 17:00,209,607,34,850,0
신리→연산교차로,2023.9.20 17:00,504,268,49,821,0
안락→연산교차로,2023.9.20 17:00,416,0,103,519,0
연산터널→연산교차로,2023.9.20 17:00,223,278,31,532,0
교대→연산교차로,2023.9.20 18:00,348,0,519,867,0
부산시청→연산교차로,2023.9.20 18:00,546,570,312,1428,0
사직운동장→연산교차로,2023.9.20 18:00,240,653,29,922,0
신리→연산교차로,2023.9.20 18:00,473,225,50,748,0
안락→연산교차로,2023.9.20 18:00,417,0,80,497,0
연산터널→연산교차로,2023.9.20 18:00,234,265,28,527,0
교대→연산교차로,2023.9.20 19:00,323,0,429,752,0
부산시청→연산교차로,2023.9.20 19:00,462,535,285,1282,0
사직운동장→연산교차로,2023.9.20 19:00,206,513,12,731,0
신리→연산교차로,2023.9.20 19:00,326,222,36,584,0
안락→연산교차로,2023.9.20 19:00,401,0,72,473,0
연산터널→연산교차로,2023.9.20 19:00,131,274,18,423,0
교대→연산교차로,2023.9.20 20:00,320,0,367,687,0
부산시청→연산교차로,2023.9.20 20:00,436,397,239,1072,0
사직운동장→연산교차로,2023.9.20 20:00,196,507,20,723,0
신리→연산교차로,2023.9.20 20:00,354,191,8,553,0
안락→연산교차로,2023.9.20 20:00,395,0,119,514,0
연산터널→연산교차로,2023.9.20 20:00,231,250,27,508,0
교대→연산교차로,2023.9.20 21:00,297,0,302,599,0
부산시청→연산교차로,2023.9.20 21:00,487,366,175,1028,0
사직운동장→연산교차로,2023.9.20 21:00,186,440,40,666,0
신리→연산교차로,2023.9.20 21:00,297,198,19,514,0
안락→연산교차로,2023.9.20 21:00,365,0,90,455,0
연산터널→연산교차로,2023.9.20 21:00,228,249,49,526,0
교대→연산교차로,2023.9.20 22:00,252,0,215,467,0
부산시청→연산교차로,2023.9.20 22:00,395,266,143,804,0
사직운동장→연산교차로,2023.9.20 22:00,129,348,40,517,0
신리→연산교차로,2023.9.20 22:00,239,136,21,396,0
안락→연산교차로,2023.9.20 22:00,337,0,99,436,0
연산터널→연산교차로,2023.9.20 22:00,205,212,35,452,0
교대→연산교차로,2023.9.20 23:00,202,0,172,374,0
부산시청→연산교차로,2023.9.20 23:00,300,202,130,632,0
사직운동장→연산교차로,2023.9.20 23:00,96,286,17,399,0
신리→연산교차로,2023.9.20 23:00,189,110,16,315,0
안락→연산교차로,2023.9.20 23:00,257,0,80,337,0
연산터널→연산교차로,2023.9.20 23:00,145,152,41,338,0
교대→연산교차로,2023.9.21 00:00,123,0,171,294,0
부산시청→연산교차로,2023.9.21 00:00,214,166,77,457,0
사직운동장→연산교차로,2023.9.21 00:00,61,266,11,338,0
신리→연산교차로,2023.9.21 00:00,98,59,5,162,0
안락→연산교차로,2023.9.21 00:00,227,0,39,266,0
연산터널→연산교차로,2023.9.21 00:00,108,160,13,281,0
교대→연산교차로,2023.9.21 01:00,90,0,131,221,0
부산시청→연산교차로,2023.9.21 01:00,137,88,61,286,0
사직운동장→연산교차로,2023.9.21 01:00,53,166,3,222,0
신리→연산교차로,2023.9.21 01:00,66,46,3,115,0
안락→연산교차로,2023.9.21 01:00,154,0,41,195,0
연산터널→연산교차로,2023.9.21 01:00,87,115,14,216,0
교대→연산교차로,2023.9.21 02:00,77,0,96,173,0
부산시청→연산교차로,2023.9.21 02:00,145,94,57,296,0
사직운동장→연산교차로,2023.9.21 02:00,46,139,3,188,0
신리→연산교차로,2023.9.21 02:00,72,38,17,127,0
안락→연산교차로,2023.9.21 02:00,129,0,32,161,0
연산터널→연산교차로,2023.9.21 02:00,75,104,14,193,0
교대→연산교차로,2023.9.21 03:00,57,0,93,150,0
부산시청→연산교차로,2023.9.21 03:00,137,75,38,250,0
사직운동장→연산교차로,2023.9.21 03:00,30,113,4,147,0
신리→연산교차로,2023.9.21 03:00,52,50,7,109,0
안락→연산교차로,2023.9.21 03:00,99,0,17,116,0
연산터널→연산교차로,2023.9.21 03:00,62,85,20,167,0
교대→연산교차로,2023.9.21 04:00,54,0,76,130,0
부산시청→연산교차로,2023.9.21 04:00,149,83,31,263,0
사직운동장→연산교차로,2023.9.21 04:00,30,94,13,137,0
신리→연산교차로,2023.9.21 04:00,81,47,3,131,0
안락→연산교차로,2023.9.21 04:00,158,0,30,188,0
연산터널→연산교차로,2023.9.21 04:00,66,103,14,183,0
교대→연산교차로,2023.9.21 05:00,71,0,101,172,0
부산시청→연산교차로,2023.9.21 05:00,226,144,74,444,0
사직운동장→연산교차로,2023.9.21 05:00,46,154,9,209,0
신리→연산교차로,2023.9.21 05:00,183,76,13,272,0
안락→연산교차로,2023.9.21 05:00,288,0,36,324,0
연산터널→연산교차로,2023.9.21 05:00,124,128,14,266,0
교대→연산교차로,2023.9.21 06:00,140,0,195,335,0
부산시청→연산교차로,2023.9.21 06:00,349,251,112,712,0
사직운동장→연산교차로,2023.9.21 06:00,83,248,45,376,0
신리→연산교차로,2023.9.21 06:00,326,191,15,532,0
안락→연산교차로,2023.9.21 06:00,436,0,87,523,0
연산터널→연산교차로,2023.9.21 06:00,206,203,38,447,0
교대→연산교차로,2023.9.21 07:00,248,0,371,619,0
부산시청→연산교차로,2023.9.21 07:00,569,384,190,1143,0
사직운동장→연산교차로,2023.9.21 07:00,172,498,52,722,0
신리→연산교차로,2023.9.21 07:00,474,306,22,802,0
안락→연산교차로,2023.9.21 07:00,596,0,91,687,0
연산터널→연산교차로,2023.9.21 07:00,276,352,45,673,0
교대→연산교차로,2023.9.21 08:00,313,0,469,782,0
부산시청→연산교차로,2023.9.21 08:00,559,424,332,1315,0
사직운동장→연산교차로,2023.9.21 08:00,191,654,43,888,0
신리→연산교차로,2023.9.21 08:00,487,337,18,842,0
안락→연산교차로,2023.9.21 08:00,615,0,107,722,0
연산터널→연산교차로,2023.9.21 08:00,310,383,22,715,0
교대→연산교차로,2023.9.21 09:00,300,0,484,784,0
부산시청→연산교차로,2023.9.21 09:00,534,369,295,1198,0
사직운동장→연산교차로,2023.9.21 09:00,204,600,70,874,0
신리→연산교차로,2023.9.21 09:00,461,337,34,832,0
안락→연산교차로,2023.9.21 09:00,580,0,102,682,0
연산터널→연산교차로,2023.9.21 09:00,308,367,35,710,0
교대→연산교차로,2023.9.21 10:00,298,0,456,754,0
부산시청→연산교차로,2023.9.21 10:00,584,355,274,1213,0
사직운동장→연산교차로,2023.9.21 10:00,218,593,59,870,0
신리→연산교차로,2023.9.21 10:00,464,275,46,785,0
안락→연산교차로,2023.9.21 10:00,542,0,152,694,0
연산터널→연산교차로,2023.9.21 10:00,314,307,56,677,0
교대→연산교차로,2023.9.21 11:00,284,0,476,760,0
부산시청→연산교차로,2023.9.21 11:00,569,398,266,1233,0
사직운동장→연산교차로,2023.9.21 11:00,193,554,69,816,0
신리→연산교차로,2023.9.21 11:00,450,268,55,773,0
안락→연산교차로,2023.9.21 11:00,534,0,124,658,0
연산터널→연산교차로,2023.9.21 11:00,304,316,61,681,0
교대→연산교차로,2023.9.21 12:00,280,0,417,697,0
부산시청→연산교차로,2023.9.21 12:00,575,369,273,1217,0
사직운동장→연산교차로,2023.9.21 12:00,197,574,74,845,0
신리→연산교차로,2023.9.21 12:00,424,232,46,702,0
안락→연산교차로,2023.9.21 12:00,486,0,163,649,0
연산터널→연산교차로,2023.9.21 12:00,295,305,31,631,0
교대→연산교차로,2023.9.21 13:00,327,0,443,770,0
부산시청→연산교차로,2023.9.21 13:00,587,442,266,1295,0
사직운동장→연산교차로,2023.9.21 13:00,202,582,69,853,0
신리→연산교차로,2023.9.21 13:00,468,261,56,785,0
안락→연산교차로,2023.9.21 13:00,447,0,111,558,0
연산터널→연산교차로,2023.9.21 13:00,247,294,35,576,0
교대→연산교차로,2023.9.21 14:00,328,0,497,825,0
부산시청→연산교차로,2023.9.21 14:00,577,455,276,1308,0
사직운동장→연산교차로,2023.9.21 14:00,206,598,83,887,0
신리→연산교차로,2023.9.21 14:00,465,279,51,795,0
안락→연산교차로,2023.9.21 14:00,431,0,114,545,0
연산터널→연산교차로,2023.9.21 14:00,231,273,43,547,0
교대→연산교차로,2023.9.21 15:00,367,0,420,787,0
부산시청→연산교차로,2023.9.21 15:00,604,514,333,1451,0
사직운동장→연산교차로,2023.9.21 15:00,217,658,62,937,0
신리→연산교차로,2023.9.21 15:00,480,277,66,823,0
안락→연산교차로,2023.9.21 15:00,438,0,104,542,0
연산터널→연산교차로,2023.9.21 15:00,238,277,43,558,0
교대→연산교차로,2023.9.21 16:00,344,0,505,849,0
부산시청→연산교차로,2023.9.21 16:00,611,523,343,1477,0
사직운동장→연산교차로,2023.9.21 16:00,214,676,66,956,0
신리→연산교차로,2023.9.21 16:00,523,287,41,851,0
안락→연산교차로,2023.9.21 16:00,430,0,108,538,0
연산터널→연산교차로,2023.9.21 16:00,260,262,42,564,0
교대→연산교차로,2023.9.21 17:00,370,0,513,883,0
부산시청→연산교차로,2023.9.21 17:00,620,573,322,1515,0
사직운동장→연산교차로,2023.9.21 17:00,225,694,38,957,0
신리→연산교차로,2023.9.21 17:00,529,293,46,868,0
안락→연산교차로,2023.9.21 17:00,442,0,103,545,0
연산터널→연산교차로,2023.9.21 17:00,223,279,36,538,0
교대→연산교차로,2023.9.21 18:00,342,0,593,935,0
부산시청→연산교차로,2023.9.21 18:00,567,566,334,1467,0
사직운동장→연산교차로,2023.9.21 18:00,222,664,57,943,0
신리→연산교차로,2023.9.21 18:00,471,296,44,811,0
안락→연산교차로,2023.9.21 18:00,439,0,83,522,0
연산터널→연산교차로,2023.9.21 18:00,217,271,42,530,0
교대→연산교차로,2023.9.21 19:00,336,0,433,769,0
부산시청→연산교차로,2023.9.21 19:00,544,451,287,1282,0
사직운동장→연산교차로,2023.9.21 19:00,201,570,64,835,0
신리→연산교차로,2023.9.21 19:00,351,225,25,601,0
안락→연산교차로,2023.9.21 19:00,417,0,96,513,0
연산터널→연산교차로,2023.9.21 19:00,228,282,57,567,0
교대→연산교차로,2023.9.21 20:00,302,0,357,659,0
부산시청→연산교차로,2023.9.21 20:00,486,383,275,1144,0
사직운동장→연산교차로,2023.9.21 20:00,155,510,85,750,0
신리→연산교차로,2023.9.21 20:00,339,196,32,567,0
안락→연산교차로,2023.9.21 20:00,419,0,111,530,0
연산터널→연산교차로,2023.9.21 20:00,215,286,44,545,0
교대→연산교차로,2023.9.21 21:00,283,0,334,617,0
부산시청→연산교차로,2023.9.21 21:00,496,340,197,1033,0
사직운동장→연산교차로,2023.9.21 21:00,158,449,59,666,0
신리→연산교차로,2023.9.21 21:00,312,195,32,539,0
안락→연산교차로,2023.9.21 21:00,405,0,100,505,0
연산터널→연산교차로,2023.9.21 21:00,234,234,45,513,0
교대→연산교차로,2023.9.21 22:00,250,0,264,514,0
부산시청→연산교차로,2023.9.21 22:00,392,267,148,807,0
사직운동장→연산교차로,2023.9.21 22:00,123,333,48,504,0
신리→연산교차로,2023.9.21 22:00,262,152,27,441,0
안락→연산교차로,2023.9.21 22:00,375,0,93,468,0
연산터널→연산교차로,2023.9.21 22:00,205,236,51,492,0
교대→연산교차로,2023.9.21 23:00,214,0,223,437,0
부산시청→연산교차로,2023.9.21 23:00,348,209,127,684,0
사직운동장→연산교차로,2023.9.21 23:00,137,289,62,488,0
신리→연산교차로,2023.9.21 23:00,204,131,20,355,0
안락→연산교차로,2023.9.21 23:00,268,0,62,330,0
연산터널→연산교차로,2023.9.21 23:00,156,232,62,450,0
교대→연산교차로,2023.9.22 00:00,153,0,181,334,0
부산시청→연산교차로,2023.9.22 00:00,274,181,109,564,0
사직운동장→연산교차로,2023.9.22 00:00,81,229,45,355,0
신리→연산교차로,2023.9.22 00:00,180,113,15,308,0
안락→연산교차로,2023.9.22 00:00,218,0,69,287,0
연산터널→연산교차로,2023.9.22 00:00,137,167,46,350,0
교대→연산교차로,2023.9.22 01:00,113,0,166,279,0
부산시청→연산교차로,2023.9.22 01:00,215,134,69,418,0
사직운동장→연산교차로,2023.9.22 01:00,54,174,29,257,0
신리→연산교차로,2023.9.22 01:00,147,62,15,224,0
안락→연산교차로,2023.9.22 01:00,151,0,48,199,0
연산터널→연산교차로,2023.9.22 01:00,106,156,49,311,0
교대→연산교차로,2023.9.22 02:00,84,0,154,238,0
부산시청→연산교차로,2023.9.22 02:00,163,80,61,304,0
사직운동장→연산교차로,2023.9.22 02:00,48,164,20,232,0
신리→연산교차로,2023.9.22 02:00,97,61,15,173,0
안락→연산교차로,2023.9.22 02:00,158,0,35,193,0
연산터널→연산교차로,2023.9.22 02:00,101,125,37,263,0
교대→연산교차로,2023.9.22 03:00,80,0,120,200,0
부산시청→연산교차로,2023.9.22 03:00,142,67,50,259,0
사직운동장→연산교차로,2023.9.22 03:00,41,136,26,203,0
신리→연산교차로,2023.9.22 03:00,81,43,10,134,0
안락→연산교차로,2023.9.22 03:00,103,0,24,127,0
연산터널→연산교차로,2023.9.22 03:00,87,105,51,243,0
교대→연산교차로,2023.9.22 04:00,52,0,122,174,0
부산시청→연산교차로,2023.9.22 04:00,176,90,44,310,0
사직운동장→연산교차로,2023.9.22 04:00,28,126,21,175,0
신리→연산교차로,2023.9.22 04:00,96,49,9,154,0
안락→연산교차로,2023.9.22 04:00,192,0,47,239,0
연산터널→연산교차로,2023.9.22 04:00,88,110,28,226,0
교대→연산교차로,2023.9.22 05:00,87,0,129,216,0
부산시청→연산교차로,2023.9.22 05:00,239,157,88,484,0
사직운동장→연산교차로,2023.9.22 05:00,57,189,15,261,0
신리→연산교차로,2023.9.22 05:00,233,104,15,352,0
안락→연산교차로,2023.9.22 05:00,296,0,62,358,0
연산터널→연산교차로,2023.9.22 05:00,150,152,25,327,0
교대→연산교차로,2023.9.22 06:00,177,0,227,404,0
부산시청→연산교차로,2023.9.22 06:00,387,272,106,765,0
사직운동장→연산교차로,2023.9.22 06:00,83,294,48,425,0
신리→연산교차로,2023.9.22 06:00,339,206,21,566,0
안락→연산교차로,2023.9.22 06:00,517,0,115,632,0
연산터널→연산교차로,2023.9.22 06:00,235,231,40,506,0
교대→연산교차로,2023.9.22 07:00,263,0,397,660,0
부산시청→연산교차로,2023.9.22 07:00,564,379,217,1160,0
사직운동장→연산교차로,2023.9.22 07:00,179,512,55,746,0
신리→연산교차로,2023.9.22 07:00,453,313,18,784,0
안락→연산교차로,2023.9.22 07:00,639,0,79,718,0
연산터널→연산교차로,2023.9.22 07:00,283,363,22,668,0
교대→연산교차로,2023.9.22 08:00,336,0,476,812,0
부산시청→연산교차로,2023.9.22 08:00,584,438,338,1360,0
사직운동장→연산교차로,2023.9.22 08:00,205,637,38,880,0
신리→연산교차로,2023.9.22 08:00,526,327,29,882,0
안락→연산교차로,2023.9.22 08:00,626,0,82,708,0
연산터널→연산교차로,2023.9.22 08:00,303,382,22,707,0
교대→연산교차로,2023.9.22 09:00,298,0,504,802,0
부산시청→연산교차로,2023.9.22 09:00,556,385,308,1249,0
사직운동장→연산교차로,2023.9.22 09:00,192,582,35,809,0
신리→연산교차로,2023.9.22 09:00,467,339,39,845,0
안락→연산교차로,2023.9.22 09:00,594,0,81,675,0
연산터널→연산교차로,2023.9.22 09:00,305,405,41,751,0
교대→연산교차로,2023.9.22 10:00,301,0,497,798,0
부산시청→연산교차로,2023.9.22 10:00,636,390,292,1318,0
사직운동장→연산교차로,2023.9.22 10:00,202,609,46,857,0
신리→연산교차로,2023.9.22 10:00,444,274,56,774,0
안락→연산교차로,2023.9.22 10:00,545,0,112,657,0
연산터널→연산교차로,2023.9.22 10:00,302,332,52,686,0
교대→연산교차로,2023.9.22 11:00,308,0,520,828,0
부산시청→연산교차로,2023.9.22 11:00,630,379,293,1302,0
사직운동장→연산교차로,2023.9.22 11:00,205,595,46,846,0
신리→연산교차로,2023.9.22 11:00,527,267,52,846,0
안락→연산교차로,2023.9.22 11:00,533,0,136,669,0
연산터널→연산교차로,2023.9.22 11:00,268,353,55,676,0
교대→연산교차로,2023.9.22 12:00,303,0,429,732,0
부산시청→연산교차로,2023.9.22 12:00,587,370,236,1193,0
사직운동장→연산교차로,2023.9.22 12:00,189,597,50,836,0
신리→연산교차로,2023.9.22 12:00,442,234,60,736,0
안락→연산교차로,2023.9.22 12:00,493,0,144,637,0
연산터널→연산교차로,2023.9.22 12:00,299,301,44,644,0
교대→연산교차로,2023.9.22 13:00,333,0,411,744,0
부산시청→연산교차로,2023.9.22 13:00,610,458,276,1344,0
사직운동장→연산교차로,2023.9.22 13:00,214,598,50,862,0
신리→연산교차로,2023.9.22 13:00,453,305,59,817,0
안락→연산교차로,2023.9.22 13:00,434,0,90,524,0
연산터널→연산교차로,2023.9.22 13:00,237,288,39,564,0
교대→연산교차로,2023.9.22 14:00,357,0,515,872,0
부산시청→연산교차로,2023.9.22 14:00,662,488,292,1442,0
사직운동장→연산교차로,2023.9.22 14:00,234,646,78,958,0
신리→연산교차로,2023.9.22 14:00,477,295,51,823,0
안락→연산교차로,2023.9.22 14:00,436,0,123,559,0
연산터널→연산교차로,2023.9.22 14:00,230,269,60,559,0
교대→연산교차로,2023.9.22 15:00,362,0,487,849,0
부산시청→연산교차로,2023.9.22 15:00,658,506,319,1483,0
사직운동장→연산교차로,2023.9.22 15:00,224,667,67,958,0
신리→연산교차로,2023.9.22 15:00,478,298,63,839,0
안락→연산교차로,2023.9.22 15:00,447,0,90,537,0
연산터널→연산교차로,2023.9.22 15:00,238,273,46,557,0
교대→연산교차로,2023.9.22 16:00,386,0,535,921,0
부산시청→연산교차로,2023.9.22 16:00,634,549,331,1514,0
사직운동장→연산교차로,2023.9.22 16:00,235,679,43,957,0
신리→연산교차로,2023.9.22 16:00,495,284,55,834,0
안락→연산교차로,2023.9.22 16:00,468,0,122,590,0
연산터널→연산교차로,2023.9.22 16:00,265,275,35,575,0
교대→연산교차로,2023.9.22 17:00,383,0,526,909,0
부산시청→연산교차로,2023.9.22 17:00,636,574,345,1555,0
사직운동장→연산교차로,2023.9.22 17:00,243,714,41,998,0
신리→연산교차로,2023.9.22 17:00,532,257,64,853,0
안락→연산교차로,2023.9.22 17:00,483,0,103,586,0
연산터널→연산교차로,2023.9.22 17:00,217,291,49,557,0
교대→연산교차로,2023.9.22 18:00,374,0,580,954,0
부산시청→연산교차로,2023.9.22 18:00,597,591,338,1526,0
사직운동장→연산교차로,2023.9.22 18:00,227,680,47,954,0
신리→연산교차로,2023.9.22 18:00,497,273,46,816,0
안락→연산교차로,2023.9.22 18:00,457,0,102,559,0
연산터널→연산교차로,2023.9.22 18:00,208,295,56,559,0
교대→연산교차로,2023.9.22 19:00,343,0,477,820,0
부산시청→연산교차로,2023.9.22 19:00,540,487,329,1356,0
사직운동장→연산교차로,2023.9.22 19:00,221,599,82,902,0
신리→연산교차로,2023.9.22 19:00,423,242,36,701,0
안락→연산교차로,2023.9.22 19:00,415,0,107,522,0
연산터널→연산교차로,2023.9.22 19:00,198,249,52,499,0
교대→연산교차로,2023.9.22 20:00,337,0,429,766,0
부산시청→연산교차로,2023.9.22 20:00,546,400,271,1217,0
사직운동장→연산교차로,2023.9.22 20:00,215,531,88,834,0
신리→연산교차로,2023.9.22 20:00,363,202,44,609,0
안락→연산교차로,2023.9.22 20:00,416,0,125,541,0
연산터널→연산교차로,2023.9.22 20:00,237,257,51,545,0
교대→연산교차로,2023.9.22 21:00,312,0,398,710,0
부산시청→연산교차로,2023.9.22 21:00,519,381,225,1125,0
사직운동장→연산교차로,2023.9.22 21:00,186,502,86,774,0
신리→연산교차로,2023.9.22 21:00,331,192,42,565,0
안락→연산교차로,2023.9.22 21:00,436,0,112,548,0
연산터널→연산교차로,2023.9.22 21:00,235,276,68,579,0
교대→연산교차로,2023.9.22 22:00,311,0,331,642,0
부산시청→연산교차로,2023.9.22 22:00,422,309,195,926,0
사직운동장→연산교차로,2023.9.22 22:00,153,386,75,614,0
신리→연산교차로,2023.9.22 22:00,336,189,34,559,0
안락→연산교차로,2023.9.22 22:00,417,0,112,529,0
연산터널→연산교차로,2023.9.22 22:00,235,262,63,560,0
교대→연산교차로,2023.9.22 23:00,229,0,289,518,0
부산시청→연산교차로,2023.9.22 23:00,372,273,164,809,0
사직운동장→연산교차로,2023.9.22 23:00,115,338,76,529,0
신리→연산교차로,2023.9.22 23:00,270,165,28,463,0
안락→연산교차로,2023.9.22 23:00,303,0,86,389,0
연산터널→연산교차로,2023.9.22 23:00,183,238,78,499,0
교대→연산교차로,2023.9.23 00:00,189,0,256,445,0
부산시청→연산교차로,2023.9.23 00:00,325,222,133,680,0
사직운동장→연산교차로,2023.9.23 00:00,90,279,63,432,0
신리→연산교차로,2023.9.23 00:00,240,126,26,392,0
안락→연산교차로,2023.9.23 00:00,280,0,82,362,0
연산터널→연산교차로,2023.9.23 00:00,205,222,64,491,0
교대→연산교차로,2023.9.23 01:00,142,0,237,379,0
부산시청→연산교차로,2023.9.23 01:00,257,182,103,542,0
사직운동장→연산교차로,2023.9.23 01:00,69,233,51,353,0
신리→연산교차로,2023.9.23 01:00,174,103,15,292,0
안락→연산교차로,2023.9.23 01:00,222,0,62,284,0
연산터널→연산교차로,2023.9.23 01:00,163,191,35,389,0
교대→연산교차로,2023.9.23 02:00,118,0,199,317,0
부산시청→연산교차로,2023.9.23 02:00,236,139,84,459,0
사직운동장→연산교차로,2023.9.23 02:00,61,186,43,290,0
신리→연산교차로,2023.9.23 02:00,147,82,17,246,0
안락→연산교차로,2023.9.23 02:00,196,0,57,253,0
연산터널→연산교차로,2023.9.23 02:00,120,167,35,322,0
교대→연산교차로,2023.9.23 03:00,80,0,168,248,0
부산시청→연산교차로,2023.9.23 03:00,218,102,82,402,0
사직운동장→연산교차로,2023.9.23 03:00,50,163,30,243,0
신리→연산교차로,2023.9.23 03:00,106,47,19,172,0
안락→연산교차로,2023.9.23 03:00,159,0,43,202,0
연산터널→연산교차로,2023.9.23 03:00,113,144,37,294,0
교대→연산교차로,2023.9.23 04:00,84,0,145,229,0
부산시청→연산교차로,2023.9.23 04:00,191,80,60,331,0
사직운동장→연산교차로,2023.9.23 04:00,49,149,16,214,0
신리→연산교차로,2023.9.23 04:00,108,71,10,189,0
안락→연산교차로,2023.9.23 04:00,214,0,45,259,0
연산터널→연산교차로,2023.9.23 04:00,90,137,31,258,0
교대→연산교차로,2023.9.23 05:00,98,0,132,230,0
부산시청→연산교차로,2023.9.23 05:00,279,165,86,530,0
사직운동장→연산교차로,2023.9.23 05:00,50,171,14,235,0
신리→연산교차로,2023.9.23 05:00,216,101,4,321,0
안락→연산교차로,2023.9.23 05:00,320,0,50,370,0
연산터널→연산교차로,2023.9.23 05:00,131,162,31,324,0
교대→연산교차로,2023.9.23 06:00,164,0,201,365,0
부산시청→연산교차로,2023.9.23 06:00,342,255,102,699,0
사직운동장→연산교차로,2023.9.23 06:00,74,251,64,389,0
신리→연산교차로,2023.9.23 06:00,318,169,16,503,0
안락→연산교차로,2023.9.23 06:00,410,0,101,511,0
연산터널→연산교차로,2023.9.23 06:00,216,181,40,437,0
교대→연산교차로,2023.9.23 07:00,194,0,219,413,0
부산시청→연산교차로,2023.9.23 07:00,406,289,135,830,0
사직운동장→연산교차로,2023.9.23 07:00,142,360,50,552,0
신리→연산교차로,2023.9.23 07:00,340,155,29,524,0
안락→연산교차로,2023.9.23 07:00,448,0,102,550,0
연산터널→연산교차로,2023.9.23 07:00,207,208,37,452,0
교대→연산교차로,2023.9.23 08:00,268,0,311,579,0
부산시청→연산교차로,2023.9.23 08:00,513,313,206,1032,0
사직운동장→연산교차로,2023.9.23 08:00,199,530,39,768,0
신리→연산교차로,2023.9.23 08:00,434,267,37,738,0
안락→연산교차로,2023.9.23 08:00,515,0,113,628,0
연산터널→연산교차로,2023.9.23 08:00,265,278,48,591,0
교대→연산교차로,2023.9.23 09:00,301,0,429,730,0
부산시청→연산교차로,2023.9.23 09:00,648,382,261,1291,0
사직운동장→연산교차로,2023.9.23 09:00,201,638,37,876,0
신리→연산교차로,2023.9.23 09:00,507,305,52,864,0
안락→연산교차로,2023.9.23 09:00,598,0,140,738,0
연산터널→연산교차로,2023.9.23 09:00,308,321,62,691,0
교대→연산교차로,2023.9.23 10:00,311,0,420,731,0
부산시청→연산교차로,2023.9.23 10:00,630,382,315,1327,0
사직운동장→연산교차로,2023.9.23 10:00,202,646,42,890,0
신리→연산교차로,2023.9.23 10:00,513,293,64,870,0
안락→연산교차로,2023.9.23 10:00,565,0,144,709,0
연산터널→연산교차로,2023.9.23 10:00,307,362,69,738,0
교대→연산교차로,2023.9.23 11:00,303,0,446,749,0
부산시청→연산교차로,2023.9.23 11:00,631,381,298,1310,0
사직운동장→연산교차로,2023.9.23 11:00,206,637,48,891,0
신리→연산교차로,2023.9.23 11:00,520,275,72,867,0
안락→연산교차로,2023.9.23 11:00,577,0,177,754,0
연산터널→연산교차로,2023.9.23 11:00,278,367,56,701,0
교대→연산교차로,2023.9.23 12:00,320,0,512,832,0
부산시청→연산교차로,2023.9.23 12:00,631,384,299,1314,0
사직운동장→연산교차로,2023.9.23 12:00,209,632,46,887,0
신리→연산교차로,2023.9.23 12:00,512,307,68,887,0
안락→연산교차로,2023.9.23 12:00,563,0,147,710,0
연산터널→연산교차로,2023.9.23 12:00,326,326,66,718,0
교대→연산교차로,2023.9.23 13:00,369,0,508,877,0
부산시청→연산교차로,2023.9.23 13:00,655,493,310,1458,0
사직운동장→연산교차로,2023.9.23 13:00,199,707,35,941,0
신리→연산교차로,2023.9.23 13:00,523,293,51,867,0
안락→연산교차로,2023.9.23 13:00,468,0,113,581,0
연산터널→연산교차로,2023.9.23 13:00,239,289,40,568,0
교대→연산교차로,2023.9.23 14:00,359,0,557,916,0
부산시청→연산교차로,2023.9.23 14:00,649,509,337,1495,0
사직운동장→연산교차로,2023.9.23 14:00,215,661,43,919,0
신리→연산교차로,2023.9.23 14:00,429,269,67,765,0
안락→연산교차로,2023.9.23 14:00,477,0,84,561,0
연산터널→연산교차로,2023.9.23 14:00,236,291,42,569,0
교대→연산교차로,2023.9.23 15:00,364,0,414,778,0
부산시청→연산교차로,2023.9.23 15:00,567,423,287,1277,0
사직운동장→연산교차로,2023.9.23 15:00,198,696,47,941,0
신리→연산교차로,2023.9.23 15:00,520,235,75,830,0
안락→연산교차로,2023.9.23 15:00,454,0,89,543,0
연산터널→연산교차로,2023.9.23 15:00,244,275,41,560,0
교대→연산교차로,2023.9.23 16:00,384,0,462,846,0
부산시청→연산교차로,2023.9.23 16:00,671,510,303,1484,0
사직운동장→연산교차로,2023.9.23 16:00,252,670,19,941,0
신리→연산교차로,2023.9.23 16:00,497,271,53,821,0
안락→연산교차로,2023.9.23 16:00,456,0,103,559,0
연산터널→연산교차로,2023.9.23 16:00,248,273,37,558,0
교대→연산교차로,2023.9.23 17:00,366,0,440,806,0
부산시청→연산교차로,2023.9.23 17:00,633,501,305,1439,0
사직운동장→연산교차로,2023.9.23 17:00,220,689,30,939,0
신리→연산교차로,2023.9.23 17:00,471,242,50,763,0
안락→연산교차로,2023.9.23 17:00,462,0,92,554,0
연산터널→연산교차로,2023.9.23 17:00,232,290,41,563,0
교대→연산교차로,2023.9.23 18:00,333,0,381,714,0
부산시청→연산교차로,2023.9.23 18:00,603,448,243,1294,0
사직운동장→연산교차로,2023.9.23 18:00,192,582,90,864,0
신리→연산교차로,2023.9.23 18:00,389,242,35,666,0
안락→연산교차로,2023.9.23 18:00,440,0,85,525,0
연산터널→연산교차로,2023.9.23 18:00,219,272,41,532,0
교대→연산교차로,2023.9.23 19:00,333,0,404,737,0
부산시청→연산교차로,2023.9.23 19:00,532,385,259,1176,0
사직운동장→연산교차로,2023.9.23 19:00,215,544,80,839,0
신리→연산교차로,2023.9.23 19:00,323,255,33,611,0
안락→연산교차로,2023.9.23 19:00,412,0,96,508,0
연산터널→연산교차로,2023.9.23 19:00,235,273,38,546,0
교대→연산교차로,2023.9.23 20:00,301,0,353,654,0
부산시청→연산교차로,2023.9.23 20:00,484,333,238,1055,0
사직운동장→연산교차로,2023.9.23 20:00,165,507,92,764,0
신리→연산교차로,2023.9.23 20:00,384,200,41,625,0
안락→연산교차로,2023.9.23 20:00,431,0,106,537,0
연산터널→연산교차로,2023.9.23 20:00,219,259,41,519,0
교대→연산교차로,2023.9.23 21:00,294,0,344,638,0
부산시청→연산교차로,2023.9.23 21:00,460,300,213,973,0
사직운동장→연산교차로,2023.9.23 21:00,164,414,62,640,0
신리→연산교차로,2023.9.23 21:00,352,224,41,617,0
안락→연산교차로,2023.9.23 21:00,425,0,102,527,0
연산터널→연산교차로,2023.9.23 21:00,222,262,75,559,0
교대→연산교차로,2023.9.23 22:00,261,0,280,541,0
부산시청→연산교차로,2023.9.23 22:00,424,246,141,811,0
사직운동장→연산교차로,2023.9.23 22:00,129,366,81,576,0
신리→연산교차로,2023.9.23 22:00,297,163,34,494,0
안락→연산교차로,2023.9.23 22:00,354,0,80,434,0
연산터널→연산교차로,2023.9.23 22:00,197,250,54,501,0
교대→연산교차로,2023.9.23 23:00,218,0,241,459,0
부산시청→연산교차로,2023.9.23 23:00,320,231,136,687,0
사직운동장→연산교차로,2023.9.23 23:00,89,282,68,439,0
신리→연산교차로,2023.9.23 23:00,257,130,29,416,0
안락→연산교차로,2023.9.23 23:00,307,0,72,379,0
연산터널→연산교차로,2023.9.23 23:00,185,213,75,473,0
교대→연산교차로,2023.9.24 00:00,174,0,222,396,1
부산시청→연산교차로,2023.9.24 00:00,321,192,125,638,1
사직운동장→연산교차로,2023.9.24 00:00,73,236,45,354,1
신리→연산교차로,2023.9.24 00:00,241,120,14,375,1
안락→연산교차로,2023.9.24 00:00,258,0,69,327,1
연산터널→연산교차로,2023.9.24 00:00,147,201,65,413,1
교대→연산교차로,2023.9.24 01:00,151,0,262,413,1
부산시청→연산교차로,2023.9.24 01:00,278,167,96,541,1
사직운동장→연산교차로,2023.9.24 01:00,58,216,48,322,1
신리→연산교차로,2023.9.24 01:00,183,116,21,320,1
안락→연산교차로,2023.9.24 01:00,219,0,63,282,1
연산터널→연산교차로,2023.9.24 01:00,128,193,55,376,1
교대→연산교차로,2023.9.24 02:00,124,0,226,350,1
부산시청→연산교차로,2023.9.24 02:00,214,139,87,440,1
사직운동장→연산교차로,2023.9.24 02:00,62,186,48,296,1
신리→연산교차로,2023.9.24 02:00,125,65,25,215,1
안락→연산교차로,2023.9.24 02:00,197,0,46,243,1
연산터널→연산교차로,2023.9.24 02:00,114,142,35,291,1
교대→연산교차로,2023.9.24 03:00,89,0,167,256,1
부산시청→연산교차로,2023.9.24 03:00,190,102,62,354,1
사직운동장→연산교차로,2023.9.24 03:00,38,150,33,221,1
신리→연산교차로,2023.9.24 03:00,101,71,12,184,1
안락→연산교차로,2023.9.24 03:00,164,0,46,210,1
연산터널→연산교차로,2023.9.24 03:00,100,119,30,249,1
교대→연산교차로,2023.9.24 04:00,79,0,105,184,1
부산시청→연산교차로,2023.9.24 04:00,181,89,57,327,1
사직운동장→연산교차로,2023.9.24 04:00,30,123,28,181,1
신리→연산교차로,2023.9.24 04:00,77,66,9,152,1
안락→연산교차로,2023.9.24 04:00,145,0,31,176,1
연산터널→연산교차로,2023.9.24 04:00,69,119,21,209,1
교대→연산교차로,2023.9.24 05:00,73,0,106,179,1
부산시청→연산교차로,2023.9.24 05:00,185,142,63,390,1
사직운동장→연산교차로,2023.9.24 05:00,39,131,19,189,1
신리→연산교차로,2023.9.24 05:00,138,56,8,202,1
안락→연산교차로,2023.9.24 05:00,185,0,41,226,1
연산터널→연산교차로,2023.9.24 05:00,94,94,14,202,1
교대→연산교차로,2023.9.24 06:00,110,0,135,245,1
부산시청→연산교차로,2023.9.24 06:00,262,192,74,528,1
사직운동장→연산교차로,2023.9.24 06:00,64,198,30,292,1
신리→연산교차로,2023.9.24 06:00,190,86,9,285,1
안락→연산교차로,2023.9.24 06:00,301,0,66,367,1
연산터널→연산교차로,2023.9.24 06:00,161,131,27,319,1
교대→연산교차로,2023.9.24 07:00,134,0,142,276,1
부산시청→연산교차로,2023.9.24 07:00,289,180,116,585,1
사직운동장→연산교차로,2023.9.24 07:00,90,243,43,376,1
신리→연산교차로,2023.9.24 07:00,223,96,15,334,1
안락→연산교차로,2023.9.24 07:00,313,0,70,383,1
연산터널→연산교차로,2023.9.24 07:00,145,143,27,315,1
교대→연산교차로,2023.9.24 08:00,165,0,190,355,1
부산시청→연산교차로,2023.9.24 08:00,316,238,117,671,1
사직운동장→연산교차로,2023.9.24 08:00,113,328,27,468,1
신리→연산교차로,2023.9.24 08:00,304,178,21,503,1
안락→연산교차로,2023.9.24 08:00,373,0,77,450,1
연산터널→연산교차로,2023.9.24 08:00,194,178,14,386,1
교대→연산교차로,2023.9.24 09:00,241,0,209,450,1
부산시청→연산교차로,2023.9.24 09:00,406,299,176,881,1
사직운동장→연산교차로,2023.9.24 09:00,122,442,43,607,1
신리→연산교차로,2023.9.24 09:00,389,232,36,657,1
안락→연산교차로,2023.9.24 09:00,442,0,109,551,1
연산터널→연산교차로,2023.9.24 09:00,292,245,29,566,1
교대→연산교차로,2023.9.24 10:00,279,0,327,606,1
부산시청→연산교차로,2023.9.24 10:00,529,308,196,1033,1
사직운동장→연산교차로,2023.9.24 10:00,174,595,65,834,1
신리→연산교차로,2023.9.24 10:00,438,237,48,723,1
안락→연산교차로,2023.9.24 10:00,488,0,121,609,1
연산터널→연산교차로,2023.9.24 10:00,261,267,39,567,1
교대→연산교차로,2023.9.24 11:00,253,0,304,557,1
부산시청→연산교차로,2023.9.24 11:00,512,342,176,1030,1
사직운동장→연산교차로,2023.9.24 11:00,171,565,52,788,1
신리→연산교차로,2023.9.24 11:00,465,194,37,696,1
안락→연산교차로,2023.9.24 11:00,522,0,130,652,1
연산터널→연산교차로,2023.9.24 11:00,282,270,39,591,1
교대→연산교차로,2023.9.24 12:00,286,0,317,603,1
부산시청→연산교차로,2023.9.24 12:00,540,352,211,1103,1
사직운동장→연산교차로,2023.9.24 12:00,173,574,52,799,1
신리→연산교차로,2023.9.24 12:00,423,215,40,678,1
안락→연산교차로,2023.9.24 12:00,518,0,145,663,1
연산터널→연산교차로,2023.9.24 12:00,258,264,52,574,1
교대→연산교차로,2023.9.24 13:00,285,0,316,601,1
부산시청→연산교차로,2023.9.24 13:00,574,355,231,1160,1
사직운동장→연산교차로,2023.9.24 13:00,203,588,40,831,1
신리→연산교차로,2023.9.24 13:00,381,227,47,655,1
안락→연산교차로,2023.9.24 13:00,507,0,122,629,1
연산터널→연산교차로,2023.9.24 13:00,248,265,52,565,1
교대→연산교차로,2023.9.24 14:00,299,0,352,651,1
부산시청→연산교차로,2023.9.24 14:00,634,332,233,1199,1
사직운동장→연산교차로,2023.9.24 14:00,214,606,36,856,1
신리→연산교차로,2023.9.24 14:00,362,231,38,631,1
안락→연산교차로,2023.9.24 14:00,542,0,127,669,1
연산터널→연산교차로,2023.9.24 14:00,260,300,57,617,1
교대→연산교차로,2023.9.24 15:00,301,0,375,676,1
부산시청→연산교차로,2023.9.24 15:00,547,342,214,1103,1
사직운동장→연산교차로,2023.9.24 15:00,217,541,66,824,1
신리→연산교차로,2023.9.24 15:00,418,199,53,670,1
안락→연산교차로,2023.9.24 15:00,569,0,115,684,1
연산터널→연산교차로,2023.9.24 15:00,242,271,43,556,1
교대→연산교차로,2023.9.24 16:00,291,0,319,610,1
부산시청→연산교차로,2023.9.24 16:00,522,355,185,1062,1
사직운동장→연산교차로,2023.9.24 16:00,217,587,45,849,1
신리→연산교차로,2023.9.24 16:00,399,210,40,649,1
안락→연산교차로,2023.9.24 16:00,512,0,163,675,1
연산터널→연산교차로,2023.9.24 16:00,235,263,33,531,1
교대→연산교차로,2023.9.24 17:00,265,0,328,593,1
부산시청→연산교차로,2023.9.24 17:00,506,368,210,1084,1
사직운동장→연산교차로,2023.9.24 17:00,175,514,51,740,1
신리→연산교차로,2023.9.24 17:00,386,209,32,627,1
안락→연산교차로,2023.9.24 17:00,577,0,154,731,1
연산터널→연산교차로,2023.9.24 17:00,266,256,45,567,1
교대→연산교차로,2023.9.24 18:00,306,0,325,631,1
부산시청→연산교차로,2023.9.24 18:00,468,298,193,959,1
사직운동장→연산교차로,2023.9.24 18:00,201,482,64,747,1
신리→연산교차로,2023.9.24 18:00,400,182,29,611,1
안락→연산교차로,2023.9.24 18:00,510,0,125,635,1
연산터널→연산교차로,2023.9.24 18:00,241,265,70,576,1
교대→연산교차로,2023.9.24 19:00,264,0,306,570,1
부산시청→연산교차로,2023.9.24 19:00,410,295,184,889,1
사직운동장→연산교차로,2023.9.24 19:00,155,431,60,646,1
신리→연산교차로,2023.9.24 19:00,335,198,28,561,1
안락→연산교차로,2023.9.24 19:00,412,0,147,559,1
연산터널→연산교차로,2023.9.24 19:00,207,247,48,502,1
교대→연산교차로,2023.9.24 20:00,263,0,274,537,1
부산시청→연산교차로,2023.9.24 20:00,392,261,134,787,1
사직운동장→연산교차로,2023.9.24 20:00,139,396,49,584,1
신리→연산교차로,2023.9.24 20:00,304,169,30,503,1
안락→연산교차로,2023.9.24 20:00,377,0,117,494,1
연산터널→연산교차로,2023.9.24 20:00,201,194,45,440,1
교대→연산교차로,2023.9.24 21:00,242,0,234,476,1
부산시청→연산교차로,2023.9.24 21:00,356,223,136,715,1
사직운동장→연산교차로,2023.9.24 21:00,108,326,60,494,1
신리→연산교차로,2023.9.24 21:00,267,158,28,453,1
안락→연산교차로,2023.9.24 21:00,331,0,78,409,1
연산터널→연산교차로,2023.9.24 21:00,170,159,46,375,1
교대→연산교차로,2023.9.24 22:00,184,0,205,389,1
부산시청→연산교차로,2023.9.24 22:00,295,186,98,579,1
사직운동장→연산교차로,2023.9.24 22:00,104,283,69,456,1
신리→연산교차로,2023.9.24 22:00,210,117,32,359,1
안락→연산교차로,2023.9.24 22:00,271,0,63,334,1
연산터널→연산교차로,2023.9.24 22:00,119,191,66,376,1
교대→연산교차로,2023.9.24 23:00,129,0,171,300,1
부산시청→연산교차로,2023.9.24 23:00,224,148,108,480,1
사직운동장→연산교차로,2023.9.24 23:00,54,224,59,337,1
신리→연산교차로,2023.9.24 23:00,172,105,17,294,1
안락→연산교차로,2023.9.24 23:00,211,0,67,278,1
연산터널→연산교차로,2023.9.24 23:00,143,150,77,370,1
교대→연산교차로,2023.9.25 00:00,92,0,150,242,0
부산시청→연산교차로,2023.9.25 00:00,187,115,79,381,0
사직운동장→연산교차로,2023.9.25 00:00,50,169,59,278,0
신리→연산교차로,2023.9.25 00:00,127,74,11,212,0
안락→연산교차로,2023.9.25 00:00,156,0,38,194,0
연산터널→연산교차로,2023.9.25 00:00,112,137,55,304,0
교대→연산교차로,2023.9.25 01:00,81,0,111,192,0
부산시청→연산교차로,2023.9.25 01:00,160,99,66,325,0
사직운동장→연산교차로,2023.9.25 01:00,39,132,38,209,0
신리→연산교차로,2023.9.25 01:00,91,48,8,147,0
안락→연산교차로,2023.9.25 01:00,111,0,29,140,0
연산터널→연산교차로,2023.9.25 01:00,69,96,57,222,0
교대→연산교차로,2023.9.25 02:00,73,0,102,175,0
부산시청→연산교차로,2023.9.25 02:00,119,68,46,233,0
사직운동장→연산교차로,2023.9.25 02:00,25,122,28,175,0
신리→연산교차로,2023.9.25 02:00,59,32,9,100,0
안락→연산교차로,2023.9.25 02:00,119,0,16,135,0
연산터널→연산교차로,2023.9.25 02:00,79,101,30,210,0
교대→연산교차로,2023.9.25 03:00,41,0,84,125,0
부산시청→연산교차로,2023.9.25 03:00,123,74,40,237,0
사직운동장→연산교차로,2023.9.25 03:00,24,105,19,148,0
신리→연산교차로,2023.9.25 03:00,59,26,8,93,0
안락→연산교차로,2023.9.25 03:00,97,0,27,124,0
연산터널→연산교차로,2023.9.25 03:00,54,86,43,183,0
교대→연산교차로,2023.9.25 04:00,50,0,89,139,0
부산시청→연산교차로,2023.9.25 04:00,148,59,49,256,0
사직운동장→연산교차로,2023.9.25 04:00,19,94,20,133,0
신리→연산교차로,2023.9.25 04:00,91,42,6,139,0
안락→연산교차로,2023.9.25 04:00,160,0,29,189,0
연산터널→연산교차로,2023.9.25 04:00,70,73,26,169,0
교대→연산교차로,2023.9.25 05:00,88,0,113,201,0
부산시청→연산교차로,2023.9.25 05:00,244,149,67,460,0
사직운동장→연산교차로,2023.9.25 05:00,50,162,11,223,0
신리→연산교차로,2023.9.25 05:00,230,104,12,346,0
안락→연산교차로,2023.9.25 05:00,345,0,39,384,0
연산터널→연산교차로,2023.9.25 05:00,118,131,21,270,0
교대→연산교차로,2023.9.25 06:00,176,0,247,423,0
부산시청→연산교차로,2023.9.25 06:00,380,280,115,775,0
사직운동장→연산교차로,2023.9.25 06:00,85,282,50,417,0
신리→연산교차로,2023.9.25 06:00,368,220,29,617,0
안락→연산교차로,2023.9.25 06:00,522,0,103,625,0
연산터널→연산교차로,2023.9.25 06:00,216,251,36,503,0
교대→연산교차로,2023.9.25 07:00,264,0,407,671,0
부산시청→연산교차로,2023.9.25 07:00,584,389,226,1199,0
사직운동장→연산교차로,2023.9.25 07:00,177,526,49,752,0
신리→연산교차로,2023.9.25 07:00,487,299,30,816,0
안락→연산교차로,2023.9.25 07:00,652,0,76,728,0
연산터널→연산교차로,2023.9.25 07:00,294,373,38,705,0
교대→연산교차로,2023.9.25 08:00,310,0,513,823,0
부산시청→연산교차로,2023.9.25 08:00,586,443,353,1382,0
사직운동장→연산교차로,2023.9.25 08:00,217,667,36,920,0
신리→연산교차로,2023.9.25 08:00,492,351,40,883,0
안락→연산교차로,2023.9.25 08:00,639,0,108,747,0
연산터널→연산교차로,2023.9.25 08:00,315,396,41,752,0
교대→연산교차로,2023.9.25 09:00,289,0,478,767,0
부산시청→연산교차로,2023.9.25 09:00,567,408,289,1264,0
사직운동장→연산교차로,2023.9.25 09:00,179,570,85,834,0
신리→연산교차로,2023.9.25 09:00,471,334,56,861,0
안락→연산교차로,2023.9.25 09:00,590,0,99,689,0
연산터널→연산교차로,2023.9.25 09:00,306,368,49,723,0
교대→연산교차로,2023.9.25 10:00,294,0,516,810,0
부산시청→연산교차로,2023.9.25 10:00,610,360,289,1259,0
사직운동장→연산교차로,2023.9.25 10:00,220,573,55,848,0
신리→연산교차로,2023.9.25 10:00,473,298,52,823,0
안락→연산교차로,2023.9.25 10:00,551,0,116,667,0
연산터널→연산교차로,2023.9.25 10:00,312,365,56,733,0
교대→연산교차로,2023.9.25 11:00,304,0,496,800,0
부산시청→연산교차로,2023.9.25 11:00,597,373,324,1294,0
사직운동장→연산교차로,2023.9.25 11:00,201,614,63,878,0
신리→연산교차로,2023.9.25 11:00,435,279,65,779,0
안락→연산교차로,2023.9.25 11:00,536,0,147,683,0
연산터널→연산교차로,2023.9.25 11:00,285,336,54,675,0
교대→연산교차로,2023.9.25 12:00,295,0,429,724,0
부산시청→연산교차로,2023.9.25 12:00,611,369,281,1261,0
사직운동장→연산교차로,2023.9.25 12:00,171,579,61,811,0
신리→연산교차로,2023.9.25 12:00,458,261,60,779,0
안락→연산교차로,2023.9.25 12:00,510,0,164,674,0
연산터널→연산교차로,2023.9.25 12:00,305,291,32,628,0
교대→연산교차로,2023.9.25 13:00,335,0,422,757,0
부산시청→연산교차로,2023.9.25 13:00,609,455,338,1402,0
사직운동장→연산교차로,2023.9.25 13:00,211,625,66,902,0
신리→연산교차로,2023.9.25 13:00,487,262,64,813,0
안락→연산교차로,2023.9.25 13:00,426,0,123,549,0
연산터널→연산교차로,2023.9.25 13:00,248,278,44,570,0
교대→연산교차로,2023.9.25 14:00,328,0,546,874,0
부산시청→연산교차로,2023.9.25 14:00,637,506,297,1440,0
사직운동장→연산교차로,2023.9.25 14:00,229,654,66,949,0
신리→연산교차로,2023.9.25 14:00,485,277,59,821,0
안락→연산교차로,2023.9.25 14:00,434,0,100,534,0
연산터널→연산교차로,2023.9.25 14:00,252,273,48,573,0
교대→연산교차로,2023.9.25 15:00,374,0,535,909,0
부산시청→연산교차로,2023.9.25 15:00,651,501,314,1466,0
사직운동장→연산교차로,2023.9.25 15:00,259,647,60,966,0
신리→연산교차로,2023.9.25 15:00,492,272,63,827,0
안락→연산교차로,2023.9.25 15:00,442,0,100,542,0
연산터널→연산교차로,2023.9.25 15:00,252,284,46,582,0
교대→연산교차로,2023.9.25 16:00,350,0,514,864,0
부산시청→연산교차로,2023.9.25 16:00,654,536,304,1494,0
사직운동장→연산교차로,2023.9.25 16:00,250,668,41,959,0
신리→연산교차로,2023.9.25 16:00,482,294,62,838,0
안락→연산교차로,2023.9.25 16:00,436,0,108,544,0
연산터널→연산교차로,2023.9.25 16:00,231,282,33,546,0
교대→연산교차로,2023.9.25 17:00,374,0,571,945,0
부산시청→연산교차로,2023.9.25 17:00,646,560,305,1511,0
사직운동장→연산교차로,2023.9.25 17:00,236,715,33,984,0
신리→연산교차로,2023.9.25 17:00,560,267,47,874,0
안락→연산교차로,2023.9.25 17:00,469,0,97,566,0
연산터널→연산교차로,2023.9.25 17:00,224,286,42,552,0
교대→연산교차로,2023.9.25 18:00,381,0,585,966,0
부산시청→연산교차로,2023.9.25 18:00,589,582,334,1505,0
사직운동장→연산교차로,2023.9.25 18:00,244,702,52,998,0
신리→연산교차로,2023.9.25 18:00,521,269,53,843,0
안락→연산교차로,2023.9.25 18:00,440,0,97,537,0
연산터널→연산교차로,2023.9.25 18:00,227,279,44,550,0
교대→연산교차로,2023.9.25 19:00,336,0,416,752,0
부산시청→연산교차로,2023.9.25 19:00,535,464,326,1325,0
사직운동장→연산교차로,2023.9.25 19:00,222,623,70,915,0
신리→연산교차로,2023.9.25 19:00,405,212,33,650,0
안락→연산교차로,2023.9.25 19:00,424,0,101,525,0
연산터널→연산교차로,2023.9.25 19:00,220,287,52,559,0
교대→연산교차로,2023.9.25 20:00,315,0,401,716,0
부산시청→연산교차로,2023.9.25 20:00,510,404,250,1164,0
사직운동장→연산교차로,2023.9.25 20:00,182,532,88,802,0
신리→연산교차로,2023.9.25 20:00,330,207,35,572,0
안락→연산교차로,2023.9.25 20:00,415,0,111,526,0
연산터널→연산교차로,2023.9.25 20:00,222,274,57,553,0
교대→연산교차로,2023.9.25 21:00,304,0,362,666,0
부산시청→연산교차로,2023.9.25 21:00,526,368,244,1138,0
사직운동장→연산교차로,2023.9.25 21:00,165,453,83,701,0
신리→연산교차로,2023.9.25 21:00,296,171,34,501,0
안락→연산교차로,2023.9.25 21:00,396,0,96,492,0
연산터널→연산교차로,2023.9.25 21:00,212,283,82,577,0
교대→연산교차로,2023.9.25 22:00,263,0,257,520,0
부산시청→연산교차로,2023.9.25 22:00,428,265,185,878,0
사직운동장→연산교차로,2023.9.25 22:00,158,389,83,630,0
신리→연산교차로,2023.9.25 22:00,258,164,32,454,0
안락→연산교차로,2023.9.25 22:00,354,0,102,456,0
연산터널→연산교차로,2023.9.25 22:00,201,252,79,532,0
교대→연산교차로,2023.9.25 23:00,171,0,208,379,0
부산시청→연산교차로,2023.9.25 23:00,303,177,124,604,0
사직운동장→연산교차로,2023.9.25 23:00,104,270,86,460,0
신리→연산교차로,2023.9.25 23:00,208,115,21,344,0
안락→연산교차로,2023.9.25 23:00,244,0,65,309,0
연산터널→연산교차로,2023.9.25 23:00,174,205,65,444,0
교대→연산교차로,2023.9.26 00:00,136,0,215,351,0
부산시청→연산교차로,2023.9.26 00:00,257,152,108,517,0
사직운동장→연산교차로,2023.9.26 00:00,69,237,65,371,0
신리→연산교차로,2023.9.26 00:00,164,95,19,278,0
안락→연산교차로,2023.9.26 00:00,213,0,48,261,0
연산터널→연산교차로,2023.9.26 00:00,148,178,79,405,0
교대→연산교차로,2023.9.26 01:00,101,0,157,258,0
부산시청→연산교차로,2023.9.26 01:00,185,134,68,387,0
사직운동장→연산교차로,2023.9.26 01:00,42,188,64,294,0
신리→연산교차로,2023.9.26 01:00,128,68,14,210,0
안락→연산교차로,2023.9.26 01:00,162,0,29,191,0
연산터널→연산교차로,2023.9.26 01:00,124,146,77,347,0
교대→연산교차로,2023.9.26 02:00,84,0,111,195,0
부산시청→연산교차로,2023.9.26 02:00,176,83,65,324,0
사직운동장→연산교차로,2023.9.26 02:00,53,135,22,210,0
신리→연산교차로,2023.9.26 02:00,104,47,11,162,0
안락→연산교차로,2023.9.26 02:00,128,0,48,176,0
연산터널→연산교차로,2023.9.26 02:00,93,117,39,249,0
교대→연산교차로,2023.9.26 03:00,48,0,122,170,0
부산시청→연산교차로,2023.9.26 03:00,147,87,49,283,0
사직운동장→연산교차로,2023.9.26 03:00,43,136,24,203,0
신리→연산교차로,2023.9.26 03:00,91,38,13,142,0
안락→연산교차로,2023.9.26 03:00,106,0,26,132,0
연산터널→연산교차로,2023.9.26 03:00,79,90,29,198,0
교대→연산교차로,2023.9.26 04:00,58,0,83,141,0
부산시청→연산교차로,2023.9.26 04:00,149,75,44,268,0
사직운동장→연산교차로,2023.9.26 04:00,34,120,25,179,0
신리→연산교차로,2023.9.26 04:00,89,59,6,154,0
안락→연산교차로,2023.9.26 04:00,177,0,35,212,0
연산터널→연산교차로,2023.9.26 04:00,98,95,36,229,0
교대→연산교차로,2023.9.26 05:00,82,0,122,204,0
부산시청→연산교차로,2023.9.26 05:00,226,147,84,457,0
사직운동장→연산교차로,2023.9.26 05:00,55,182,16,253,0
신리→연산교차로,2023.9.26 05:00,222,104,8,334,0
안락→연산교차로,2023.9.26 05:00,306,0,52,358,0
연산터널→연산교차로,2023.9.26 05:00,140,153,23,316,0
교대→연산교차로,2023.9.26 06:00,173,0,233,406,0
부산시청→연산교차로,2023.9.26 06:00,385,279,124,788,0
사직운동장→연산교차로,2023.9.26 06:00,78,314,49,441,0
신리→연산교차로,2023.9.26 06:00,336,207,20,563,0
안락→연산교차로,2023.9.26 06:00,481,0,98,579,0
연산터널→연산교차로,2023.9.26 06:00,251,229,42,522,0
교대→연산교차로,2023.9.26 07:00,254,0,412,666,0
부산시청→연산교차로,2023.9.26 07:00,603,360,255,1218,0
사직운동장→연산교차로,2023.9.26 07:00,177,522,55,754,0
신리→연산교차로,2023.9.26 07:00,475,304,30,809,0
안락→연산교차로,2023.9.26 07:00,658,0,83,741,0
연산터널→연산교차로,2023.9.26 07:00,270,380,41,691,0
교대→연산교차로,2023.9.26 08:00,316,0,494,810,0
부산시청→연산교차로,2023.9.26 08:00,589,433,335,1357,0
사직운동장→연산교차로,2023.9.26 08:00,199,676,40,915,0
신리→연산교차로,2023.9.26 08:00,527,343,27,897,0
안락→연산교차로,2023.9.26 08:00,616,0,99,715,0
연산터널→연산교차로,2023.9.26 08:00,335,386,36,757,0
교대→연산교차로,2023.9.26 09:00,290,0,564,854,0
부산시청→연산교차로,2023.9.26 09:00,550,401,304,1255,0
사직운동장→연산교차로,2023.9.26 09:00,198,620,71,889,0
신리→연산교차로,2023.9.26 09:00,477,336,26,839,0
안락→연산교차로,2023.9.26 09:00,594,0,104,698,0
연산터널→연산교차로,2023.9.26 09:00,283,385,43,711,0
교대→연산교차로,2023.9.26 10:00,310,0,468,778,0
부산시청→연산교차로,2023.9.26 10:00,610,385,301,1296,0
사직운동장→연산교차로,2023.9.26 10:00,204,585,50,839,0
신리→연산교차로,2023.9.26 10:00,526,291,44,861,0
안락→연산교차로,2023.9.26 10:00,579,0,117,696,0
연산터널→연산교차로,2023.9.26 10:00,302,363,46,711,0
교대→연산교차로,2023.9.26 11:00,315,0,507,822,0
부산시청→연산교차로,2023.9.26 11:00,604,407,261,1272,0
사직운동장→연산교차로,2023.9.26 11:00,206,604,54,864,0
신리→연산교차로,2023.9.26 11:00,446,289,55,790,0
안락→연산교차로,2023.9.26 11:00,552,0,160,712,0
연산터널→연산교차로,2023.9.26 11:00,267,301,61,629,0
교대→연산교차로,2023.9.26 12:00,292,0,432,724,0
부산시청→연산교차로,2023.9.26 12:00,587,407,284,1278,0
사직운동장→연산교차로,2023.9.26 12:00,179,580,68,827,0
신리→연산교차로,2023.9.26 12:00,431,251,72,754,0
안락→연산교차로,2023.9.26 12:00,497,0,154,651,0
연산터널→연산교차로,2023.9.26 12:00,290,309,60,659,0
교대→연산교차로,2023.9.26 13:00,335,0,469,804,0
부산시청→연산교차로,2023.9.26 13:00,589,466,282,1337,0
사직운동장→연산교차로,2023.9.26 13:00,195,644,94,933,0
신리→연산교차로,2023.9.26 13:00,462,279,54,795,0
안락→연산교차로,2023.9.26 13:00,448,0,140,588,0
연산터널→연산교차로,2023.9.26 13:00,256,270,31,557,0
교대→연산교차로,2023.9.26 14:00,352,0,514,866,0
부산시청→연산교차로,2023.9.26 14:00,588,492,292,1372,0
사직운동장→연산교차로,2023.9.26 14:00,234,664,69,967,0
신리→연산교차로,2023.9.26 14:00,486,276,61,823,0
안락→연산교차로,2023.9.26 14:00,434,0,151,585,0
연산터널→연산교차로,2023.9.26 14:00,245,273,45,563,0
교대→연산교차로,2023.9.26 15:00,342,0,518,860,0
부산시청→연산교차로,2023.9.26 15:00,586,516,303,1405,0
사직운동장→연산교차로,2023.9.26 15:00,222,657,77,956,0
신리→연산교차로,2023.9.26 15:00,481,256,60,797,0
안락→연산교차로,2023.9.26 15:00,441,0,108,549,0
연산터널→연산교차로,2023.9.26 15:00,231,289,43,563,0
교대→연산교차로,2023.9.26 16:00,351,0,556,907,0
부산시청→연산교차로,2023.9.26 16:00,604,487,305,1396,0
사직운동장→연산교차로,2023.9.26 16:00,231,649,42,922,0
신리→연산교차로,2023.9.26 16:00,508,280,59,847,0
안락→연산교차로,2023.9.26 16:00,418,0,92,510,0
연산터널→연산교차로,2023.9.26 16:00,237,259,40,536,0
교대→연산교차로,2023.9.26 17:00,371,0,534,905,0
부산시청→연산교차로,2023.9.26 17:00,595,554,333,1482,0
사직운동장→연산교차로,2023.9.26 17:00,235,682,35,952,0
신리→연산교차로,2023.9.26 17:00,551,280,49,880,0
안락→연산교차로,2023.9.26 17:00,446,0,112,558,0
연산터널→연산교차로,2023.9.26 17:00,254,275,39,568,0
교대→연산교차로,2023.9.26 18:00,351,0,591,942,0
부산시청→연산교차로,2023.9.26 18:00,609,578,325,1512,0
사직운동장→연산교차로,2023.9.26 18:00,224,678,49,951,0
신리→연산교차로,2023.9.26 18:00,496,260,49,805,0
안락→연산교차로,2023.9.26 18:00,434,0,94,528,0
연산터널→연산교차로,2023.9.26 18:00,225,283,40,548,0
교대→연산교차로,2023.9.26 19:00,349,0,452,801,0
부산시청→연산교차로,2023.9.26 19:00,599,484,305,1388,0
사직운동장→연산교차로,2023.9.26 19:00,209,630,57,896,0
신리→연산교차로,2023.9.26 19:00,392,248,38,678,0
안락→연산교차로,2023.9.26 19:00,431,0,97,528,0
연산터널→연산교차로,2023.9.26 19:00,209,292,51,552,0
교대→연산교차로,2023.9.26 20:00,343,0,386,729,0
부산시청→연산교차로,2023.9.26 20:00,535,434,273,1242,0
사직운동장→연산교차로,2023.9.26 20:00,203,554,79,836,0
신리→연산교차로,2023.9.26 20:00,335,207,32,574,0
안락→연산교차로,2023.9.26 20:00,427,0,85,512,0
연산터널→연산교차로,2023.9.26 20:00,226,247,62,535,0
교대→연산교차로,2023.9.26 21:00,299,0,377,676,0
부산시청→연산교차로,2023.9.26 21:00,521,334,212,1067,0
사직운동장→연산교차로,2023.9.26 21:00,156,475,85,716,0
신리→연산교차로,2023.9.26 21:00,312,197,29,538,0
안락→연산교차로,2023.9.26 21:00,453,0,131,584,0
연산터널→연산교차로,2023.9.26 21:00,248,301,48,597,0
교대→연산교차로,2023.9.26 22:00,271,0,281,552,0
부산시청→연산교차로,2023.9.26 22:00,419,297,184,900,0
사직운동장→연산교차로,2023.9.26 22:00,153,371,73,597,0
신리→연산교차로,2023.9.26 22:00,290,169,24,483,0
안락→연산교차로,2023.9.26 22:00,401,0,87,488,0
연산터널→연산교차로,2023.9.26 22:00,218,272,57,547,0
교대→연산교차로,2023.9.26 23:00,193,0,212,405,0
부산시청→연산교차로,2023.9.26 23:00,352,227,141,720,0
사직운동장→연산교차로,2023.9.26 23:00,120,297,67,484,0
신리→연산교차로,2023.9.26 23:00,217,116,20,353,0
안락→연산교차로,2023.9.26 23:00,269,0,93,362,0
연산터널→연산교차로,2023.9.26 23:00,151,202,65,418,0
교대→연산교차로,2023.9.27 00:00,144,0,174,318,0
부산시청→연산교차로,2023.9.27 00:00,271,165,100,536,0
사직운동장→연산교차로,2023.9.27 00:00,97,229,46,372,0
신리→연산교차로,2023.9.27 00:00,175,95,12,282,0
안락→연산교차로,2023.9.27 00:00,232,0,60,292,0
연산터널→연산교차로,2023.9.27 00:00,150,178,59,387,0
교대→연산교차로,2023.9.27 01:00,108,0,171,279,0
부산시청→연산교차로,2023.9.27 01:00,178,123,89,390,0
사직운동장→연산교차로,2023.9.27 01:00,55,201,47,303,0
신리→연산교차로,2023.9.27 01:00,103,76,10,189,0
안락→연산교차로,2023.9.27 01:00,180,0,44,224,0
연산터널→연산교차로,2023.9.27 01:00,119,136,39,294,0
교대→연산교차로,2023.9.27 02:00,71,0,124,195,0
부산시청→연산교차로,2023.9.27 02:00,165,75,71,311,0
사직운동장→연산교차로,2023.9.27 02:00,57,137,48,242,0
신리→연산교차로,2023.9.27 02:00,85,54,16,155,0
안락→연산교차로,2023.9.27 02:00,118,0,26,144,0
연산터널→연산교차로,2023.9.27 02:00,89,129,26,244,0
교대→연산교차로,2023.9.27 03:00,75,0,118,193,0
부산시청→연산교차로,2023.9.27 03:00,167,79,51,297,0
사직운동장→연산교차로,2023.9.27 03:00,39,130,27,196,0
신리→연산교차로,2023.9.27 03:00,77,47,12,136,0
안락→연산교차로,2023.9.27 03:00,113,0,24,137,0
연산터널→연산교차로,2023.9.27 03:00,81,100,49,230,0
교대→연산교차로,2023.9.27 04:00,46,0,76,122,0
부산시청→연산교차로,2023.9.27 04:00,163,86,48,297,0
사직운동장→연산교차로,2023.9.27 04:00,32,118,26,176,0
신리→연산교차로,2023.9.27 04:00,88,48,15,151,0
안락→연산교차로,2023.9.27 04:00,167,0,30,197,0
연산터널→연산교차로,2023.9.27 04:00,83,93,38,214,0
교대→연산교차로,2023.9.27 05:00,79,0,134,213,0
부산시청→연산교차로,2023.9.27 05:00,233,146,74,453,0
사직운동장→연산교차로,2023.9.27 05:00,47,186,14,247,0
신리→연산교차로,2023.9.27 05:00,209,93,12,314,0
안락→연산교차로,2023.9.27 05:00,309,0,53,362,0
연산터널→연산교차로,2023.9.27 05:00,143,140,23,306,0
교대→연산교차로,2023.9.27 06:00,168,0,214,382,0
부산시청→연산교차로,2023.9.27 06:00,384,255,119,758,0
사직운동장→연산교차로,2023.9.27 06:00,99,284,41,424,0
신리→연산교차로,2023.9.27 06:00,345,191,24,560,0
안락→연산교차로,2023.9.27 06:00,486,0,103,589,0
연산터널→연산교차로,2023.9.27 06:00,237,232,44,513,0
교대→연산교차로,2023.9.27 07:00,273,0,353,626,0
부산시청→연산교차로,2023.9.27 07:00,570,391,235,1196,0
사직운동장→연산교차로,2023.9.27 07:00,189,523,63,775,0
신리→연산교차로,2023.9.27 07:00,466,299,26,791,0
안락→연산교차로,2023.9.27 07:00,623,0,85,708,0
연산터널→연산교차로,2023.9.27 07:00,294,361,45,700,0
교대→연산교차로,2023.9.27 08:00,312,0,484,796,0
부산시청→연산교차로,2023.9.27 08:00,620,435,314,1369,0
사직운동장→연산교차로,2023.9.27 08:00,209,649,66,924,0
신리→연산교차로,2023.9.27 08:00,534,333,31,898,0
안락→연산교차로,2023.9.27 08:00,597,0,108,705,0
연산터널→연산교차로,2023.9.27 08:00,311,391,26,728,0
교대→연산교차로,2023.9.27 09:00,297,0,539,836,0
부산시청→연산교차로,2023.9.27 09:00,621,399,300,1320,0
사직운동장→연산교차로,2023.9.27 09:00,186,622,72,880,0
신리→연산교차로,2023.9.27 09:00,492,332,50,874,0
안락→연산교차로,2023.9.27 09:00,589,0,126,715,0
연산터널→연산교차로,2023.9.27 09:00,291,380,43,714,0
교대→연산교차로,2023.9.27 10:00,305,0,486,791,0
부산시청→연산교차로,2023.9.27 10:00,607,378,309,1294,0
사직운동장→연산교차로,2023.9.27 10:00,226,595,43,864,0
신리→연산교차로,2023.9.27 10:00,479,287,55,821,0
안락→연산교차로,2023.9.27 10:00,560,0,115,675,0
연산터널→연산교차로,2023.9.27 10:00,306,384,53,743,0
교대→연산교차로,2023.9.27 11:00,307,0,446,753,0
부산시청→연산교차로,2023.9.27 11:00,596,399,275,1270,0
사직운동장→연산교차로,2023.9.27 11:00,213,572,76,861,0
신리→연산교차로,2023.9.27 11:00,520,274,63,857,0
안락→연산교차로,2023.9.27 11:00,536,0,140,676,0
연산터널→연산교차로,2023.9.27 11:00,297,346,47,690,0
교대→연산교차로,2023.9.27 12:00,307,0,526,833,0
부산시청→연산교차로,2023.9.27 12:00,598,383,311,1292,0
사직운동장→연산교차로,2023.9.27 12:00,210,630,59,899,0
신리→연산교차로,2023.9.27 12:00,512,310,56,878,0
안락→연산교차로,2023.9.27 12:00,514,0,151,665,0
연산터널→연산교차로,2023.9.27 12:00,323,300,55,678,0
교대→연산교차로,2023.9.27 13:00,350,0,453,803,0
부산시청→연산교차로,2023.9.27 13:00,629,539,345,1513,0
사직운동장→연산교차로,2023.9.27 13:00,233,690,66,989,0
신리→연산교차로,2023.9.27 13:00,499,276,73,848,0
안락→연산교차로,2023.9.27 13:00,448,0,136,584,0
연산터널→연산교차로,2023.9.27 13:00,246,269,40,555,0
교대→연산교차로,2023.9.27 14:00,377,0,549,926,0
부산시청→연산교차로,2023.9.27 14:00,658,532,344,1534,0
사직운동장→연산교차로,2023.9.27 14:00,235,678,57,970,0
신리→연산교차로,2023.9.27 14:00,518,288,52,858,0
안락→연산교차로,2023.9.27 14:00,428,0,119,547,0
연산터널→연산교차로,2023.9.27 14:00,236,296,50,582,0
교대→연산교차로,2023.9.27 15:00,372,0,536,908,0
부산시청→연산교차로,2023.9.27 15:00,632,519,364,1515,0
사직운동장→연산교차로,2023.9.27 15:00,235,671,56,962,0
신리→연산교차로,2023.9.27 15:00,536,293,62,891,0
안락→연산교차로,2023.9.27 15:00,461,0,129,590,0
연산터널→연산교차로,2023.9.27 15:00,258,298,43,599,0
교대→연산교차로,2023.9.27 16:00,387,0,522,909,0
부산시청→연산교차로,2023.9.27 16:00,641,549,353,1543,0
사직운동장→연산교차로,2023.9.27 16:00,252,698,37,987,0
신리→연산교차로,2023.9.27 16:00,529,295,67,891,0
안락→연산교차로,2023.9.27 16:00,437,0,110,547,0
연산터널→연산교차로,2023.9.27 16:00,244,294,42,580,0
교대→연산교차로,2023.9.27 17:00,372,0,515,887,0
부산시청→연산교차로,2023.9.27 17:00,619,563,313,1495,0
사직운동장→연산교차로,2023.9.27 17:00,250,699,43,992,0
신리→연산교차로,2023.9.27 17:00,522,285,50,857,0
안락→연산교차로,2023.9.27 17:00,455,0,105,560,0
연산터널→연산교차로,2023.9.27 17:00,232,307,47,586,0
교대→연산교차로,2023.9.27 18:00,365,0,514,879,0
부산시청→연산교차로,2023.9.27 18:00,568,547,357,1472,0
사직운동장→연산교차로,2023.9.27 18:00,265,639,52,956,0
신리→연산교차로,2023.9.27 18:00,509,262,52,823,0
안락→연산교차로,2023.9.27 18:00,431,0,122,553,0
연산터널→연산교차로,2023.9.27 18:00,193,298,40,531,0
교대→연산교차로,2023.9.27 19:00,353,0,447,800,0
부산시청→연산교차로,2023.9.27 19:00,516,452,342,1310,0
사직운동장→연산교차로,2023.9.27 19:00,214,616,73,903,0
신리→연산교차로,2023.9.27 19:00,404,259,40,703,0
안락→연산교차로,2023.9.27 19:00,443,0,96,539,0
연산터널→연산교차로,2023.9.27 19:00,223,277,51,551,0
교대→연산교차로,2023.9.27 20:00,329,0,392,721,0
부산시청→연산교차로,2023.9.27 20:00,546,364,213,1123,0
사직운동장→연산교차로,2023.9.27 20:00,201,551,85,837,0
신리→연산교차로,2023.9.27 20:00,376,215,35,626,0
안락→연산교차로,2023.9.27 20:00,426,0,106,532,0
연산터널→연산교차로,2023.9.27 20:00,223,290,33,546,0
교대→연산교차로,2023.9.27 21:00,310,0,406,716,0
부산시청→연산교차로,2023.9.27 21:00,517,354,242,1113,0
사직운동장→연산교차로,2023.9.27 21:00,185,472,86,743,0
신리→연산교차로,2023.9.27 21:00,329,187,37,553,0
안락→연산교차로,2023.9.27 21:00,483,0,129,612,0
연산터널→연산교차로,2023.9.27 21:00,265,284,72,621,0
교대→연산교차로,2023.9.27 22:00,286,0,305,591,0
부산시청→연산교차로,2023.9.27 22:00,485,336,141,962,0
사직운동장→연산교차로,2023.9.27 22:00,169,394,73,636,0
신리→연산교차로,2023.9.27 22:00,285,196,22,503,0
안락→연산교차로,2023.9.27 22:00,431,0,112,543,0
연산터널→연산교차로,2023.9.27 22:00,216,253,59,528,0
교대→연산교차로,2023.9.27 23:00,238,0,238,476,0
부산시청→연산교차로,2023.9.27 23:00,386,253,162,801,0
사직운동장→연산교차로,2023.9.27 23:00,135,325,41,501,0
신리→연산교차로,2023.9.27 23:00,255,129,31,415,0
안락→연산교차로,2023.9.27 23:00,313,0,104,417,0
연산터널→연산교차로,2023.9.27 23:00,173,217,52,442,0
교대→연산교차로,2023.9.28 00:00,218,0,206,424,1
부산시청→연산교차로,2023.9.28 00:00,358,228,121,707,1
사직운동장→연산교차로,2023.9.28 00:00,78,243,28,349,1
신리→연산교차로,2023.9.28 00:00,221,130,17,368,1
안락→연산교차로,2023.9.28 00:00,284,0,87,371,1
연산터널→연산교차로,2023.9.28 00:00,137,192,28,357,1
교대→연산교차로,2023.9.28 01:00,178,0,192,370,1
부산시청→연산교차로,2023.9.28 01:00,269,173,95,537,1
사직운동장→연산교차로,2023.9.28 01:00,68,202,22,292,1
신리→연산교차로,2023.9.28 01:00,181,112,20,313,1
안락→연산교차로,2023.9.28 01:00,223,0,71,294,1
연산터널→연산교차로,2023.9.28 01:00,138,170,28,336,1
교대→연산교차로,2023.9.28 02:00,149,0,198,347,1
부산시청→연산교차로,2023.9.28 02:00,259,137,98,494,1
사직운동장→연산교차로,2023.9.28 02:00,67,162,24,253,1
신리→연산교차로,2023.9.28 02:00,155,88,7,250,1
안락→연산교차로,2023.9.28 02:00,224,0,62,286,1
연산터널→연산교차로,2023.9.28 02:00,115,159,38,312,1
교대→연산교차로,2023.9.28 03:00,112,0,172,284,1
부산시청→연산교차로,2023.9.28 03:00,229,111,83,423,1
사직운동장→연산교차로,2023.9.28 03:00,55,191,7,253,1
신리→연산교차로,2023.9.28 03:00,111,64,10,185,1
안락→연산교차로,2023.9.28 03:00,190,0,43,233,1
연산터널→연산교차로,2023.9.28 03:00,116,151,35,302,1
교대→연산교차로,2023.9.28 04:00,93,0,96,189,1
부산시청→연산교차로,2023.9.28 04:00,210,103,72,385,1
사직운동장→연산교차로,2023.9.28 04:00,30,143,5,178,1
신리→연산교차로,2023.9.28 04:00,98,67,6,171,1
안락→연산교차로,2023.9.28 04:00,171,0,42,213,1
연산터널→연산교차로,2023.9.28 04:00,98,132,34,264,1
교대→연산교차로,2023.9.28 05:00,84,0,98,182,1
부산시청→연산교차로,2023.9.28 05:00,185,112,70,367,1
사직운동장→연산교차로,2023.9.28 05:00,64,106,6,176,1
신리→연산교차로,2023.9.28 05:00,129,47,10,186,1
안락→연산교차로,2023.9.28 05:00,203,0,35,238,1
연산터널→연산교차로,2023.9.28 05:00,99,127,27,253,1
교대→연산교차로,2023.9.28 06:00,93,0,102,195,1
부산시청→연산교차로,2023.9.28 06:00,276,169,77,522,1
사직운동장→연산교차로,2023.9.28 06:00,56,191,40,287,1
신리→연산교차로,2023.9.28 06:00,205,89,20,314,1
안락→연산교차로,2023.9.28 06:00,241,0,64,305,1
연산터널→연산교차로,2023.9.28 06:00,128,134,34,296,1
교대→연산교차로,2023.9.28 07:00,143,0,149,292,1
부산시청→연산교차로,2023.9.28 07:00,281,158,101,540,1
사직운동장→연산교차로,2023.9.28 07:00,72,242,34,348,1
신리→연산교차로,2023.9.28 07:00,239,108,8,355,1
안락→연산교차로,2023.9.28 07:00,274,0,55,329,1
연산터널→연산교차로,2023.9.28 07:00,165,147,26,338,1
교대→연산교차로,2023.9.28 08:00,190,0,180,370,1
부산시청→연산교차로,2023.9.28 08:00,375,238,154,767,1
사직운동장→연산교차로,2023.9.28 08:00,115,347,44,506,1
신리→연산교차로,2023.9.28 08:00,354,149,0,503,1
안락→연산교차로,2023.9.28 08:00,353,0,80,433,1
연산터널→연산교차로,2023.9.28 08:00,186,178,27,391,1
교대→연산교차로,2023.9.28 09:00,250,0,204,454,1
부산시청→연산교차로,2023.9.28 09:00,490,310,215,1015,1
사직운동장→연산교차로,2023.9.28 09:00,156,479,46,681,1
신리→연산교차로,2023.9.28 09:00,502,191,0,693,1
안락→연산교차로,2023.9.28 09:00,470,0,99,569,1
연산터널→연산교차로,2023.9.28 09:00,235,256,57,548,1
교대→연산교차로,2023.9.28 10:00,313,0,284,597,1
부산시청→연산교차로,2023.9.28 10:00,593,365,245,1203,1
사직운동장→연산교차로,2023.9.28 10:00,212,619,29,860,1
신리→연산교차로,2023.9.28 10:00,466,244,31,741,1
안락→연산교차로,2023.9.28 10:00,536,0,141,677,1
연산터널→연산교차로,2023.9.28 10:00,242,292,47,581,1
교대→연산교차로,2023.9.28 11:00,295,0,329,624,1
부산시청→연산교차로,2023.9.28 11:00,620,383,273,1276,1
사직운동장→연산교차로,2023.9.28 11:00,216,628,33,877,1
신리→연산교차로,2023.9.28 11:00,500,267,46,813,1
안락→연산교차로,2023.9.28 11:00,553,0,157,710,1
연산터널→연산교차로,2023.9.28 11:00,299,293,45,637,1
교대→연산교차로,2023.9.28 12:00,309,0,312,621,1
부산시청→연산교차로,2023.9.28 12:00,666,387,256,1309,1
사직운동장→연산교차로,2023.9.28 12:00,229,562,55,846,1
신리→연산교차로,2023.9.28 12:00,451,243,42,736,1
안락→연산교차로,2023.9.28 12:00,559,0,164,723,1
연산터널→연산교차로,2023.9.28 12:00,291,300,39,630,1
교대→연산교차로,2023.9.28 13:00,309,0,307,616,1
부산시청→연산교차로,2023.9.28 13:00,606,379,245,1230,1
사직운동장→연산교차로,2023.9.28 13:00,232,562,42,836,1
신리→연산교차로,2023.9.28 13:00,438,250,33,721,1
안락→연산교차로,2023.9.28 13:00,549,0,151,700,1
연산터널→연산교차로,2023.9.28 13:00,260,306,42,608,1
교대→연산교차로,2023.9.28 14:00,320,0,298,618,1
부산시청→연산교차로,2023.9.28 14:00,590,350,227,1167,1
사직운동장→연산교차로,2023.9.28 14:00,212,548,38,798,1
신리→연산교차로,2023.9.28 14:00,407,239,30,676,1
안락→연산교차로,2023.9.28 14:00,566,0,125,691,1
연산터널→연산교차로,2023.9.28 14:00,232,298,77,607,1
교대→연산교차로,2023.9.28 15:00,316,0,273,589,1
부산시청→연산교차로,2023.9.28 15:00,605,370,241,1216,1
사직운동장→연산교차로,2023.9.28 15:00,218,591,47,856,1
신리→연산교차로,2023.9.28 15:00,424,274,48,746,1
안락→연산교차로,2023.9.28 15:00,570,0,176,746,1
연산터널→연산교차로,2023.9.28 15:00,279,337,60,676,1
교대→연산교차로,2023.9.28 16:00,304,0,320,624,1
부산시청→연산교차로,2023.9.28 16:00,569,339,245,1153,1
사직운동장→연산교차로,2023.9.28 16:00,220,542,55,817,1
신리→연산교차로,2023.9.28 16:00,383,267,47,697,1
안락→연산교차로,2023.9.28 16:00,576,0,168,744,1
연산터널→연산교차로,2023.9.28 16:00,283,314,55,652,1
교대→연산교차로,2023.9.28 17:00,299,0,295,594,1
부산시청→연산교차로,2023.9.28 17:00,565,332,263,1160,1
사직운동장→연산교차로,2023.9.28 17:00,218,536,46,800,1
신리→연산교차로,2023.9.28 17:00,416,243,29,688,1
안락→연산교차로,2023.9.28 17:00,593,0,134,727,1
연산터널→연산교차로,2023.9.28 17:00,251,290,53,594,1
교대→연산교차로,2023.9.28 18:00,298,0,284,582,1
부산시청→연산교차로,2023.9.28 18:00,547,337,215,1099,1
사직운동장→연산교차로,2023.9.28 18:00,196,510,60,766,1
신리→연산교차로,2023.9.28 18:00,384,227,26,637,1
안락→연산교차로,2023.9.28 18:00,506,0,141,647,1
연산터널→연산교차로,2023.9.28 18:00,216,273,49,538,1
교대→연산교차로,2023.9.28 19:00,280,0,273,553,1
부산시청→연산교차로,2023.9.28 19:00,447,307,202,956,1
사직운동장→연산교차로,2023.9.28 19:00,182,487,56,725,1
신리→연산교차로,2023.9.28 19:00,363,208,32,603,1
안락→연산교차로,2023.9.28 19:00,440,0,116,556,1
연산터널→연산교차로,2023.9.28 19:00,226,303,62,591,1
교대→연산교차로,2023.9.28 20:00,270,0,281,551,1
부산시청→연산교차로,2023.9.28 20:00,442,282,194,918,1
사직운동장→연산교차로,2023.9.28 20:00,218,518,60,796,1
신리→연산교차로,2023.9.28 20:00,344,186,23,553,1
안락→연산교차로,2023.9.28 20:00,460,0,122,582,1
연산터널→연산교차로,2023.9.28 20:00,206,255,46,507,1
교대→연산교차로,2023.9.28 21:00,295,0,234,529,1
부산시청→연산교차로,2023.9.28 21:00,429,268,151,848,1
사직운동장→연산교차로,2023.9.28 21:00,152,375,51,578,1
신리→연산교차로,2023.9.28 21:00,379,183,26,588,1
안락→연산교차로,2023.9.28 21:00,360,0,117,477,1
연산터널→연산교차로,2023.9.28 21:00,186,239,56,481,1
교대→연산교차로,2023.9.28 22:00,227,0,174,401,1
부산시청→연산교차로,2023.9.28 22:00,392,220,113,725,1
사직운동장→연산교차로,2023.9.28 22:00,132,296,50,478,1
신리→연산교차로,2023.9.28 22:00,272,137,23,432,1
안락→연산교차로,2023.9.28 22:00,332,0,86,418,1
연산터널→연산교차로,2023.9.28 22:00,163,194,51,408,1
교대→연산교차로,2023.9.28 23:00,153,0,192,345,1
부산시청→연산교차로,2023.9.28 23:00,306,195,116,617,1
사직운동장→연산교차로,2023.9.28 23:00,72,248,53,373,1
신리→연산교차로,2023.9.28 23:00,202,123,16,341,1
안락→연산교차로,2023.9.28 23:00,286,0,79,365,1
연산터널→연산교차로,2023.9.28 23:00,147,196,53,396,1
교대→연산교차로,2023.9.29 00:00,125,0,181,306,1
부산시청→연산교차로,2023.9.29 00:00,229,183,111,523,1
사직운동장→연산교차로,2023.9.29 00:00,61,195,19,275,1
신리→연산교차로,2023.9.29 00:00,197,85,14,296,1
안락→연산교차로,2023.9.29 00:00,208,0,45,253,1
연산터널→연산교차로,2023.9.29 00:00,130,173,50,353,1
교대→연산교차로,2023.9.29 01:00,104,0,150,254,1
부산시청→연산교차로,2023.9.29 01:00,224,147,79,450,1
사직운동장→연산교차로,2023.9.29 01:00,60,151,11,222,1
신리→연산교차로,2023.9.29 01:00,132,63,9,204,1
안락→연산교차로,2023.9.29 01:00,186,0,39,225,1
연산터널→연산교차로,2023.9.29 01:00,105,134,37,276,1
교대→연산교차로,2023.9.29 02:00,98,0,121,219,1
부산시청→연산교차로,2023.9.29 02:00,179,80,54,313,1
사직운동장→연산교차로,2023.9.29 02:00,32,99,13,144,1
신리→연산교차로,2023.9.29 02:00,96,44,16,156,1
안락→연산교차로,2023.9.29 02:00,117,0,45,162,1
연산터널→연산교차로,2023.9.29 02:00,103,107,27,237,1
교대→연산교차로,2023.9.29 03:00,64,0,102,166,1
부산시청→연산교차로,2023.9.29 03:00,162,76,61,299,1
사직운동장→연산교차로,2023.9.29 03:00,38,125,3,166,1
신리→연산교차로,2023.9.29 03:00,77,38,11,126,1
안락→연산교차로,2023.9.29 03:00,124,0,36,160,1
연산터널→연산교차로,2023.9.29 03:00,81,94,52,227,1
교대→연산교차로,2023.9.29 04:00,49,0,74,123,1
부산시청→연산교차로,2023.9.29 04:00,113,60,46,219,1
사직운동장→연산교차로,2023.9.29 04:00,33,76,4,113,1
신리→연산교차로,2023.9.29 04:00,81,37,6,124,1
안락→연산교차로,2023.9.29 04:00,105,0,25,130,1
연산터널→연산교차로,2023.9.29 04:00,55,86,36,177,1
교대→연산교차로,2023.9.29 05:00,57,0,52,109,1
부산시청→연산교차로,2023.9.29 05:00,122,75,48,245,1
사직운동장→연산교차로,2023.9.29 05:00,36,95,5,136,1
신리→연산교차로,2023.9.29 05:00,102,35,11,148,1
안락→연산교차로,2023.9.29 05:00,92,0,33,125,1
연산터널→연산교차로,2023.9.29 05:00,62,79,17,158,1
교대→연산교차로,2023.9.29 06:00,107,0,89,196,1
부산시청→연산교차로,2023.9.29 06:00,202,146,66,414,1
사직운동장→연산교차로,2023.9.29 06:00,61,169,20,250,1
신리→연산교차로,2023.9.29 06:00,174,73,16,263,1
안락→연산교차로,2023.9.29 06:00,163,0,40,203,1
연산터널→연산교차로,2023.9.29 06:00,116,102,28,246,1
교대→연산교차로,2023.9.29 07:00,245,0,131,376,1
부산시청→연산교차로,2023.9.29 07:00,358,232,152,742,1
사직운동장→연산교차로,2023.9.29 07:00,126,337,24,487,1
신리→연산교차로,2023.9.29 07:00,355,134,13,502,1
안락→연산교차로,2023.9.29 07:00,332,0,76,408,1
연산터널→연산교차로,2023.9.29 07:00,168,160,7,335,1
교대→연산교차로,2023.9.29 08:00,308,0,190,498,1
부산시청→연산교차로,2023.9.29 08:00,522,328,177,1027,1
사직운동장→연산교차로,2023.9.29 08:00,141,423,17,581,1
신리→연산교차로,2023.9.29 08:00,415,169,27,611,1
안락→연산교차로,2023.9.29 08:00,450,0,122,572,1
연산터널→연산교차로,2023.9.29 08:00,221,214,19,454,1
교대→연산교차로,2023.9.29 09:00,248,0,158,406,1
부산시청→연산교차로,2023.9.29 09:00,487,288,191,966,1
사직운동장→연산교차로,2023.9.29 09:00,151,412,24,587,1
신리→연산교차로,2023.9.29 09:00,416,166,34,616,1
안락→연산교차로,2023.9.29 09:00,399,0,92,491,1
연산터널→연산교차로,2023.9.29 09:00,220,251,33,504,1
교대→연산교차로,2023.9.29 10:00,286,0,198,484,1
부산시청→연산교차로,2023.9.29 10:00,536,344,205,1085,1
사직운동장→연산교차로,2023.9.29 10:00,189,510,26,725,1
신리→연산교차로,2023.9.29 10:00,521,226,32,779,1
안락→연산교차로,2023.9.29 10:00,539,0,106,645,1
연산터널→연산교차로,2023.9.29 10:00,281,271,42,594,1
교대→연산교차로,2023.9.29 11:00,304,0,243,547,1
부산시청→연산교차로,2023.9.29 11:00,630,359,266,1255,1
사직운동장→연산교차로,2023.9.29 11:00,221,596,33,850,1
신리→연산교차로,2023.9.29 11:00,416,285,51,752,1
안락→연산교차로,2023.9.29 11:00,594,0,147,741,1
연산터널→연산교차로,2023.9.29 11:00,293,319,42,654,1
교대→연산교차로,2023.9.29 12:00,297,0,246,543,1
부산시청→연산교차로,2023.9.29 12:00,650,335,300,1285,1
사직운동장→연산교차로,2023.9.29 12:00,240,573,34,847,1
신리→연산교차로,2023.9.29 12:00,418,312,41,771,1
안락→연산교차로,2023.9.29 12:00,594,0,153,747,1
연산터널→연산교차로,2023.9.29 12:00,315,337,42,694,1
교대→연산교차로,2023.9.29 13:00,279,0,275,554,1
부산시청→연산교차로,2023.9.29 13:00,680,379,268,1327,1
사직운동장→연산교차로,2023.9.29 13:00,237,576,32,845,1
신리→연산교차로,2023.9.29 13:00,422,312,46,780,1
안락→연산교차로,2023.9.29 13:00,609,0,136,745,1
연산터널→연산교차로,2023.9.29 13:00,299,327,40,666,1
교대→연산교차로,2023.9.29 14:00,332,0,272,604,1
부산시청→연산교차로,2023.9.29 14:00,648,367,254,1269,1
사직운동장→연산교차로,2023.9.29 14:00,221,600,29,850,1
신리→연산교차로,2023.9.29 14:00,443,256,33,732,1
안락→연산교차로,2023.9.29 14:00,595,0,128,723,1
연산터널→연산교차로,2023.9.29 14:00,292,298,41,631,1
교대→연산교차로,2023.9.29 15:00,305,0,291,596,1
부산시청→연산교차로,2023.9.29 15:00,630,368,246,1244,1
사직운동장→연산교차로,2023.9.29 15:00,229,587,32,848,1
신리→연산교차로,2023.9.29 15:00,443,248,31,722,1
안락→연산교차로,2023.9.29 15:00,600,0,130,730,1
연산터널→연산교차로,2023.9.29 15:00,276,291,36,603,1
교대→연산교차로,2023.9.29 16:00,305,0,336,641,1
부산시청→연산교차로,2023.9.29 16:00,587,359,259,1205,1
사직운동장→연산교차로,2023.9.29 16:00,230,592,35,857,1
신리→연산교차로,2023.9.29 16:00,453,221,23,697,1
안락→연산교차로,2023.9.29 16:00,619,0,113,732,1
연산터널→연산교차로,2023.9.29 16:00,284,302,53,639,1
교대→연산교차로,2023.9.29 17:00,304,0,295,599,1
부산시청→연산교차로,2023.9.29 17:00,585,337,219,1141,1
사직운동장→연산교차로,2023.9.29 17:00,255,551,27,833,1
신리→연산교차로,2023.9.29 17:00,421,235,28,684,1
안락→연산교차로,2023.9.29 17:00,594,0,118,712,1
연산터널→연산교차로,2023.9.29 17:00,230,306,51,587,1
교대→연산교차로,2023.9.29 18:00,311,0,273,584,1
부산시청→연산교차로,2023.9.29 18:00,487,309,170,966,1
사직운동장→연산교차로,2023.9.29 18:00,226,470,50,746,1
신리→연산교차로,2023.9.29 18:00,359,177,20,556,1
안락→연산교차로,2023.9.29 18:00,562,0,110,672,1
연산터널→연산교차로,2023.9.29 18:00,200,251,52,503,1
교대→연산교차로,2023.9.29 19:00,285,0,268,553,1
부산시청→연산교차로,2023.9.29 19:00,415,287,151,853,1
사직운동장→연산교차로,2023.9.29 19:00,179,429,53,661,1
신리→연산교차로,2023.9.29 19:00,348,183,28,559,1
안락→연산교차로,2023.9.29 19:00,496,0,129,625,1
연산터널→연산교차로,2023.9.29 19:00,235,264,40,539,1
교대→연산교차로,2023.9.29 20:00,297,0,278,575,1
부산시청→연산교차로,2023.9.29 20:00,432,288,152,872,1
사직운동장→연산교차로,2023.9.29 20:00,188,394,54,636,1
신리→연산교차로,2023.9.29 20:00,385,194,30,609,1
안락→연산교차로,2023.9.29 20:00,430,0,115,545,1
연산터널→연산교차로,2023.9.29 20:00,220,234,50,504,1
교대→연산교차로,2023.9.29 21:00,254,0,225,479,1
부산시청→연산교차로,2023.9.29 21:00,384,255,163,802,1
사직운동장→연산교차로,2023.9.29 21:00,137,392,49,578,1
신리→연산교차로,2023.9.29 21:00,355,188,23,566,1
안락→연산교차로,2023.9.29 21:00,418,0,98,516,1
연산터널→연산교차로,2023.9.29 21:00,194,217,44,455,1
교대→연산교차로,2023.9.29 22:00,244,0,224,468,1
부산시청→연산교차로,2023.9.29 22:00,343,229,136,708,1
사직운동장→연산교차로,2023.9.29 22:00,124,334,51,509,1
신리→연산교차로,2023.9.29 22:00,274,159,30,463,1
안락→연산교차로,2023.9.29 22:00,366,0,78,444,1
연산터널→연산교차로,2023.9.29 22:00,163,191,42,396,1
교대→연산교차로,2023.9.29 23:00,175,0,190,365,1
부산시청→연산교차로,2023.9.29 23:00,288,167,96,551,1
사직운동장→연산교차로,2023.9.29 23:00,61,222,42,325,1
신리→연산교차로,2023.9.29 23:00,221,126,15,362,1
안락→연산교차로,2023.9.29 23:00,266,0,66,332,1
연산터널→연산교차로,2023.9.29 23:00,129,159,52,340,1
교대→연산교차로,2023.9.30 00:00,189,0,256,445,1
부산시청→연산교차로,2023.9.30 00:00,325,222,133,680,1
사직운동장→연산교차로,2023.9.30 00:00,90,279,63,432,1
신리→연산교차로,2023.9.30 00:00,240,126,26,392,1
안락→연산교차로,2023.9.30 00:00,280,0,82,362,1
연산터널→연산교차로,2023.9.30 00:00,205,222,64,491,1
교대→연산교차로,2023.9.30 01:00,142,0,237,379,1
부산시청→연산교차로,2023.9.30 01:00,257,182,103,542,1
사직운동장→연산교차로,2023.9.30 01:00,69,233,51,353,1
신리→연산교차로,2023.9.30 01:00,174,103,15,292,1
안락→연산교차로,2023.9.30 01:00,222,0,62,284,1
연산터널→연산교차로,2023.9.30 01:00,163,191,35,389,1
교대→연산교차로,2023.9.30 02:00,118,0,199,317,1
부산시청→연산교차로,2023.9.30 02:00,236,139,84,459,1
사직운동장→연산교차로,2023.9.30 02:00,61,186,43,290,1
신리→연산교차로,2023.9.30 02:00,147,82,17,246,1
안락→연산교차로,2023.9.30 02:00,196,0,57,253,1
연산터널→연산교차로,2023.9.30 02:00,120,167,35,322,1
교대→연산교차로,2023.9.30 03:00,80,0,168,248,1
부산시청→연산교차로,2023.9.30 03:00,218,102,82,402,1
사직운동장→연산교차로,2023.9.30 03:00,50,163,30,243,1
신리→연산교차로,2023.9.30 03:00,106,47,19,172,1
안락→연산교차로,2023.9.30 03:00,159,0,43,202,1
연산터널→연산교차로,2023.9.30 03:00,113,144,37,294,1
교대→연산교차로,2023.9.30 04:00,84,0,145,229,1
부산시청→연산교차로,2023.9.30 04:00,191,80,60,331,1
사직운동장→연산교차로,2023.9.30 04:00,49,149,16,214,1
신리→연산교차로,2023.9.30 04:00,108,71,10,189,1
안락→연산교차로,2023.9.30 04:00,214,0,45,259,1
연산터널→연산교차로,2023.9.30 04:00,90,137,31,258,1
교대→연산교차로,2023.9.30 05:00,98,0,132,230,1
부산시청→연산교차로,2023.9.30 05:00,279,165,86,530,1
사직운동장→연산교차로,2023.9.30 05:00,50,171,14,235,1
신리→연산교차로,2023.9.30 05:00,216,101,4,321,1
안락→연산교차로,2023.9.30 05:00,320,0,50,370,1
연산터널→연산교차로,2023.9.30 05:00,131,162,31,324,1
교대→연산교차로,2023.9.30 06:00,164,0,201,365,1
부산시청→연산교차로,2023.9.30 06:00,342,255,102,699,1
사직운동장→연산교차로,2023.9.30 06:00,74,251,64,389,1
신리→연산교차로,2023.9.30 06:00,318,169,16,503,1
안락→연산교차로,2023.9.30 06:00,410,0,101,511,1
연산터널→연산교차로,2023.9.30 06:00,216,181,40,437,1
교대→연산교차로,2023.9.30 07:00,194,0,219,413,1
부산시청→연산교차로,2023.9.30 07:00,406,289,135,830,1
사직운동장→연산교차로,2023.9.30 07:00,142,360,50,552,1
신리→연산교차로,2023.9.30 07:00,340,155,29,524,1
안락→연산교차로,2023.9.30 07:00,448,0,102,550,1
연산터널→연산교차로,2023.9.30 07:00,207,208,37,452,1
교대→연산교차로,2023.9.30 08:00,268,0,311,579,1
부산시청→연산교차로,2023.9.30 08:00,513,313,206,1032,1
사직운동장→연산교차로,2023.9.30 08:00,199,530,39,768,1
신리→연산교차로,2023.9.30 08:00,434,267,37,738,1
안락→연산교차로,2023.9.30 08:00,515,0,113,628,1
연산터널→연산교차로,2023.9.30 08:00,265,278,48,591,1
교대→연산교차로,2023.9.30 09:00,301,0,429,730,1
부산시청→연산교차로,2023.9.30 09:00,648,382,261,1291,1
사직운동장→연산교차로,2023.9.30 09:00,201,638,37,876,1
신리→연산교차로,2023.9.30 09:00,507,305,52,864,1
안락→연산교차로,2023.9.30 09:00,598,0,140,738,1
연산터널→연산교차로,2023.9.30 09:00,308,321,62,691,1
교대→연산교차로,2023.9.30 10:00,311,0,420,731,1
부산시청→연산교차로,2023.9.30 10:00,630,382,315,1327,1
사직운동장→연산교차로,2023.9.30 10:00,202,646,42,890,1
신리→연산교차로,2023.9.30 10:00,513,293,64,870,1
안락→연산교차로,2023.9.30 10:00,565,0,144,709,1
연산터널→연산교차로,2023.9.30 10:00,307,362,69,738,1
교대→연산교차로,2023.9.30 11:00,303,0,446,749,1
부산시청→연산교차로,2023.9.30 11:00,631,381,298,1310,1
사직운동장→연산교차로,2023.9.30 11:00,206,637,48,891,1
신리→연산교차로,2023.9.30 11:00,520,275,72,867,1
안락→연산교차로,2023.9.30 11:00,577,0,177,754,1
연산터널→연산교차로,2023.9.30 11:00,278,367,56,701,1
교대→연산교차로,2023.9.30 12:00,320,0,512,832,1
부산시청→연산교차로,2023.9.30 12:00,631,384,299,1314,1
사직운동장→연산교차로,2023.9.30 12:00,209,632,46,887,1
신리→연산교차로,2023.9.30 12:00,512,307,68,887,1
안락→연산교차로,2023.9.30 12:00,563,0,147,710,1
연산터널→연산교차로,2023.9.30 12:00,326,326,66,718,1
교대→연산교차로,2023.9.30 13:00,369,0,508,877,1
부산시청→연산교차로,2023.9.30 13:00,655,493,310,1458,1
사직운동장→연산교차로,2023.9.30 13:00,199,707,35,941,1
신리→연산교차로,2023.9.30 13:00,523,293,51,867,1
안락→연산교차로,2023.9.30 13:00,468,0,113,581,1
연산터널→연산교차로,2023.9.30 13:00,239,289,40,568,1
교대→연산교차로,2023.9.30 14:00,359,0,557,916,1
부산시청→연산교차로,2023.9.30 14:00,649,509,337,1495,1
사직운동장→연산교차로,2023.9.30 14:00,215,661,43,919,1
신리→연산교차로,2023.9.30 14:00,429,269,67,765,1
안락→연산교차로,2023.9.30 14:00,477,0,84,561,1
연산터널→연산교차로,2023.9.30 14:00,236,291,42,569,1
교대→연산교차로,2023.9.30 15:00,364,0,414,778,1
부산시청→연산교차로,2023.9.30 15:00,567,423,287,1277,1
사직운동장→연산교차로,2023.9.30 15:00,198,696,47,941,1
신리→연산교차로,2023.9.30 15:00,520,235,75,830,1
안락→연산교차로,2023.9.30 15:00,454,0,89,543,1
연산터널→연산교차로,2023.9.30 15:00,244,275,41,560,1
교대→연산교차로,2023.9.30 16:00,384,0,462,846,1
부산시청→연산교차로,2023.9.30 16:00,671,510,303,1484,1
사직운동장→연산교차로,2023.9.30 16:00,252,670,19,941,1
신리→연산교차로,2023.9.30 16:00,497,271,53,821,1
안락→연산교차로,2023.9.30 16:00,456,0,103,559,1
연산터널→연산교차로,2023.9.30 16:00,248,273,37,558,1
교대→연산교차로,2023.9.30 17:00,366,0,440,806,1
부산시청→연산교차로,2023.9.30 17:00,633,501,305,1439,1
사직운동장→연산교차로,2023.9.30 17:00,220,689,30,939,1
신리→연산교차로,2023.9.30 17:00,471,242,50,763,1
안락→연산교차로,2023.9.30 17:00,462,0,92,554,1
연산터널→연산교차로,2023.9.30 17:00,232,290,41,563,1
교대→연산교차로,2023.9.30 18:00,333,0,381,714,1
부산시청→연산교차로,2023.9.30 18:00,603,448,243,1294,1
사직운동장→연산교차로,2023.9.30 18:00,192,582,90,864,1
신리→연산교차로,2023.9.30 18:00,389,242,35,666,1
안락→연산교차로,2023.9.30 18:00,440,0,85,525,1
연산터널→연산교차로,2023.9.30 18:00,219,272,41,532,1
교대→연산교차로,2023.9.30 19:00,333,0,404,737,1
부산시청→연산교차로,2023.9.30 19:00,532,385,259,1176,1
사직운동장→연산교차로,2023.9.30 19:00,215,544,80,839,1
신리→연산교차로,2023.9.30 19:00,323,255,33,611,1
안락→연산교차로,2023.9.30 19:00,412,0,96,508,1
연산터널→연산교차로,2023.9.30 19:00,235,273,38,546,1
교대→연산교차로,2023.9.30 20:00,301,0,353,654,1
부산시청→연산교차로,2023.9.30 20:00,484,333,238,1055,1
사직운동장→연산교차로,2023.9.30 20:00,165,507,92,764,1
신리→연산교차로,2023.9.30 20:00,384,200,41,625,1
안락→연산교차로,2023.9.30 20:00,431,0,106,537,1
연산터널→연산교차로,2023.9.30 20:00,219,259,41,519,1
교대→연산교차로,2023.9.30 21:00,294,0,344,638,1
부산시청→연산교차로,2023.9.30 21:00,460,300,213,973,1
사직운동장→연산교차로,2023.9.30 21:00,164,414,62,640,1
신리→연산교차로,2023.9.30 21:00,352,224,41,617,1
안락→연산교차로,2023.9.30 21:00,425,0,102,527,1
연산터널→연산교차로,2023.9.30 21:00,222,262,75,559,1
교대→연산교차로,2023.9.30 22:00,261,0,280,541,1
부산시청→연산교차로,2023.9.30 22:00,424,246,141,811,1
사직운동장→연산교차로,2023.9.30 22:00,129,366,81,576,1
신리→연산교차로,2023.9.30 22:00,297,163,34,494,1
안락→연산교차로,2023.9.30 22:00,354,0,80,434,1
연산터널→연산교차로,2023.9.30 22:00,197,250,54,501,1
교대→연산교차로,2023.9.30 23:00,218,0,241,459,1
부산시청→연산교차로,2023.9.30 23:00,320,231,136,687,1
사직운동장→연산교차로,2023.9.30 23:00,89,282,68,439,1
신리→연산교차로,2023.9.30 23:00,257,130,29,416,1
안락→연산교차로,2023.9.30 23:00,307,0,72,379,1
연산터널→연산교차로,2023.9.30 23:00,185,213,75,473,1
교대→연산교차로,2023.10.1 00:00,179,0,167,346,1
부산시청→연산교차로,2023.10.1 00:00,292,184,121,597,1
사직운동장→연산교차로,2023.10.1 00:00,70,191,32,293,1
신리→연산교차로,2023.10.1 00:00,219,129,16,364,1
안락→연산교차로,2023.10.1 00:00,230,0,57,287,1
연산터널→연산교차로,2023.10.1 00:00,130,169,29,328,1
교대→연산교차로,2023.10.1 01:00,134,0,179,313,1
부산시청→연산교차로,2023.10.1 01:00,244,152,81,477,1
사직운동장→연산교차로,2023.10.1 01:00,59,145,25,229,1
신리→연산교차로,2023.10.1 01:00,174,95,15,284,1
안락→연산교차로,2023.10.1 01:00,188,0,45,233,1
연산터널→연산교차로,2023.10.1 01:00,110,122,28,260,1
교대→연산교차로,2023.10.1 02:00,124,0,161,285,1
부산시청→연산교차로,2023.10.1 02:00,210,139,71,420,1
사직운동장→연산교차로,2023.10.1 02:00,47,145,19,211,1
신리→연산교차로,2023.10.1 02:00,147,94,22,263,1
안락→연산교차로,2023.10.1 02:00,147,0,34,181,1
연산터널→연산교차로,2023.10.1 02:00,81,145,30,256,1
교대→연산교차로,2023.10.1 03:00,94,0,120,214,1
부산시청→연산교차로,2023.10.1 03:00,175,106,56,337,1
사직운동장→연산교차로,2023.10.1 03:00,49,143,12,204,1
신리→연산교차로,2023.10.1 03:00,113,66,8,187,1
안락→연산교차로,2023.10.1 03:00,154,0,38,192,1
연산터널→연산교차로,2023.10.1 03:00,75,106,20,201,1
교대→연산교차로,2023.10.1 04:00,75,0,99,174,1
부산시청→연산교차로,2023.10.1 04:00,143,82,51,276,1
사직운동장→연산교차로,2023.10.1 04:00,33,119,4,156,1
신리→연산교차로,2023.10.1 04:00,87,54,8,149,1
안락→연산교차로,2023.10.1 04:00,139,0,40,179,1
연산터널→연산교차로,2023.10.1 04:00,66,117,15,198,1
교대→연산교차로,2023.10.1 05:00,52,0,92,144,1
부산시청→연산교차로,2023.10.1 05:00,189,99,40,328,1
사직운동장→연산교차로,2023.10.1 05:00,40,112,4,156,1
신리→연산교차로,2023.10.1 05:00,108,58,7,173,1
안락→연산교차로,2023.10.1 05:00,148,0,42,190,1
연산터널→연산교차로,2023.10.1 05:00,75,85,18,178,1
교대→연산교차로,2023.10.1 06:00,85,0,97,182,1
부산시청→연산교차로,2023.10.1 06:00,191,151,49,391,1
사직운동장→연산교차로,2023.10.1 06:00,31,125,35,191,1
신리→연산교차로,2023.10.1 06:00,157,66,12,235,1
안락→연산교차로,2023.10.1 06:00,198,0,57,255,1
연산터널→연산교차로,2023.10.1 06:00,108,107,23,238,1
교대→연산교차로,2023.10.1 07:00,90,0,120,210,1
부산시청→연산교차로,2023.10.1 07:00,214,148,71,433,1
사직운동장→연산교차로,2023.10.1 07:00,57,193,43,293,1
신리→연산교차로,2023.10.1 07:00,163,87,16,266,1
안락→연산교차로,2023.10.1 07:00,176,0,45,221,1
연산터널→연산교차로,2023.10.1 07:00,121,112,32,265,1
교대→연산교차로,2023.10.1 08:00,156,0,114,270,1
부산시청→연산교차로,2023.10.1 08:00,265,198,103,566,1
사직운동장→연산교차로,2023.10.1 08:00,84,291,35,410,1
신리→연산교차로,2023.10.1 08:00,255,115,22,392,1
안락→연산교차로,2023.10.1 08:00,272,0,61,333,1
연산터널→연산교차로,2023.10.1 08:00,165,135,33,333,1
교대→연산교차로,2023.10.1 09:00,182,0,167,349,1
부산시청→연산교차로,2023.10.1 09:00,384,290,147,821,1
사직운동장→연산교차로,2023.10.1 09:00,108,370,45,523,1
신리→연산교차로,2023.10.1 09:00,404,186,16,606,1
안락→연산교차로,2023.10.1 09:00,408,0,81,489,1
연산터널→연산교차로,2023.10.1 09:00,232,183,39,454,1
교대→연산교차로,2023.10.1 10:00,255,0,218,473,1
부산시청→연산교차로,2023.10.1 10:00,468,322,168,958,1
사직운동장→연산교차로,2023.10.1 10:00,166,555,47,768,1
신리→연산교차로,2023.10.1 10:00,449,170,29,648,1
안락→연산교차로,2023.10.1 10:00,435,0,108,543,1
연산터널→연산교차로,2023.10.1 10:00,250,253,52,555,1
교대→연산교차로,2023.10.1 11:00,255,0,222,477,1
부산시청→연산교차로,2023.10.1 11:00,575,336,207,1118,1
사직운동장→연산교차로,2023.10.1 11:00,193,563,46,802,1
신리→연산교차로,2023.10.1 11:00,426,230,25,681,1
안락→연산교차로,2023.10.1 11:00,487,0,136,623,1
연산터널→연산교차로,2023.10.1 11:00,255,268,38,561,1
교대→연산교차로,2023.10.1 12:00,253,0,193,446,1
부산시청→연산교차로,2023.10.1 12:00,664,356,231,1251,1
사직운동장→연산교차로,2023.10.1 12:00,214,593,47,854,1
신리→연산교차로,2023.10.1 12:00,503,266,33,802,1
안락→연산교차로,2023.10.1 12:00,505,0,152,657,1
연산터널→연산교차로,2023.10.1 12:00,293,273,43,609,1
교대→연산교차로,2023.10.1 13:00,264,0,252,516,1
부산시청→연산교차로,2023.10.1 13:00,659,357,230,1246,1
사직운동장→연산교차로,2023.10.1 13:00,198,584,36,818,1
신리→연산교차로,2023.10.1 13:00,445,293,36,774,1
안락→연산교차로,2023.10.1 13:00,552,0,133,685,1
연산터널→연산교차로,2023.10.1 13:00,246,274,50,570,1
교대→연산교차로,2023.10.1 14:00,304,0,253,557,1
부산시청→연산교차로,2023.10.1 14:00,576,331,265,1172,1
사직운동장→연산교차로,2023.10.1 14:00,215,582,42,839,1
신리→연산교차로,2023.10.1 14:00,449,190,36,675,1
안락→연산교차로,2023.10.1 14:00,523,0,158,681,1
연산터널→연산교차로,2023.10.1 14:00,244,264,53,561,1
교대→연산교차로,2023.10.1 15:00,321,0,275,596,1
부산시청→연산교차로,2023.10.1 15:00,547,331,209,1087,1
사직운동장→연산교차로,2023.10.1 15:00,234,524,57,815,1
신리→연산교차로,2023.10.1 15:00,442,208,33,683,1
안락→연산교차로,2023.10.1 15:00,528,0,113,641,1
연산터널→연산교차로,2023.10.1 15:00,217,235,37,489,1
교대→연산교차로,2023.10.1 16:00,291,0,298,589,1
부산시청→연산교차로,2023.10.1 16:00,520,348,222,1090,1
사직운동장→연산교차로,2023.10.1 16:00,230,524,63,817,1
신리→연산교차로,2023.10.1 16:00,401,223,44,668,1
안락→연산교차로,2023.10.1 16:00,514,0,143,657,1
연산터널→연산교차로,2023.10.1 16:00,223,247,40,510,1
교대→연산교차로,2023.10.1 17:00,309,0,312,621,1
부산시청→연산교차로,2023.10.1 17:00,503,318,198,1019,1
사직운동장→연산교차로,2023.10.1 17:00,297,500,27,824,1
신리→연산교차로,2023.10.1 17:00,381,202,24,607,1
안락→연산교차로,2023.10.1 17:00,566,0,122,688,1
연산터널→연산교차로,2023.10.1 17:00,257,249,58,564,1
교대→연산교차로,2023.10.1 18:00,299,0,298,597,1
부산시청→연산교차로,2023.10.1 18:00,483,285,200,968,1
사직운동장→연산교차로,2023.10.1 18:00,237,498,51,786,1
신리→연산교차로,2023.10.1 18:00,350,192,30,572,1
안락→연산교차로,2023.10.1 18:00,516,0,136,652,1
연산터널→연산교차로,2023.10.1 18:00,237,272,54,563,1
교대→연산교차로,2023.10.1 19:00,290,0,284,574,1
부산시청→연산교차로,2023.10.1 19:00,391,275,180,846,1
사직운동장→연산교차로,2023.10.1 19:00,166,391,60,617,1
신리→연산교차로,2023.10.1 19:00,306,169,32,507,1
안락→연산교차로,2023.10.1 19:00,481,0,117,598,1
연산터널→연산교차로,2023.10.1 19:00,233,258,49,540,1
교대→연산교차로,2023.10.1 20:00,265,0,275,540,1
부산시청→연산교차로,2023.10.1 20:00,398,271,170,839,1
사직운동장→연산교차로,2023.10.1 20:00,155,384,46,585,1
신리→연산교차로,2023.10.1 20:00,315,188,25,528,1
안락→연산교차로,2023.10.1 20:00,430,0,110,540,1
연산터널→연산교차로,2023.10.1 20:00,237,208,48,493,1
교대→연산교차로,2023.10.1 21:00,256,0,213,469,1
부산시청→연산교차로,2023.10.1 21:00,370,226,150,746,1
사직운동장→연산교차로,2023.10.1 21:00,134,355,48,537,1
신리→연산교차로,2023.10.1 21:00,305,205,24,534,1
안락→연산교차로,2023.10.1 21:00,357,0,98,455,1
연산터널→연산교차로,2023.10.1 21:00,165,192,37,394,1
교대→연산교차로,2023.10.1 22:00,234,0,217,451,1
부산시청→연산교차로,2023.10.1 22:00,351,247,129,727,1
사직운동장→연산교차로,2023.10.1 22:00,109,281,63,453,1
신리→연산교차로,2023.10.1 22:00,268,173,17,458,1
안락→연산교차로,2023.10.1 22:00,321,0,79,400,1
연산터널→연산교차로,2023.10.1 22:00,144,191,42,377,1
교대→연산교차로,2023.10.1 23:00,180,0,196,376,1
부산시청→연산교차로,2023.10.1 23:00,324,187,100,611,1
사직운동장→연산교차로,2023.10.1 23:00,92,265,62,419,1
신리→연산교차로,2023.10.1 23:00,248,123,23,394,1
안락→연산교차로,2023.10.1 23:00,278,0,64,342,1
연산터널→연산교차로,2023.10.1 23:00,135,154,31,320,1
교대→연산교차로,2023.10.2 00:00,146,0,170,316,1
부산시청→연산교차로,2023.10.2 00:00,289,179,96,564,1
사직운동장→연산교차로,2023.10.2 00:00,60,192,26,278,1
신리→연산교차로,2023.10.2 00:00,199,131,14,344,1
안락→연산교차로,2023.10.2 00:00,216,0,44,260,1
연산터널→연산교차로,2023.10.2 00:00,116,148,22,286,1
교대→연산교차로,2023.10.2 01:00,108,0,126,234,1
부산시청→연산교차로,2023.10.2 01:00,168,131,78,377,1
사직운동장→연산교차로,2023.10.2 01:00,36,128,29,193,1
신리→연산교차로,2023.10.2 01:00,134,76,11,221,1
안락→연산교차로,2023.10.2 01:00,174,0,45,219,1
연산터널→연산교차로,2023.10.2 01:00,69,92,26,187,1
교대→연산교차로,2023.10.2 02:00,95,0,136,231,1
부산시청→연산교차로,2023.10.2 02:00,190,107,60,357,1
사직운동장→연산교차로,2023.10.2 02:00,43,143,23,209,1
신리→연산교차로,2023.10.2 02:00,111,64,19,194,1
안락→연산교차로,2023.10.2 02:00,158,0,44,202,1
연산터널→연산교차로,2023.10.2 02:00,76,87,27,190,1
교대→연산교차로,2023.10.2 03:00,88,0,145,233,1
부산시청→연산교차로,2023.10.2 03:00,173,98,72,343,1
사직운동장→연산교차로,2023.10.2 03:00,49,109,12,170,1
신리→연산교차로,2023.10.2 03:00,89,50,17,156,1
안락→연산교차로,2023.10.2 03:00,155,0,32,187,1
연산터널→연산교차로,2023.10.2 03:00,81,91,32,204,1
교대→연산교차로,2023.10.2 04:00,64,0,102,166,1
부산시청→연산교차로,2023.10.2 04:00,162,77,55,294,1
사직운동장→연산교차로,2023.10.2 04:00,34,124,6,164,1
신리→연산교차로,2023.10.2 04:00,74,51,6,131,1
안락→연산교차로,2023.10.2 04:00,136,0,41,177,1
연산터널→연산교차로,2023.10.2 04:00,62,90,20,172,1
교대→연산교차로,2023.10.2 05:00,73,0,106,179,1
부산시청→연산교차로,2023.10.2 05:00,164,111,67,342,1
사직운동장→연산교차로,2023.10.2 05:00,43,106,6,155,1
신리→연산교차로,2023.10.2 05:00,141,60,8,209,1
안락→연산교차로,2023.10.2 05:00,219,0,36,255,1
연산터널→연산교차로,2023.10.2 05:00,91,102,14,207,1
교대→연산교차로,2023.10.2 06:00,105,0,145,250,1
부산시청→연산교차로,2023.10.2 06:00,252,187,81,520,1
사직운동장→연산교차로,2023.10.2 06:00,56,176,41,273,1
신리→연산교차로,2023.10.2 06:00,200,111,15,326,1
안락→연산교차로,2023.10.2 06:00,300,0,71,371,1
연산터널→연산교차로,2023.10.2 06:00,151,135,35,321,1
교대→연산교차로,2023.10.2 07:00,132,0,164,296,1
부산시청→연산교차로,2023.10.2 07:00,285,198,112,595,1
사직운동장→연산교차로,2023.10.2 07:00,89,265,51,405,1
신리→연산교차로,2023.10.2 07:00,230,139,26,395,1
안락→연산교차로,2023.10.2 07:00,314,0,62,376,1
연산터널→연산교차로,2023.10.2 07:00,149,155,35,339,1
교대→연산교차로,2023.10.2 08:00,190,0,223,413,1
부산시청→연산교차로,2023.10.2 08:00,397,238,181,816,1
사직운동장→연산교차로,2023.10.2 08:00,134,348,47,529,1
신리→연산교차로,2023.10.2 08:00,383,150,56,589,1
안락→연산교차로,2023.10.2 08:00,367,0,82,449,1
연산터널→연산교차로,2023.10.2 08:00,190,212,34,436,1
교대→연산교차로,2023.10.2 09:00,215,0,296,511,1
부산시청→연산교차로,2023.10.2 09:00,450,320,184,954,1
사직운동장→연산교차로,2023.10.2 09:00,140,494,66,700,1
신리→연산교차로,2023.10.2 09:00,402,239,52,693,1
안락→연산교차로,2023.10.2 09:00,433,0,117,550,1
연산터널→연산교차로,2023.10.2 09:00,252,256,72,580,1
교대→연산교차로,2023.10.2 10:00,261,0,330,591,1
부산시청→연산교차로,2023.10.2 10:00,491,353,234,1078,1
사직운동장→연산교차로,2023.10.2 10:00,198,547,64,809,1
신리→연산교차로,2023.10.2 10:00,498,214,61,773,1
안락→연산교차로,2023.10.2 10:00,487,0,171,658,1
연산터널→연산교차로,2023.10.2 10:00,255,291,55,601,1
교대→연산교차로,2023.10.2 11:00,256,0,331,587,1
부산시청→연산교차로,2023.10.2 11:00,600,328,231,1159,1
사직운동장→연산교차로,2023.10.2 11:00,199,563,76,838,1
신리→연산교차로,2023.10.2 11:00,487,253,67,807,1
안락→연산교차로,2023.10.2 11:00,494,0,177,671,1
연산터널→연산교차로,2023.10.2 11:00,271,270,60,601,1
교대→연산교차로,2023.10.2 12:00,284,0,265,549,1
부산시청→연산교차로,2023.10.2 12:00,589,386,245,1220,1
사직운동장→연산교차로,2023.10.2 12:00,212,554,63,829,1
신리→연산교차로,2023.10.2 12:00,440,308,62,810,1
안락→연산교차로,2023.10.2 12:00,520,0,171,691,1
연산터널→연산교차로,2023.10.2 12:00,266,289,65,620,1
교대→연산교차로,2023.10.2 13:00,299,0,287,586,1
부산시청→연산교차로,2023.10.2 13:00,657,373,213,1243,1
사직운동장→연산교차로,2023.10.2 13:00,223,526,52,801,1
신리→연산교차로,2023.10.2 13:00,477,261,47,785,1
안락→연산교차로,2023.10.2 13:00,491,0,195,686,1
연산터널→연산교차로,2023.10.2 13:00,264,287,50,601,1
교대→연산교차로,2023.10.2 14:00,316,0,342,658,1
부산시청→연산교차로,2023.10.2 14:00,632,378,232,1242,1
사직운동장→연산교차로,2023.10.2 14:00,201,575,60,836,1
신리→연산교차로,2023.10.2 14:00,434,261,62,757,1
안락→연산교차로,2023.10.2 14:00,562,0,161,723,1
연산터널→연산교차로,2023.10.2 14:00,272,292,46,610,1
교대→연산교차로,2023.10.2 15:00,284,0,329,613,1
부산시청→연산교차로,2023.10.2 15:00,615,378,246,1239,1
사직운동장→연산교차로,2023.10.2 15:00,193,562,69,824,1
신리→연산교차로,2023.10.2 15:00,431,266,47,744,1
안락→연산교차로,2023.10.2 15:00,532,0,153,685,1
연산터널→연산교차로,2023.10.2 15:00,245,257,52,554,1
교대→연산교차로,2023.10.2 16:00,294,0,345,639,1
부산시청→연산교차로,2023.10.2 16:00,528,373,243,1144,1
사직운동장→연산교차로,2023.10.2 16:00,215,546,64,825,1
신리→연산교차로,2023.10.2 16:00,429,292,40,761,1
안락→연산교차로,2023.10.2 16:00,556,0,156,712,1
연산터널→연산교차로,2023.10.2 16:00,261,273,44,578,1
교대→연산교차로,2023.10.2 17:00,311,0,318,629,1
부산시청→연산교차로,2023.10.2 17:00,569,382,239,1190,1
사직운동장→연산교차로,2023.10.2 17:00,213,587,60,860,1
신리→연산교차로,2023.10.2 17:00,395,244,46,685,1
안락→연산교차로,2023.10.2 17:00,556,0,140,696,1
연산터널→연산교차로,2023.10.2 17:00,236,274,61,571,1
교대→연산교차로,2023.10.2 18:00,303,0,346,649,1
부산시청→연산교차로,2023.10.2 18:00,532,319,202,1053,1
사직운동장→연산교차로,2023.10.2 18:00,240,547,42,829,1
신리→연산교차로,2023.10.2 18:00,319,207,31,557,1
안락→연산교차로,2023.10.2 18:00,525,0,128,653,1
연산터널→연산교차로,2023.10.2 18:00,231,240,56,527,1
교대→연산교차로,2023.10.2 19:00,267,0,285,552,1
부산시청→연산교차로,2023.10.2 19:00,488,282,192,962,1
사직운동장→연산교차로,2023.10.2 19:00,150,450,81,681,1
신리→연산교차로,2023.10.2 19:00,286,191,31,508,1
안락→연산교차로,2023.10.2 19:00,440,0,113,553,1
연산터널→연산교차로,2023.10.2 19:00,210,264,41,515,1
교대→연산교차로,2023.10.2 20:00,276,0,270,546,1
부산시청→연산교차로,2023.10.2 20:00,434,247,198,879,1
사직운동장→연산교차로,2023.10.2 20:00,138,452,71,661,1
신리→연산교차로,2023.10.2 20:00,331,177,26,534,1
안락→연산교차로,2023.10.2 20:00,406,0,128,534,1
연산터널→연산교차로,2023.10.2 20:00,216,218,64,498,1
교대→연산교차로,2023.10.2 21:00,256,0,238,494,1
부산시청→연산교차로,2023.10.2 21:00,409,277,155,841,1
사직운동장→연산교차로,2023.10.2 21:00,153,394,62,609,1
신리→연산교차로,2023.10.2 21:00,298,173,30,501,1
안락→연산교차로,2023.10.2 21:00,354,0,101,455,1
연산터널→연산교차로,2023.10.2 21:00,226,226,46,498,1
교대→연산교차로,2023.10.2 22:00,250,0,184,434,1
부산시청→연산교차로,2023.10.2 22:00,349,244,162,755,1
사직운동장→연산교차로,2023.10.2 22:00,189,412,61,662,1
신리→연산교차로,2023.10.2 22:00,267,182,29,478,1
안락→연산교차로,2023.10.2 22:00,324,0,82,406,1
연산터널→연산교차로,2023.10.2 22:00,163,215,53,431,1
교대→연산교차로,2023.10.2 23:00,194,0,188,382,1
부산시청→연산교차로,2023.10.2 23:00,303,181,117,601,1
사직운동장→연산교차로,2023.10.2 23:00,94,257,36,387,1
신리→연산교차로,2023.10.2 23:00,235,132,17,384,1
안락→연산교차로,2023.10.2 23:00,280,0,76,356,1
연산터널→연산교차로,2023.10.2 23:00,155,176,49,380,1
교대→연산교차로,2023.10.3 00:00,132,0,188,320,1
부산시청→연산교차로,2023.10.3 00:00,269,182,109,560,1
사직운동장→연산교차로,2023.10.3 00:00,80,213,42,335,1
신리→연산교차로,2023.10.3 00:00,195,103,23,321,1
안락→연산교차로,2023.10.3 00:00,217,0,57,274,1
연산터널→연산교차로,2023.10.3 00:00,111,182,24,317,1
교대→연산교차로,2023.10.3 01:00,113,0,150,263,1
부산시청→연산교차로,2023.10.3 01:00,242,145,88,475,1
사직운동장→연산교차로,2023.10.3 01:00,57,191,21,269,1
신리→연산교차로,2023.10.3 01:00,132,84,17,233,1
안락→연산교차로,2023.10.3 01:00,194,0,34,228,1
연산터널→연산교차로,2023.10.3 01:00,104,116,31,251,1
교대→연산교차로,2023.10.3 02:00,97,0,141,238,1
부산시청→연산교차로,2023.10.3 02:00,205,98,72,375,1
사직운동장→연산교차로,2023.10.3 02:00,38,172,15,225,1
신리→연산교차로,2023.10.3 02:00,126,59,15,200,1
안락→연산교차로,2023.10.3 02:00,157,0,36,193,1
연산터널→연산교차로,2023.10.3 02:00,95,136,26,257,1
교대→연산교차로,2023.10.3 03:00,61,0,155,216,1
부산시청→연산교차로,2023.10.3 03:00,181,108,55,344,1
사직운동장→연산교차로,2023.10.3 03:00,45,118,16,179,1
신리→연산교차로,2023.10.3 03:00,88,53,13,154,1
안락→연산교차로,2023.10.3 03:00,130,0,35,165,1
연산터널→연산교차로,2023.10.3 03:00,80,91,32,203,1
교대→연산교차로,2023.10.3 04:00,59,0,101,160,1
부산시청→연산교차로,2023.10.3 04:00,161,84,41,286,1
사직운동장→연산교차로,2023.10.3 04:00,32,112,5,149,1
신리→연산교차로,2023.10.3 04:00,76,50,4,130,1
안락→연산교차로,2023.10.3 04:00,145,0,40,185,1
연산터널→연산교차로,2023.10.3 04:00,55,125,26,206,1
교대→연산교차로,2023.10.3 05:00,74,0,109,183,1
부산시청→연산교차로,2023.10.3 05:00,208,110,77,395,1
사직운동장→연산교차로,2023.10.3 05:00,41,136,6,183,1
신리→연산교차로,2023.10.3 05:00,153,72,6,231,1
안락→연산교차로,2023.10.3 05:00,238,0,44,282,1
연산터널→연산교차로,2023.10.3 05:00,101,114,17,232,1
교대→연산교차로,2023.10.3 06:00,110,0,142,252,1
부산시청→연산교차로,2023.10.3 06:00,289,177,78,544,1
사직운동장→연산교차로,2023.10.3 06:00,63,197,44,304,1
신리→연산교차로,2023.10.3 06:00,203,111,15,329,1
안락→연산교차로,2023.10.3 06:00,299,0,88,387,1
연산터널→연산교차로,2023.10.3 06:00,172,132,45,349,1
교대→연산교차로,2023.10.3 07:00,121,0,187,308,1
부산시청→연산교차로,2023.10.3 07:00,294,178,89,561,1
사직운동장→연산교차로,2023.10.3 07:00,91,275,47,413,1
신리→연산교차로,2023.10.3 07:00,196,133,21,350,1
안락→연산교차로,2023.10.3 07:00,293,0,62,355,1
연산터널→연산교차로,2023.10.3 07:00,148,172,41,361,1
교대→연산교차로,2023.10.3 08:00,145,0,193,338,1
부산시청→연산교차로,2023.10.3 08:00,309,211,140,660,1
사직운동장→연산교차로,2023.10.3 08:00,84,305,63,452,1
신리→연산교차로,2023.10.3 08:00,298,141,35,474,1
안락→연산교차로,2023.10.3 08:00,337,0,82,419,1
연산터널→연산교차로,2023.10.3 08:00,171,173,33,377,1
교대→연산교차로,2023.10.3 09:00,191,0,228,419,1
부산시청→연산교차로,2023.10.3 09:00,402,282,166,850,1
사직운동장→연산교차로,2023.10.3 09:00,130,376,50,556,1
신리→연산교차로,2023.10.3 09:00,343,190,37,570,1
안락→연산교차로,2023.10.3 09:00,373,0,103,476,1
연산터널→연산교차로,2023.10.3 09:00,195,221,43,459,1
교대→연산교차로,2023.10.3 10:00,220,0,263,483,1
부산시청→연산교차로,2023.10.3 10:00,414,294,159,867,1
사직운동장→연산교차로,2023.10.3 10:00,164,490,54,708,1
신리→연산교차로,2023.10.3 10:00,407,199,40,646,1
안락→연산교차로,2023.10.3 10:00,469,0,146,615,1
연산터널→연산교차로,2023.10.3 10:00,224,242,42,508,1
교대→연산교차로,2023.10.3 11:00,271,0,281,552,1
부산시청→연산교차로,2023.10.3 11:00,480,326,201,1007,1
사직운동장→연산교차로,2023.10.3 11:00,177,515,54,746,1
신리→연산교차로,2023.10.3 11:00,421,230,45,696,1
안락→연산교차로,2023.10.3 11:00,447,0,137,584,1
연산터널→연산교차로,2023.10.3 11:00,264,275,41,580,1
교대→연산교차로,2023.10.3 12:00,263,0,323,586,1
부산시청→연산교차로,2023.10.3 12:00,549,337,218,1104,1
사직운동장→연산교차로,2023.10.3 12:00,179,526,75,780,1
신리→연산교차로,2023.10.3 12:00,407,246,36,689,1
안락→연산교차로,2023.10.3 12:00,476,0,163,639,1
연산터널→연산교차로,2023.10.3 12:00,282,262,45,589,1
교대→연산교차로,2023.10.3 13:00,293,0,307,600,1
부산시청→연산교차로,2023.10.3 13:00,547,336,228,1111,1
사직운동장→연산교차로,2023.10.3 13:00,179,531,58,768,1
신리→연산교차로,2023.10.3 13:00,421,264,27,712,1
안락→연산교차로,2023.10.3 13:00,516,0,158,674,1
연산터널→연산교차로,2023.10.3 13:00,276,299,45,620,1
교대→연산교차로,2023.10.3 14:00,295,0,336,631,1
부산시청→연산교차로,2023.10.3 14:00,548,326,229,1103,1
사직운동장→연산교차로,2023.10.3 14:00,215,548,63,826,1
신리→연산교차로,2023.10.3 14:00,420,224,37,681,1
안락→연산교차로,2023.10.3 14:00,526,0,164,690,1
연산터널→연산교차로,2023.10.3 14:00,270,270,48,588,1
교대→연산교차로,2023.10.3 15:00,278,0,326,604,1
부산시청→연산교차로,2023.10.3 15:00,583,331,234,1148,1
사직운동장→연산교차로,2023.10.3 15:00,189,540,76,805,1
신리→연산교차로,2023.10.3 15:00,400,227,51,678,1
안락→연산교차로,2023.10.3 15:00,488,0,161,649,1
연산터널→연산교차로,2023.10.3 15:00,247,255,38,540,1
교대→연산교차로,2023.10.3 16:00,276,0,358,634,1
부산시청→연산교차로,2023.10.3 16:00,572,362,239,1173,1
사직운동장→연산교차로,2023.10.3 16:00,198,549,62,809,1
신리→연산교차로,2023.10.3 16:00,425,202,48,675,1
안락→연산교차로,2023.10.3 16:00,532,0,162,694,1
연산터널→연산교차로,2023.10.3 16:00,265,277,57,599,1
교대→연산교차로,2023.10.3 17:00,280,0,322,602,1
부산시청→연산교차로,2023.10.3 17:00,558,346,258,1162,1
사직운동장→연산교차로,2023.10.3 17:00,207,566,63,836,1
신리→연산교차로,2023.10.3 17:00,382,230,38,650,1
안락→연산교차로,2023.10.3 17:00,516,0,172,688,1
연산터널→연산교차로,2023.10.3 17:00,244,255,61,560,1
교대→연산교차로,2023.10.3 18:00,263,0,289,552,1
부산시청→연산교차로,2023.10.3 18:00,450,308,206,964,1
사직운동장→연산교차로,2023.10.3 18:00,175,478,64,717,1
신리→연산교차로,2023.10.3 18:00,331,192,26,549,1
안락→연산교차로,2023.10.3 18:00,501,0,115,616,1
연산터널→연산교차로,2023.10.3 18:00,229,249,25,503,1
교대→연산교차로,2023.10.3 19:00,282,0,311,593,1
부산시청→연산교차로,2023.10.3 19:00,433,270,182,885,1
사직운동장→연산교차로,2023.10.3 19:00,133,424,60,617,1
신리→연산교차로,2023.10.3 19:00,283,176,35,494,1
안락→연산교차로,2023.10.3 19:00,397,0,121,518,1
연산터널→연산교차로,2023.10.3 19:00,208,264,39,511,1
교대→연산교차로,2023.10.3 20:00,237,0,229,466,1
부산시청→연산교차로,2023.10.3 20:00,389,252,157,798,1
사직운동장→연산교차로,2023.10.3 20:00,135,356,61,552,1
신리→연산교차로,2023.10.3 20:00,266,144,32,442,1
안락→연산교차로,2023.10.3 20:00,353,0,99,452,1
연산터널→연산교차로,2023.10.3 20:00,195,206,51,452,1
교대→연산교차로,2023.10.3 21:00,228,0,203,431,1
부산시청→연산교차로,2023.10.3 21:00,349,227,154,730,1
사직운동장→연산교차로,2023.10.3 21:00,106,297,67,470,1
신리→연산교차로,2023.10.3 21:00,252,152,25,429,1
안락→연산교차로,2023.10.3 21:00,304,0,94,398,1
연산터널→연산교차로,2023.10.3 21:00,156,178,58,392,1
교대→연산교차로,2023.10.3 22:00,183,0,208,391,1
부산시청→연산교차로,2023.10.3 22:00,304,203,102,609,1
사직운동장→연산교차로,2023.10.3 22:00,96,298,71,465,1
신리→연산교차로,2023.10.3 22:00,189,107,22,318,1
안락→연산교차로,2023.10.3 22:00,246,0,57,303,1
연산터널→연산교차로,2023.10.3 22:00,149,166,59,374,1
교대→연산교차로,2023.10.3 23:00,119,0,161,280,1
부산시청→연산교차로,2023.10.3 23:00,230,152,98,480,1
사직운동장→연산교차로,2023.10.3 23:00,63,209,63,335,1
신리→연산교차로,2023.10.3 23:00,165,81,21,267,1
안락→연산교차로,2023.10.3 23:00,206,0,61,267,1
연산터널→연산교차로,2023.10.3 23:00,128,149,70,347,1
교대→연산교차로,2023.10.4 00:00,89,0,166,255,0
부산시청→연산교차로,2023.10.4 00:00,200,113,76,389,0
사직운동장→연산교차로,2023.10.4 00:00,44,195,20,259,0
신리→연산교차로,2023.10.4 00:00,98,70,17,185,0
안락→연산교차로,2023.10.4 00:00,155,0,39,194,0
연산터널→연산교차로,2023.10.4 00:00,108,139,56,303,0
교대→연산교차로,2023.10.4 01:00,75,0,109,184,0
부산시청→연산교차로,2023.10.4 01:00,163,90,57,310,0
사직운동장→연산교차로,2023.10.4 01:00,40,120,20,180,0
신리→연산교차로,2023.10.4 01:00,91,48,13,152,0
안락→연산교차로,2023.10.4 01:00,124,0,35,159,0
연산터널→연산교차로,2023.10.4 01:00,87,99,42,228,0
교대→연산교차로,2023.10.4 02:00,66,0,87,153,0
부산시청→연산교차로,2023.10.4 02:00,114,64,62,240,0
사직운동장→연산교차로,2023.10.4 02:00,30,106,9,145,0
신리→연산교차로,2023.10.4 02:00,83,43,13,139,0
안락→연산교차로,2023.10.4 02:00,98,0,19,117,0
연산터널→연산교차로,2023.10.4 02:00,71,87,41,199,0
교대→연산교차로,2023.10.4 03:00,55,0,91,146,0
부산시청→연산교차로,2023.10.4 03:00,124,64,45,233,0
사직운동장→연산교차로,2023.10.4 03:00,24,110,8,142,0
신리→연산교차로,2023.10.4 03:00,70,36,9,115,0
안락→연산교차로,2023.10.4 03:00,96,0,28,124,0
연산터널→연산교차로,2023.10.4 03:00,67,76,50,193,0
교대→연산교차로,2023.10.4 04:00,47,0,69,116,0
부산시청→연산교차로,2023.10.4 04:00,149,71,36,256,0
사직운동장→연산교차로,2023.10.4 04:00,29,106,2,137,0
신리→연산교차로,2023.10.4 04:00,91,52,11,154,0
안락→연산교차로,2023.10.4 04:00,163,0,30,193,0
연산터널→연산교차로,2023.10.4 04:00,71,82,23,176,0
교대→연산교차로,2023.10.4 05:00,80,0,97,177,0
부산시청→연산교차로,2023.10.4 05:00,233,165,88,486,0
사직운동장→연산교차로,2023.10.4 05:00,47,145,7,199,0
신리→연산교차로,2023.10.4 05:00,215,92,6,313,0
안락→연산교차로,2023.10.4 05:00,304,0,39,343,0
연산터널→연산교차로,2023.10.4 05:00,129,129,22,280,0
교대→연산교차로,2023.10.4 06:00,151,0,246,397,0
부산시청→연산교차로,2023.10.4 06:00,364,265,120,749,0
사직운동장→연산교차로,2023.10.4 06:00,74,261,53,388,0
신리→연산교차로,2023.10.4 06:00,330,189,16,535,0
안락→연산교차로,2023.10.4 06:00,482,0,101,583,0
연산터널→연산교차로,2023.10.4 06:00,236,232,35,503,0
교대→연산교차로,2023.10.4 07:00,263,0,387,650,0
부산시청→연산교차로,2023.10.4 07:00,607,379,224,1210,0
사직운동장→연산교차로,2023.10.4 07:00,189,527,57,773,0
신리→연산교차로,2023.10.4 07:00,479,313,21,813,0
안락→연산교차로,2023.10.4 07:00,632,0,85,717,0
연산터널→연산교차로,2023.10.4 07:00,296,389,38,723,0
교대→연산교차로,2023.10.4 08:00,335,0,521,856,0
부산시청→연산교차로,2023.10.4 08:00,579,441,321,1341,0
사직운동장→연산교차로,2023.10.4 08:00,218,657,62,937,0
신리→연산교차로,2023.10.4 08:00,505,345,22,872,0
안락→연산교차로,2023.10.4 08:00,626,0,108,734,0
연산터널→연산교차로,2023.10.4 08:00,337,376,25,738,0
교대→연산교차로,2023.10.4 09:00,280,0,506,786,0
부산시청→연산교차로,2023.10.4 09:00,546,392,283,1221,0
사직운동장→연산교차로,2023.10.4 09:00,194,548,77,819,0
신리→연산교차로,2023.10.4 09:00,472,344,44,860,0
안락→연산교차로,2023.10.4 09:00,572,0,91,663,0
연산터널→연산교차로,2023.10.4 09:00,307,373,33,713,0
교대→연산교차로,2023.10.4 10:00,294,0,449,743,0
부산시청→연산교차로,2023.10.4 10:00,547,368,250,1165,0
사직운동장→연산교차로,2023.10.4 10:00,195,535,85,815,0
신리→연산교차로,2023.10.4 10:00,447,286,58,791,0
안락→연산교차로,2023.10.4 10:00,538,0,140,678,0
연산터널→연산교차로,2023.10.4 10:00,324,341,61,726,0
교대→연산교차로,2023.10.4 11:00,278,0,359,637,0
부산시청→연산교차로,2023.10.4 11:00,563,355,219,1137,0
사직운동장→연산교차로,2023.10.4 11:00,210,536,91,837,0
신리→연산교차로,2023.10.4 11:00,446,231,48,725,0
안락→연산교차로,2023.10.4 11:00,505,0,154,659,0
연산터널→연산교차로,2023.10.4 11:00,262,304,52,618,0
교대→연산교차로,2023.10.4 12:00,294,0,353,647,0
부산시청→연산교차로,2023.10.4 12:00,521,345,269,1135,0
사직운동장→연산교차로,2023.10.4 12:00,187,551,83,821,0
신리→연산교차로,2023.10.4 12:00,413,248,61,722,0
안락→연산교차로,2023.10.4 12:00,464,0,154,618,0
연산터널→연산교차로,2023.10.4 12:00,249,247,45,541,0
교대→연산교차로,2023.10.4 13:00,321,0,429,750,0
부산시청→연산교차로,2023.10.4 13:00,555,396,246,1197,0
사직운동장→연산교차로,2023.10.4 13:00,191,558,78,827,0
신리→연산교차로,2023.10.4 13:00,437,274,37,748,0
안락→연산교차로,2023.10.4 13:00,441,0,128,569,0
연산터널→연산교차로,2023.10.4 13:00,242,271,30,543,0
교대→연산교차로,2023.10.4 14:00,334,0,440,774,0
부산시청→연산교차로,2023.10.4 14:00,565,458,281,1304,0
사직운동장→연산교차로,2023.10.4 14:00,222,579,84,885,0
신리→연산교차로,2023.10.4 14:00,464,288,62,814,0
안락→연산교차로,2023.10.4 14:00,421,0,137,558,0
연산터널→연산교차로,2023.10.4 14:00,223,301,51,575,0
교대→연산교차로,2023.10.4 15:00,349,0,455,804,0
부산시청→연산교차로,2023.10.4 15:00,563,470,274,1307,0
사직운동장→연산교차로,2023.10.4 15:00,200,632,117,949,0
신리→연산교차로,2023.10.4 15:00,469,246,52,767,0
안락→연산교차로,2023.10.4 15:00,432,0,110,542,0
연산터널→연산교차로,2023.10.4 15:00,229,269,48,546,0
교대→연산교차로,2023.10.4 16:00,337,0,465,802,0
부산시청→연산교차로,2023.10.4 16:00,625,542,301,1468,0
사직운동장→연산교차로,2023.10.4 16:00,255,627,89,971,0
신리→연산교차로,2023.10.4 16:00,523,301,56,880,0
안락→연산교차로,2023.10.4 16:00,434,0,102,536,0
연산터널→연산교차로,2023.10.4 16:00,229,282,40,551,0
교대→연산교차로,2023.10.4 17:00,359,0,537,896,0
부산시청→연산교차로,2023.10.4 17:00,655,565,330,1550,0
사직운동장→연산교차로,2023.10.4 17:00,235,702,53,990,0
신리→연산교차로,2023.10.4 17:00,504,288,73,865,0
안락→연산교차로,2023.10.4 17:00,425,0,143,568,0
연산터널→연산교차로,2023.10.4 17:00,226,289,44,559,0
교대→연산교차로,2023.10.4 18:00,354,0,581,935,0
부산시청→연산교차로,2023.10.4 18:00,600,585,342,1527,0
사직운동장→연산교차로,2023.10.4 18:00,234,649,52,935,0
신리→연산교차로,2023.10.4 18:00,519,275,35,829,0
안락→연산교차로,2023.10.4 18:00,443,0,94,537,0
연산터널→연산교차로,2023.10.4 18:00,232,282,32,546,0
교대→연산교차로,2023.10.4 19:00,320,0,406,726,0
부산시청→연산교차로,2023.10.4 19:00,501,399,307,1207,0
사직운동장→연산교차로,2023.10.4 19:00,202,533,65,800,0
신리→연산교차로,2023.10.4 19:00,374,216,30,620,0
안락→연산교차로,2023.10.4 19:00,400,0,81,481,0
연산터널→연산교차로,2023.10.4 19:00,202,271,43,516,0
교대→연산교차로,2023.10.4 20:00,320,0,343,663,0
부산시청→연산교차로,2023.10.4 20:00,476,327,218,1021,0
사직운동장→연산교차로,2023.10.4 20:00,159,484,61,704,0
신리→연산교차로,2023.10.4 20:00,314,192,28,534,0
안락→연산교차로,2023.10.4 20:00,382,0,72,454,0
연산터널→연산교차로,2023.10.4 20:00,206,241,50,497,0
교대→연산교차로,2023.10.4 21:00,269,0,288,557,0
부산시청→연산교차로,2023.10.4 21:00,371,314,210,895,0
사직운동장→연산교차로,2023.10.4 21:00,146,444,78,668,0
신리→연산교차로,2023.10.4 21:00,275,156,28,459,0
안락→연산교차로,2023.10.4 21:00,386,0,105,491,0
연산터널→연산교차로,2023.10.4 21:00,203,256,60,519,0
교대→연산교차로,2023.10.4 22:00,225,0,184,409,0
부산시청→연산교차로,2023.10.4 22:00,383,241,146,770,0
사직운동장→연산교차로,2023.10.4 22:00,186,357,54,597,0
신리→연산교차로,2023.10.4 22:00,203,150,24,377,0
안락→연산교차로,2023.10.4 22:00,301,0,82,383,0
연산터널→연산교차로,2023.10.4 22:00,199,210,59,468,0
교대→연산교차로,2023.10.4 23:00,155,0,160,315,0
부산시청→연산교차로,2023.10.4 23:00,285,175,88,548,0
사직운동장→연산교차로,2023.10.4 23:00,116,261,50,427,0
신리→연산교차로,2023.10.4 23:00,186,105,19,310,0
안락→연산교차로,2023.10.4 23:00,207,0,52,259,0
연산터널→연산교차로,2023.10.4 23:00,125,176,57,358,0
교대→연산교차로,2023.10.5 00:00,109,0,148,257,0
부산시청→연산교차로,2023.10.5 00:00,228,138,91,457,0
사직운동장→연산교차로,2023.10.5 00:00,79,204,29,312,0
신리→연산교차로,2023.10.5 00:00,152,73,17,242,0
안락→연산교차로,2023.10.5 00:00,193,0,43,236,0
연산터널→연산교차로,2023.10.5 00:00,111,158,64,333,0
교대→연산교차로,2023.10.5 01:00,100,0,140,240,0
부산시청→연산교차로,2023.10.5 01:00,170,105,74,349,0
사직운동장→연산교차로,2023.10.5 01:00,53,162,22,237,0
신리→연산교차로,2023.10.5 01:00,96,72,10,178,0
안락→연산교차로,2023.10.5 01:00,140,0,43,183,0
연산터널→연산교차로,2023.10.5 01:00,95,119,45,259,0
교대→연산교차로,2023.10.5 02:00,78,0,107,185,0
부산시청→연산교차로,2023.10.5 02:00,146,71,58,275,0
사직운동장→연산교차로,2023.10.5 02:00,37,152,13,202,0
신리→연산교차로,2023.10.5 02:00,82,52,11,145,0
안락→연산교차로,2023.10.5 02:00,108,0,34,142,0
연산터널→연산교차로,2023.10.5 02:00,81,112,27,220,0
교대→연산교차로,2023.10.5 03:00,49,0,95,144,0
부산시청→연산교차로,2023.10.5 03:00,138,74,48,260,0
사직운동장→연산교차로,2023.10.5 03:00,23,127,8,158,0
신리→연산교차로,2023.10.5 03:00,58,35,6,99,0
안락→연산교차로,2023.10.5 03:00,109,0,31,140,0
연산터널→연산교차로,2023.10.5 03:00,57,97,60,214,0
교대→연산교차로,2023.10.5 04:00,55,0,75,130,0
부산시청→연산교차로,2023.10.5 04:00,143,81,40,264,0
사직운동장→연산교차로,2023.10.5 04:00,35,111,10,156,0
신리→연산교차로,2023.10.5 04:00,97,49,11,157,0
안락→연산교차로,2023.10.5 04:00,167,0,36,203,0
연산터널→연산교차로,2023.10.5 04:00,69,93,18,180,0
교대→연산교차로,2023.10.5 05:00,86,0,117,203,0
부산시청→연산교차로,2023.10.5 05:00,240,154,88,482,0
사직운동장→연산교차로,2023.10.5 05:00,55,169,9,233,0
신리→연산교차로,2023.10.5 05:00,192,103,10,305,0
안락→연산교차로,2023.10.5 05:00,313,0,63,376,0
연산터널→연산교차로,2023.10.5 05:00,129,138,37,304,0
교대→연산교차로,2023.10.5 06:00,185,0,231,416,0
부산시청→연산교차로,2023.10.5 06:00,367,262,110,739,0
사직운동장→연산교차로,2023.10.5 06:00,96,297,49,442,0
신리→연산교차로,2023.10.5 06:00,364,195,23,582,0
안락→연산교차로,2023.10.5 06:00,466,0,95,561,0
연산터널→연산교차로,2023.10.5 06:00,226,210,30,466,0
교대→연산교차로,2023.10.5 07:00,262,0,411,673,0
부산시청→연산교차로,2023.10.5 07:00,588,376,195,1159,0
사직운동장→연산교차로,2023.10.5 07:00,206,523,74,803,0
신리→연산교차로,2023.10.5 07:00,477,304,27,808,0
안락→연산교차로,2023.10.5 07:00,631,0,89,720,0
연산터널→연산교차로,2023.10.5 07:00,284,423,36,743,0
교대→연산교차로,2023.10.5 08:00,300,0,507,807,0
부산시청→연산교차로,2023.10.5 08:00,569,430,314,1313,0
사직운동장→연산교차로,2023.10.5 08:00,197,644,74,915,0
신리→연산교차로,2023.10.5 08:00,513,334,28,875,0
안락→연산교차로,2023.10.5 08:00,634,0,107,741,0
연산터널→연산교차로,2023.10.5 08:00,326,386,27,739,0
교대→연산교차로,2023.10.5 09:00,281,0,465,746,0
부산시청→연산교차로,2023.10.5 09:00,546,384,290,1220,0
사직운동장→연산교차로,2023.10.5 09:00,183,600,107,890,0
신리→연산교차로,2023.10.5 09:00,464,325,38,827,0
안락→연산교차로,2023.10.5 09:00,568,0,131,699,0
연산터널→연산교차로,2023.10.5 09:00,321,355,44,720,0
교대→연산교차로,2023.10.5 10:00,273,0,450,723,0
부산시청→연산교차로,2023.10.5 10:00,604,357,256,1217,0
사직운동장→연산교차로,2023.10.5 10:00,205,559,71,835,0
신리→연산교차로,2023.10.5 10:00,469,314,45,828,0
안락→연산교차로,2023.10.5 10:00,553,0,142,695,0
연산터널→연산교차로,2023.10.5 10:00,280,290,48,618,0
교대→연산교차로,2023.10.5 11:00,289,0,408,697,0
부산시청→연산교차로,2023.10.5 11:00,565,345,267,1177,0
사직운동장→연산교차로,2023.10.5 11:00,207,574,85,866,0
신리→연산교차로,2023.10.5 11:00,428,249,68,745,0
안락→연산교차로,2023.10.5 11:00,493,0,193,686,0
연산터널→연산교차로,2023.10.5 11:00,268,315,48,631,0
교대→연산교차로,2023.10.5 12:00,291,0,344,635,0
부산시청→연산교차로,2023.10.5 12:00,503,348,277,1128,0
사직운동장→연산교차로,2023.10.5 12:00,168,522,100,790,0
신리→연산교차로,2023.10.5 12:00,414,242,49,705,0
안락→연산교차로,2023.10.5 12:00,462,0,158,620,0
연산터널→연산교차로,2023.10.5 12:00,244,256,51,551,0
교대→연산교차로,2023.10.5 13:00,305,0,432,737,0
부산시청→연산교차로,2023.10.5 13:00,587,452,292,1331,0
사직운동장→연산교차로,2023.10.5 13:00,204,624,70,898,0
신리→연산교차로,2023.10.5 13:00,422,268,64,754,0
안락→연산교차로,2023.10.5 13:00,440,0,117,557,0
연산터널→연산교차로,2023.10.5 13:00,223,278,45,546,0
교대→연산교차로,2023.10.5 14:00,349,0,466,815,0
부산시청→연산교차로,2023.10.5 14:00,570,439,289,1298,0
사직운동장→연산교차로,2023.10.5 14:00,191,627,82,900,0
신리→연산교차로,2023.10.5 14:00,452,254,73,779,0
안락→연산교차로,2023.10.5 14:00,427,0,91,518,0
연산터널→연산교차로,2023.10.5 14:00,224,263,38,525,0
교대→연산교차로,2023.10.5 15:00,347,0,467,814,0
부산시청→연산교차로,2023.10.5 15:00,574,465,291,1330,0
사직운동장→연산교차로,2023.10.5 15:00,232,614,101,947,0
신리→연산교차로,2023.10.5 15:00,482,256,58,796,0
안락→연산교차로,2023.10.5 15:00,410,0,99,509,0
연산터널→연산교차로,2023.10.5 15:00,222,277,52,551,0
교대→연산교차로,2023.10.5 16:00,337,0,498,835,0
부산시청→연산교차로,2023.10.5 16:00,635,518,300,1453,0
사직운동장→연산교차로,2023.10.5 16:00,236,641,87,964,0
신리→연산교차로,2023.10.5 16:00,544,288,60,892,0
안락→연산교차로,2023.10.5 16:00,448,0,90,538,0
연산터널→연산교차로,2023.10.5 16:00,260,256,43,559,0
교대→연산교차로,2023.10.5 17:00,352,0,534,886,0
부산시청→연산교차로,2023.10.5 17:00,628,557,326,1511,0
사직운동장→연산교차로,2023.10.5 17:00,247,684,47,978,0
신리→연산교차로,2023.10.5 17:00,486,311,46,843,0
안락→연산교차로,2023.10.5 17:00,424,0,110,534,0
연산터널→연산교차로,2023.10.5 17:00,239,273,42,554,0
교대→연산교차로,2023.10.5 18:00,344,0,512,856,0
부산시청→연산교차로,2023.10.5 18:00,578,583,326,1487,0
사직운동장→연산교차로,2023.10.5 18:00,249,645,46,940,0
신리→연산교차로,2023.10.5 18:00,511,281,36,828,0
안락→연산교차로,2023.10.5 18:00,443,0,93,536,0
연산터널→연산교차로,2023.10.5 18:00,213,266,54,533,0
교대→연산교차로,2023.10.5 19:00,303,0,389,692,0
부산시청→연산교차로,2023.10.5 19:00,499,380,273,1152,0
사직운동장→연산교차로,2023.10.5 19:00,182,573,71,826,0
신리→연산교차로,2023.10.5 19:00,378,238,42,658,0
안락→연산교차로,2023.10.5 19:00,434,0,98,532,0
연산터널→연산교차로,2023.10.5 19:00,194,250,49,493,0
교대→연산교차로,2023.10.5 20:00,296,0,350,646,0
부산시청→연산교차로,2023.10.5 20:00,488,372,246,1106,0
사직운동장→연산교차로,2023.10.5 20:00,174,550,94,818,0
신리→연산교차로,2023.10.5 20:00,310,165,34,509,0
안락→연산교차로,2023.10.5 20:00,403,0,94,497,0
연산터널→연산교차로,2023.10.5 20:00,209,266,57,532,0
교대→연산교차로,2023.10.5 21:00,277,0,280,557,0
부산시청→연산교차로,2023.10.5 21:00,461,323,206,990,0
사직운동장→연산교차로,2023.10.5 21:00,171,489,72,732,0
신리→연산교차로,2023.10.5 21:00,297,184,27,508,0
안락→연산교차로,2023.10.5 21:00,383,0,118,501,0
연산터널→연산교차로,2023.10.5 21:00,225,268,67,560,0
교대→연산교차로,2023.10.5 22:00,240,0,219,459,0
부산시청→연산교차로,2023.10.5 22:00,395,285,151,831,0
사직운동장→연산교차로,2023.10.5 22:00,182,476,71,729,0
신리→연산교차로,2023.10.5 22:00,242,150,17,409,0
안락→연산교차로,2023.10.5 22:00,333,0,99,432,0
연산터널→연산교차로,2023.10.5 22:00,177,233,50,460,0
교대→연산교차로,2023.10.5 23:00,175,0,201,376,0
부산시청→연산교차로,2023.10.5 23:00,320,175,121,616,0
사직운동장→연산교차로,2023.10.5 23:00,107,256,46,409,0
신리→연산교차로,2023.10.5 23:00,191,128,23,342,0
안락→연산교차로,2023.10.5 23:00,266,0,56,322,0
연산터널→연산교차로,2023.10.5 23:00,157,187,56,400,0
교대→연산교차로,2023.10.6 00:00,146,0,211,357,0
부산시청→연산교차로,2023.10.6 00:00,256,162,118,536,0
사직운동장→연산교차로,2023.10.6 00:00,79,263,44,386,0
신리→연산교차로,2023.10.6 00:00,147,95,17,259,0
안락→연산교차로,2023.10.6 00:00,211,0,53,264,0
연산터널→연산교차로,2023.10.6 00:00,140,169,49,358,0
교대→연산교차로,2023.10.6 01:00,110,0,166,276,0
부산시청→연산교차로,2023.10.6 01:00,191,136,73,400,0
사직운동장→연산교차로,2023.10.6 01:00,61,175,34,270,0
신리→연산교차로,2023.10.6 01:00,129,69,23,221,0
안락→연산교차로,2023.10.6 01:00,161,0,46,207,0
연산터널→연산교차로,2023.10.6 01:00,115,139,39,293,0
교대→연산교차로,2023.10.6 02:00,75,0,130,205,0
부산시청→연산교차로,2023.10.6 02:00,167,76,63,306,0
사직운동장→연산교차로,2023.10.6 02:00,41,159,19,219,0
신리→연산교차로,2023.10.6 02:00,96,53,15,164,0
안락→연산교차로,2023.10.6 02:00,132,0,32,164,0
연산터널→연산교차로,2023.10.6 02:00,102,112,39,253,0
교대→연산교차로,2023.10.6 03:00,68,0,102,170,0
부산시청→연산교차로,2023.10.6 03:00,158,76,52,286,0
사직운동장→연산교차로,2023.10.6 03:00,30,118,6,154,0
신리→연산교차로,2023.10.6 03:00,63,31,14,108,0
안락→연산교차로,2023.10.6 03:00,104,0,25,129,0
연산터널→연산교차로,2023.10.6 03:00,69,89,41,199,0
교대→연산교차로,2023.10.6 04:00,47,0,78,125,0
부산시청→연산교차로,2023.10.6 04:00,154,73,43,270,0
사직운동장→연산교차로,2023.10.6 04:00,39,144,7,190,0
신리→연산교차로,2023.10.6 04:00,94,62,12,168,0
안락→연산교차로,2023.10.6 04:00,168,0,35,203,0
연산터널→연산교차로,2023.10.6 04:00,66,99,33,198,0
교대→연산교차로,2023.10.6 05:00,78,0,142,220,0
부산시청→연산교차로,2023.10.6 05:00,214,164,93,471,0
사직운동장→연산교차로,2023.10.6 05:00,44,203,6,253,0
신리→연산교차로,2023.10.6 05:00,192,101,11,304,0
안락→연산교차로,2023.10.6 05:00,313,0,71,384,0
연산터널→연산교차로,2023.10.6 05:00,155,129,36,320,0
교대→연산교차로,2023.10.6 06:00,175,0,234,409,0
부산시청→연산교차로,2023.10.6 06:00,365,261,106,732,0
사직운동장→연산교차로,2023.10.6 06:00,93,255,47,395,0
신리→연산교차로,2023.10.6 06:00,338,169,22,529,0
안락→연산교차로,2023.10.6 06:00,463,0,108,571,0
연산터널→연산교차로,2023.10.6 06:00,226,238,35,499,0
교대→연산교차로,2023.10.6 07:00,255,0,392,647,0
부산시청→연산교차로,2023.10.6 07:00,566,373,202,1141,0
사직운동장→연산교차로,2023.10.6 07:00,197,511,66,774,0
신리→연산교차로,2023.10.6 07:00,471,299,30,800,0
안락→연산교차로,2023.10.6 07:00,625,0,100,725,0
연산터널→연산교차로,2023.10.6 07:00,314,357,36,707,0
교대→연산교차로,2023.10.6 08:00,313,0,521,834,0
부산시청→연산교차로,2023.10.6 08:00,581,444,341,1366,0
사직운동장→연산교차로,2023.10.6 08:00,188,650,66,904,0
신리→연산교차로,2023.10.6 08:00,501,351,18,870,0
안락→연산교차로,2023.10.6 08:00,625,0,99,724,0
연산터널→연산교차로,2023.10.6 08:00,302,391,38,731,0
교대→연산교차로,2023.10.6 09:00,294,0,507,801,0
부산시청→연산교차로,2023.10.6 09:00,518,383,277,1178,0
사직운동장→연산교차로,2023.10.6 09:00,177,597,109,883,0
신리→연산교차로,2023.10.6 09:00,444,321,43,808,0
안락→연산교차로,2023.10.6 09:00,577,0,102,679,0
연산터널→연산교차로,2023.10.6 09:00,299,367,41,707,0
교대→연산교차로,2023.10.6 10:00,275,0,439,714,0
부산시청→연산교차로,2023.10.6 10:00,566,370,279,1215,0
사직운동장→연산교차로,2023.10.6 10:00,184,542,75,801,0
신리→연산교차로,2023.10.6 10:00,402,249,59,710,0
안락→연산교차로,2023.10.6 10:00,534,0,148,682,0
연산터널→연산교차로,2023.10.6 10:00,306,324,44,674,0
교대→연산교차로,2023.10.6 11:00,280,0,468,748,0
부산시청→연산교차로,2023.10.6 11:00,597,386,247,1230,0
사직운동장→연산교차로,2023.10.6 11:00,187,585,86,858,0
신리→연산교차로,2023.10.6 11:00,439,265,60,764,0
안락→연산교차로,2023.10.6 11:00,505,0,157,662,0
연산터널→연산교차로,2023.10.6 11:00,284,315,52,651,0
교대→연산교차로,2023.10.6 12:00,319,0,382,701,0
부산시청→연산교차로,2023.10.6 12:00,580,350,238,1168,0
사직운동장→연산교차로,2023.10.6 12:00,189,570,79,838,0
신리→연산교차로,2023.10.6 12:00,425,240,57,722,0
안락→연산교차로,2023.10.6 12:00,481,0,143,624,0
연산터널→연산교차로,2023.10.6 12:00,265,285,37,587,0
교대→연산교차로,2023.10.6 13:00,332,0,433,765,0
부산시청→연산교차로,2023.10.6 13:00,614,445,285,1344,0
사직운동장→연산교차로,2023.10.6 13:00,186,587,78,851,0
신리→연산교차로,2023.10.6 13:00,466,261,60,787,0
안락→연산교차로,2023.10.6 13:00,456,0,114,570,0
연산터널→연산교차로,2023.10.6 13:00,239,254,43,536,0
교대→연산교차로,2023.10.6 14:00,348,0,485,833,0
부산시청→연산교차로,2023.10.6 14:00,600,493,282,1375,0
사직운동장→연산교차로,2023.10.6 14:00,217,631,87,935,0
신리→연산교차로,2023.10.6 14:00,452,307,62,821,0
안락→연산교차로,2023.10.6 14:00,435,0,121,556,0
연산터널→연산교차로,2023.10.6 14:00,241,287,48,576,0
교대→연산교차로,2023.10.6 15:00,348,0,517,865,0
부산시청→연산교차로,2023.10.6 15:00,627,467,309,1403,0
사직운동장→연산교차로,2023.10.6 15:00,235,618,81,934,0
신리→연산교차로,2023.10.6 15:00,487,280,55,822,0
안락→연산교차로,2023.10.6 15:00,436,0,117,553,0
연산터널→연산교차로,2023.10.6 15:00,226,293,44,563,0
교대→연산교차로,2023.10.6 16:00,363,0,491,854,0
부산시청→연산교차로,2023.10.6 16:00,612,539,338,1489,0
사직운동장→연산교차로,2023.10.6 16:00,234,694,52,980,0
신리→연산교차로,2023.10.6 16:00,495,316,58,869,0
안락→연산교차로,2023.10.6 16:00,454,0,121,575,0
연산터널→연산교차로,2023.10.6 16:00,267,285,45,597,0
교대→연산교차로,2023.10.6 17:00,372,0,524,896,0
부산시청→연산교차로,2023.10.6 17:00,663,565,345,1573,0
사직운동장→연산교차로,2023.10.6 17:00,243,705,43,991,0
신리→연산교차로,2023.10.6 17:00,508,280,61,849,0
안락→연산교차로,2023.10.6 17:00,452,0,103,555,0
연산터널→연산교차로,2023.10.6 17:00,238,287,30,555,0
교대→연산교차로,2023.10.6 18:00,360,0,555,915,0
부산시청→연산교차로,2023.10.6 18:00,584,605,326,1515,0
사직운동장→연산교차로,2023.10.6 18:00,231,681,70,982,0
신리→연산교차로,2023.10.6 18:00,524,263,46,833,0
안락→연산교차로,2023.10.6 18:00,445,0,115,560,0
연산터널→연산교차로,2023.10.6 18:00,216,284,37,537,0
교대→연산교차로,2023.10.6 19:00,344,0,421,765,0
부산시청→연산교차로,2023.10.6 19:00,555,433,292,1280,0
사직운동장→연산교차로,2023.10.6 19:00,196,565,77,838,0
신리→연산교차로,2023.10.6 19:00,410,214,32,656,0
안락→연산교차로,2023.10.6 19:00,431,0,96,527,0
연산터널→연산교차로,2023.10.6 19:00,200,260,68,528,0
교대→연산교차로,2023.10.6 20:00,327,0,421,748,0
부산시청→연산교차로,2023.10.6 20:00,485,367,237,1089,0
사직운동장→연산교차로,2023.10.6 20:00,184,534,67,785,0
신리→연산교차로,2023.10.6 20:00,349,200,26,575,0
안락→연산교차로,2023.10.6 20:00,428,0,100,528,0
연산터널→연산교차로,2023.10.6 20:00,213,276,69,558,0
교대→연산교차로,2023.10.6 21:00,298,0,337,635,0
부산시청→연산교차로,2023.10.6 21:00,461,306,189,956,0
사직운동장→연산교차로,2023.10.6 21:00,175,502,85,762,0
신리→연산교차로,2023.10.6 21:00,291,204,33,528,0
안락→연산교차로,2023.10.6 21:00,425,0,94,519,0
연산터널→연산교차로,2023.10.6 21:00,228,288,68,584,0
교대→연산교차로,2023.10.6 22:00,253,0,279,532,0
부산시청→연산교차로,2023.10.6 22:00,449,290,187,926,0
사직운동장→연산교차로,2023.10.6 22:00,147,438,75,660,0
신리→연산교차로,2023.10.6 22:00,311,174,34,519,0
안락→연산교차로,2023.10.6 22:00,374,0,105,479,0
연산터널→연산교차로,2023.10.6 22:00,208,269,77,554,0
교대→연산교차로,2023.10.6 23:00,204,0,237,441,0
부산시청→연산교차로,2023.10.6 23:00,373,209,138,720,0
사직운동장→연산교차로,2023.10.6 23:00,120,353,83,556,0
신리→연산교차로,2023.10.6 23:00,242,134,18,394,0
안락→연산교차로,2023.10.6 23:00,326,0,81,407,0
연산터널→연산교차로,2023.10.6 23:00,186,241,71,498,0
교대→연산교차로,2023.10.7 00:00,193,0,252,445,0
부산시청→연산교차로,2023.10.7 00:00,336,217,125,678,0
사직운동장→연산교차로,2023.10.7 00:00,87,288,59,434,0
신리→연산교차로,2023.10.7 00:00,235,121,25,381,0
안락→연산교차로,2023.10.7 00:00,256,0,89,345,0
연산터널→연산교차로,2023.10.7 00:00,134,213,78,425,0
교대→연산교차로,2023.10.7 01:00,135,0,242,377,0
부산시청→연산교차로,2023.10.7 01:00,233,183,106,522,0
사직운동장→연산교차로,2023.10.7 01:00,58,231,61,350,0
신리→연산교차로,2023.10.7 01:00,165,94,21,280,0
안락→연산교차로,2023.10.7 01:00,212,0,54,266,0
연산터널→연산교차로,2023.10.7 01:00,129,223,74,426,0
교대→연산교차로,2023.10.7 02:00,115,0,175,290,0
부산시청→연산교차로,2023.10.7 02:00,225,121,71,417,0
사직운동장→연산교차로,2023.10.7 02:00,61,240,24,325,0
신리→연산교차로,2023.10.7 02:00,137,63,13,213,0
안락→연산교차로,2023.10.7 02:00,182,0,31,213,0
연산터널→연산교차로,2023.10.7 02:00,125,163,27,315,0
교대→연산교차로,2023.10.7 03:00,94,0,173,267,0
부산시청→연산교차로,2023.10.7 03:00,208,114,57,379,0
사직운동장→연산교차로,2023.10.7 03:00,44,157,17,218,0
신리→연산교차로,2023.10.7 03:00,103,57,16,176,0
안락→연산교차로,2023.10.7 03:00,141,0,34,175,0
연산터널→연산교차로,2023.10.7 03:00,97,138,54,289,0
교대→연산교차로,2023.10.7 04:00,70,0,120,190,0
부산시청→연산교차로,2023.10.7 04:00,166,106,64,336,0
사직운동장→연산교차로,2023.10.7 04:00,39,138,10,187,0
신리→연산교차로,2023.10.7 04:00,110,44,10,164,0
안락→연산교차로,2023.10.7 04:00,166,0,43,209,0
연산터널→연산교차로,2023.10.7 04:00,95,128,43,266,0
교대→연산교차로,2023.10.7 05:00,102,0,141,243,0
부산시청→연산교차로,2023.10.7 05:00,220,184,84,488,0
사직운동장→연산교차로,2023.10.7 05:00,44,177,10,231,0
신리→연산교차로,2023.10.7 05:00,198,89,11,298,0
안락→연산교차로,2023.10.7 05:00,296,0,45,341,0
연산터널→연산교차로,2023.10.7 05:00,107,160,25,292,0
교대→연산교차로,2023.10.7 06:00,163,0,185,348,0
부산시청→연산교차로,2023.10.7 06:00,340,268,87,695,0
사직운동장→연산교차로,2023.10.7 06:00,74,236,39,349,0
신리→연산교차로,2023.10.7 06:00,280,141,24,445,0
안락→연산교차로,2023.10.7 06:00,417,0,80,497,0
연산터널→연산교차로,2023.10.7 06:00,202,165,33,400,0
교대→연산교차로,2023.10.7 07:00,189,0,219,408,0
부산시청→연산교차로,2023.10.7 07:00,386,254,137,777,0
사직운동장→연산교차로,2023.10.7 07:00,118,352,52,522,0
신리→연산교차로,2023.10.7 07:00,320,141,24,485,0
안락→연산교차로,2023.10.7 07:00,447,0,90,537,0
연산터널→연산교차로,2023.10.7 07:00,213,190,46,449,0
교대→연산교차로,2023.10.7 08:00,251,0,338,589,0
부산시청→연산교차로,2023.10.7 08:00,495,343,243,1081,0
사직운동장→연산교차로,2023.10.7 08:00,183,495,59,737,0
신리→연산교차로,2023.10.7 08:00,440,238,52,730,0
안락→연산교차로,2023.10.7 08:00,520,0,109,629,0
연산터널→연산교차로,2023.10.7 08:00,280,265,49,594,0
교대→연산교차로,2023.10.7 09:00,286,0,382,668,0
부산시청→연산교차로,2023.10.7 09:00,554,352,244,1150,0
사직운동장→연산교차로,2023.10.7 09:00,173,578,69,820,0
신리→연산교차로,2023.10.7 09:00,497,291,59,847,0
안락→연산교차로,2023.10.7 09:00,588,0,132,720,0
연산터널→연산교차로,2023.10.7 09:00,285,345,49,679,0
교대→연산교차로,2023.10.7 10:00,285,0,427,712,0
부산시청→연산교차로,2023.10.7 10:00,613,376,235,1224,0
사직운동장→연산교차로,2023.10.7 10:00,191,600,76,867,0
신리→연산교차로,2023.10.7 10:00,503,300,79,882,0
안락→연산교차로,2023.10.7 10:00,579,0,134,713,0
연산터널→연산교차로,2023.10.7 10:00,318,351,58,727,0
교대→연산교차로,2023.10.7 11:00,294,0,478,772,0
부산시청→연산교차로,2023.10.7 11:00,640,381,272,1293,0
사직운동장→연산교차로,2023.10.7 11:00,185,607,86,878,0
신리→연산교차로,2023.10.7 11:00,495,299,71,865,0
안락→연산교차로,2023.10.7 11:00,574,0,136,710,0
연산터널→연산교차로,2023.10.7 11:00,292,363,59,714,0
교대→연산교차로,2023.10.7 12:00,281,0,424,705,0
부산시청→연산교차로,2023.10.7 12:00,612,355,217,1184,0
사직운동장→연산교차로,2023.10.7 12:00,181,544,56,781,0
신리→연산교차로,2023.10.7 12:00,476,269,57,802,0
안락→연산교차로,2023.10.7 12:00,529,0,146,675,0
연산터널→연산교차로,2023.10.7 12:00,267,295,51,613,0
교대→연산교차로,2023.10.7 13:00,350,0,549,899,0
부산시청→연산교차로,2023.10.7 13:00,616,505,328,1449,0
사직운동장→연산교차로,2023.10.7 13:00,179,677,69,925,0
신리→연산교차로,2023.10.7 13:00,524,278,50,852,0
안락→연산교차로,2023.10.7 13:00,464,0,116,580,0
연산터널→연산교차로,2023.10.7 13:00,235,292,55,582,0
교대→연산교차로,2023.10.7 14:00,352,0,423,775,0
부산시청→연산교차로,2023.10.7 14:00,628,443,291,1362,0
사직운동장→연산교차로,2023.10.7 14:00,189,607,85,881,0
신리→연산교차로,2023.10.7 14:00,476,261,60,797,0
안락→연산교차로,2023.10.7 14:00,455,0,118,573,0
연산터널→연산교차로,2023.10.7 14:00,222,281,44,547,0
교대→연산교차로,2023.10.7 15:00,341,0,425,766,0
부산시청→연산교차로,2023.10.7 15:00,646,492,328,1466,0
사직운동장→연산교차로,2023.10.7 15:00,191,609,70,870,0
신리→연산교차로,2023.10.7 15:00,467,240,55,762,0
안락→연산교차로,2023.10.7 15:00,435,0,115,550,0
연산터널→연산교차로,2023.10.7 15:00,226,298,35,559,0
교대→연산교차로,2023.10.7 16:00,342,0,414,756,0
부산시청→연산교차로,2023.10.7 16:00,648,480,286,1414,0
사직운동장→연산교차로,2023.10.7 16:00,190,598,63,851,0
신리→연산교차로,2023.10.7 16:00,452,235,38,725,0
안락→연산교차로,2023.10.7 16:00,456,0,97,553,0
연산터널→연산교차로,2023.10.7 16:00,234,269,47,550,0
교대→연산교차로,2023.10.7 17:00,340,0,408,748,0
부산시청→연산교차로,2023.10.7 17:00,601,459,273,1333,0
사직운동장→연산교차로,2023.10.7 17:00,188,560,69,817,0
신리→연산교차로,2023.10.7 17:00,424,236,51,711,0
안락→연산교차로,2023.10.7 17:00,461,0,117,578,0
연산터널→연산교차로,2023.10.7 17:00,233,273,49,555,0
교대→연산교차로,2023.10.7 18:00,348,0,448,796,0
부산시청→연산교차로,2023.10.7 18:00,569,397,266,1232,0
사직운동장→연산교차로,2023.10.7 18:00,203,540,56,799,0
신리→연산교차로,2023.10.7 18:00,385,224,44,653,0
안락→연산교차로,2023.10.7 18:00,435,0,103,538,0
연산터널→연산교차로,2023.10.7 18:00,214,267,49,530,0
교대→연산교차로,2023.10.7 19:00,296,0,351,647,0
부산시청→연산교차로,2023.10.7 19:00,473,350,210,1033,0
사직운동장→연산교차로,2023.10.7 19:00,165,473,76,714,0
신리→연산교차로,2023.10.7 19:00,355,242,20,617,0
안락→연산교차로,2023.10.7 19:00,396,0,85,481,0
연산터널→연산교차로,2023.10.7 19:00,243,244,61,548,0
교대→연산교차로,2023.10.7 20:00,279,0,282,561,0
부산시청→연산교차로,2023.10.7 20:00,442,331,199,972,0
사직운동장→연산교차로,2023.10.7 20:00,144,412,60,616,0
신리→연산교차로,2023.10.7 20:00,309,214,32,555,0
안락→연산교차로,2023.10.7 20:00,375,0,85,460,0
연산터널→연산교차로,2023.10.7 20:00,217,242,48,507,0
교대→연산교차로,2023.10.7 21:00,248,0,271,519,0
부산시청→연산교차로,2023.10.7 21:00,434,259,153,846,0
사직운동장→연산교차로,2023.10.7 21:00,137,348,79,564,0
신리→연산교차로,2023.10.7 21:00,261,181,32,474,0
안락→연산교차로,2023.10.7 21:00,314,0,88,402,0
연산터널→연산교차로,2023.10.7 21:00,192,248,51,491,0
교대→연산교차로,2023.10.7 22:00,200,0,203,403,0
부산시청→연산교차로,2023.10.7 22:00,352,207,143,702,0
사직운동장→연산교차로,2023.10.7 22:00,101,311,65,477,0
신리→연산교차로,2023.10.7 22:00,240,136,24,400,0
안락→연산교차로,2023.10.7 22:00,252,0,79,331,0
연산터널→연산교차로,2023.10.7 22:00,172,200,58,430,0
교대→연산교차로,2023.10.7 23:00,192,0,200,392,0
부산시청→연산교차로,2023.10.7 23:00,356,224,112,692,0
사직운동장→연산교차로,2023.10.7 23:00,107,272,58,437,0
신리→연산교차로,2023.10.7 23:00,252,136,17,405,0
안락→연산교차로,2023.10.7 23:00,299,0,73,372,0
연산터널→연산교차로,2023.10.7 23:00,152,207,57,416,0
교대→연산교차로,2023.10.8 00:00,159,0,214,373,1
부산시청→연산교차로,2023.10.8 00:00,303,205,119,627,1
사직운동장→연산교차로,2023.10.8 00:00,74,244,41,359,1
신리→연산교차로,2023.10.8 00:00,197,116,19,332,1
안락→연산교차로,2023.10.8 00:00,259,0,63,322,1
연산터널→연산교차로,2023.10.8 00:00,129,177,49,355,1
교대→연산교차로,2023.10.8 01:00,109,0,230,339,1
부산시청→연산교차로,2023.10.8 01:00,225,132,72,429,1
사직운동장→연산교차로,2023.10.8 01:00,70,178,38,286,1
신리→연산교차로,2023.10.8 01:00,127,102,24,253,1
안락→연산교차로,2023.10.8 01:00,192,0,51,243,1
연산터널→연산교차로,2023.10.8 01:00,121,157,51,329,1
교대→연산교차로,2023.10.8 02:00,106,0,168,274,1
부산시청→연산교차로,2023.10.8 02:00,189,105,79,373,1
사직운동장→연산교차로,2023.10.8 02:00,48,125,27,200,1
신리→연산교차로,2023.10.8 02:00,129,66,11,206,1
안락→연산교차로,2023.10.8 02:00,156,0,38,194,1
연산터널→연산교차로,2023.10.8 02:00,115,159,34,308,1
교대→연산교차로,2023.10.8 03:00,77,0,172,249,1
부산시청→연산교차로,2023.10.8 03:00,175,108,70,353,1
사직운동장→연산교차로,2023.10.8 03:00,48,120,14,182,1
신리→연산교차로,2023.10.8 03:00,79,54,12,145,1
안락→연산교차로,2023.10.8 03:00,122,0,31,153,1
연산터널→연산교차로,2023.10.8 03:00,89,111,38,238,1
교대→연산교차로,2023.10.8 04:00,70,0,117,187,1
부산시청→연산교차로,2023.10.8 04:00,129,93,43,265,1
사직운동장→연산교차로,2023.10.8 04:00,33,126,8,167,1
신리→연산교차로,2023.10.8 04:00,70,57,4,131,1
안락→연산교차로,2023.10.8 04:00,132,0,33,165,1
연산터널→연산교차로,2023.10.8 04:00,77,101,19,197,1
교대→연산교차로,2023.10.8 05:00,61,0,99,160,1
부산시청→연산교차로,2023.10.8 05:00,144,113,41,298,1
사직운동장→연산교차로,2023.10.8 05:00,30,117,4,151,1
신리→연산교차로,2023.10.8 05:00,132,66,5,203,1
안락→연산교차로,2023.10.8 05:00,160,0,31,191,1
연산터널→연산교차로,2023.10.8 05:00,75,83,19,177,1
교대→연산교차로,2023.10.8 06:00,105,0,117,222,1
부산시청→연산교차로,2023.10.8 06:00,191,164,62,417,1
사직운동장→연산교차로,2023.10.8 06:00,49,146,31,226,1
신리→연산교차로,2023.10.8 06:00,168,94,7,269,1
안락→연산교차로,2023.10.8 06:00,224,0,62,286,1
연산터널→연산교차로,2023.10.8 06:00,117,114,27,258,1
교대→연산교차로,2023.10.8 07:00,128,0,137,265,1
부산시청→연산교차로,2023.10.8 07:00,255,182,73,510,1
사직운동장→연산교차로,2023.10.8 07:00,78,183,40,301,1
신리→연산교차로,2023.10.8 07:00,203,93,21,317,1
안락→연산교차로,2023.10.8 07:00,242,0,69,311,1
연산터널→연산교차로,2023.10.8 07:00,122,122,36,280,1
교대→연산교차로,2023.10.8 08:00,164,0,190,354,1
부산시청→연산교차로,2023.10.8 08:00,270,206,111,587,1
사직운동장→연산교차로,2023.10.8 08:00,113,319,53,485,1
신리→연산교차로,2023.10.8 08:00,287,118,19,424,1
안락→연산교차로,2023.10.8 08:00,323,0,70,393,1
연산터널→연산교차로,2023.10.8 08:00,154,152,27,333,1
교대→연산교차로,2023.10.8 09:00,220,0,212,432,1
부산시청→연산교차로,2023.10.8 09:00,365,292,138,795,1
사직운동장→연산교차로,2023.10.8 09:00,125,370,32,527,1
신리→연산교차로,2023.10.8 09:00,424,228,29,681,1
안락→연산교차로,2023.10.8 09:00,416,0,91,507,1
연산터널→연산교차로,2023.10.8 09:00,240,193,35,468,1
교대→연산교차로,2023.10.8 10:00,248,0,284,532,1
부산시청→연산교차로,2023.10.8 10:00,404,304,169,877,1
사직운동장→연산교차로,2023.10.8 10:00,169,475,64,708,1
신리→연산교차로,2023.10.8 10:00,433,231,38,702,1
안락→연산교차로,2023.10.8 10:00,466,0,128,594,1
연산터널→연산교차로,2023.10.8 10:00,241,228,43,512,1
교대→연산교차로,2023.10.8 11:00,256,0,336,592,1
부산시청→연산교차로,2023.10.8 11:00,484,352,172,1008,1
사직운동장→연산교차로,2023.10.8 11:00,162,462,77,701,1
신리→연산교차로,2023.10.8 11:00,445,195,40,680,1
안락→연산교차로,2023.10.8 11:00,471,0,147,618,1
연산터널→연산교차로,2023.10.8 11:00,230,261,47,538,1
교대→연산교차로,2023.10.8 12:00,287,0,373,660,1
부산시청→연산교차로,2023.10.8 12:00,508,337,199,1044,1
사직운동장→연산교차로,2023.10.8 12:00,175,526,88,789,1
신리→연산교차로,2023.10.8 12:00,423,224,41,688,1
안락→연산교차로,2023.10.8 12:00,476,0,138,614,1
연산터널→연산교차로,2023.10.8 12:00,244,253,63,560,1
교대→연산교차로,2023.10.8 13:00,299,0,384,683,1
부산시청→연산교차로,2023.10.8 13:00,529,351,196,1076,1
사직운동장→연산교차로,2023.10.8 13:00,190,496,73,759,1
신리→연산교차로,2023.10.8 13:00,430,218,53,701,1
안락→연산교차로,2023.10.8 13:00,549,0,129,678,1
연산터널→연산교차로,2023.10.8 13:00,264,250,57,571,1
교대→연산교차로,2023.10.8 14:00,283,0,362,645,1
부산시청→연산교차로,2023.10.8 14:00,538,378,212,1128,1
사직운동장→연산교차로,2023.10.8 14:00,190,536,75,801,1
신리→연산교차로,2023.10.8 14:00,440,213,55,708,1
안락→연산교차로,2023.10.8 14:00,527,0,119,646,1
연산터널→연산교차로,2023.10.8 14:00,257,272,50,579,1
교대→연산교차로,2023.10.8 15:00,269,0,312,581,1
부산시청→연산교차로,2023.10.8 15:00,503,336,242,1081,1
사직운동장→연산교차로,2023.10.8 15:00,176,509,61,746,1
신리→연산교차로,2023.10.8 15:00,416,194,37,647,1
안락→연산교차로,2023.10.8 15:00,499,0,146,645,1
연산터널→연산교차로,2023.10.8 15:00,235,220,39,494,1
교대→연산교차로,2023.10.8 16:00,280,0,325,605,1
부산시청→연산교차로,2023.10.8 16:00,549,370,211,1130,1
사직운동장→연산교차로,2023.10.8 16:00,171,482,50,703,1
신리→연산교차로,2023.10.8 16:00,398,257,42,697,1
안락→연산교차로,2023.10.8 16:00,530,0,136,666,1
연산터널→연산교차로,2023.10.8 16:00,256,253,43,552,1
교대→연산교차로,2023.10.8 17:00,285,0,342,627,1
부산시청→연산교차로,2023.10.8 17:00,503,371,196,1070,1
사직운동장→연산교차로,2023.10.8 17:00,198,518,49,765,1
신리→연산교차로,2023.10.8 17:00,407,210,32,649,1
안락→연산교차로,2023.10.8 17:00,501,0,133,634,1
연산터널→연산교차로,2023.10.8 17:00,219,246,42,507,1
교대→연산교차로,2023.10.8 18:00,279,0,273,552,1
부산시청→연산교차로,2023.10.8 18:00,474,303,172,949,1
사직운동장→연산교차로,2023.10.8 18:00,172,439,61,672,1
신리→연산교차로,2023.10.8 18:00,320,180,33,533,1
안락→연산교차로,2023.10.8 18:00,489,0,140,629,1
연산터널→연산교차로,2023.10.8 18:00,189,239,67,495,1
교대→연산교차로,2023.10.8 19:00,239,0,252,491,1
부산시청→연산교차로,2023.10.8 19:00,416,255,165,836,1
사직운동장→연산교차로,2023.10.8 19:00,168,398,69,635,1
신리→연산교차로,2023.10.8 19:00,319,196,34,549,1
안락→연산교차로,2023.10.8 19:00,390,0,130,520,1
연산터널→연산교차로,2023.10.8 19:00,170,230,51,451,1
교대→연산교차로,2023.10.8 20:00,239,0,260,499,1
부산시청→연산교차로,2023.10.8 20:00,436,252,170,858,1
사직운동장→연산교차로,2023.10.8 20:00,134,383,59,576,1
신리→연산교차로,2023.10.8 20:00,273,153,30,456,1
안락→연산교차로,2023.10.8 20:00,373,0,103,476,1
연산터널→연산교차로,2023.10.8 20:00,185,223,42,450,1
교대→연산교차로,2023.10.8 21:00,246,0,237,483,1
부산시청→연산교차로,2023.10.8 21:00,391,229,125,745,1
사직운동장→연산교차로,2023.10.8 21:00,109,334,62,505,1
신리→연산교차로,2023.10.8 21:00,250,159,23,432,1
안락→연산교차로,2023.10.8 21:00,330,0,85,415,1
연산터널→연산교차로,2023.10.8 21:00,188,213,61,462,1
교대→연산교차로,2023.10.8 22:00,218,0,200,418,1
부산시청→연산교차로,2023.10.8 22:00,332,225,132,689,1
사직운동장→연산교차로,2023.10.8 22:00,106,279,69,454,1
신리→연산교차로,2023.10.8 22:00,214,148,19,381,1
안락→연산교차로,2023.10.8 22:00,312,0,83,395,1
연산터널→연산교차로,2023.10.8 22:00,138,198,47,383,1
교대→연산교차로,2023.10.8 23:00,151,0,177,328,1
부산시청→연산교차로,2023.10.8 23:00,292,175,109,576,1
사직운동장→연산교차로,2023.10.8 23:00,76,238,50,364,1
신리→연산교차로,2023.10.8 23:00,180,113,23,316,1
안락→연산교차로,2023.10.8 23:00,227,0,53,280,1
연산터널→연산교차로,2023.10.8 23:00,134,179,58,371,1
교대→연산교차로,2023.10.9 00:00,164,0,205,369,1
부산시청→연산교차로,2023.10.9 00:00,253,170,105,528,1
사직운동장→연산교차로,2023.10.9 00:00,72,194,41,307,1
신리→연산교차로,2023.10.9 00:00,180,107,19,306,1
안락→연산교차로,2023.10.9 00:00,193,0,51,244,1
연산터널→연산교차로,2023.10.9 00:00,130,174,64,368,1
교대→연산교차로,2023.10.9 01:00,103,0,166,269,1
부산시청→연산교차로,2023.10.9 01:00,220,171,92,483,1
사직운동장→연산교차로,2023.10.9 01:00,41,151,32,224,1
신리→연산교차로,2023.10.9 01:00,131,62,16,209,1
안락→연산교차로,2023.10.9 01:00,186,0,43,229,1
연산터널→연산교차로,2023.10.9 01:00,106,147,41,294,1
교대→연산교차로,2023.10.9 02:00,82,0,144,226,1
부산시청→연산교차로,2023.10.9 02:00,186,102,68,356,1
사직운동장→연산교차로,2023.10.9 02:00,30,120,22,172,1
신리→연산교차로,2023.10.9 02:00,83,58,15,156,1
안락→연산교차로,2023.10.9 02:00,164,0,35,199,1
연산터널→연산교차로,2023.10.9 02:00,72,130,42,244,1
교대→연산교차로,2023.10.9 03:00,67,0,142,209,1
부산시청→연산교차로,2023.10.9 03:00,169,83,65,317,1
사직운동장→연산교차로,2023.10.9 03:00,39,133,14,186,1
신리→연산교차로,2023.10.9 03:00,71,37,4,112,1
안락→연산교차로,2023.10.9 03:00,129,0,36,165,1
연산터널→연산교차로,2023.10.9 03:00,77,110,28,215,1
교대→연산교차로,2023.10.9 04:00,65,0,95,160,1
부산시청→연산교차로,2023.10.9 04:00,180,94,60,334,1
사직운동장→연산교차로,2023.10.9 04:00,26,94,8,128,1
신리→연산교차로,2023.10.9 04:00,86,52,13,151,1
안락→연산교차로,2023.10.9 04:00,174,0,43,217,1
연산터널→연산교차로,2023.10.9 04:00,82,102,27,211,1
교대→연산교차로,2023.10.9 05:00,79,0,121,200,1
부산시청→연산교차로,2023.10.9 05:00,206,139,56,401,1
사직운동장→연산교차로,2023.10.9 05:00,45,150,5,200,1
신리→연산교차로,2023.10.9 05:00,159,68,9,236,1
안락→연산교차로,2023.10.9 05:00,258,0,40,298,1
연산터널→연산교차로,2023.10.9 05:00,98,123,15,236,1
교대→연산교차로,2023.10.9 06:00,167,0,165,332,1
부산시청→연산교차로,2023.10.9 06:00,295,226,96,617,1
사직운동장→연산교차로,2023.10.9 06:00,68,213,50,331,1
신리→연산교차로,2023.10.9 06:00,257,132,19,408,1
안락→연산교차로,2023.10.9 06:00,378,0,83,461,1
연산터널→연산교차로,2023.10.9 06:00,193,153,26,372,1
교대→연산교차로,2023.10.9 07:00,142,0,168,310,1
부산시청→연산교차로,2023.10.9 07:00,345,173,126,644,1
사직운동장→연산교차로,2023.10.9 07:00,83,297,61,441,1
신리→연산교차로,2023.10.9 07:00,264,145,25,434,1
안락→연산교차로,2023.10.9 07:00,366,0,81,447,1
연산터널→연산교차로,2023.10.9 07:00,175,167,32,374,1
교대→연산교차로,2023.10.9 08:00,173,0,217,390,1
부산시청→연산교차로,2023.10.9 08:00,343,240,228,811,1
사직운동장→연산교차로,2023.10.9 08:00,109,320,53,482,1
신리→연산교차로,2023.10.9 08:00,281,151,41,473,1
안락→연산교차로,2023.10.9 08:00,405,0,83,488,1
연산터널→연산교차로,2023.10.9 08:00,200,190,37,427,1
교대→연산교차로,2023.10.9 09:00,207,0,240,447,1
부산시청→연산교차로,2023.10.9 09:00,423,266,205,894,1
사직운동장→연산교차로,2023.10.9 09:00,120,431,63,614,1
신리→연산교차로,2023.10.9 09:00,375,187,41,603,1
안락→연산교차로,2023.10.9 09:00,450,0,116,566,1
연산터널→연산교차로,2023.10.9 09:00,238,247,37,522,1
교대→연산교차로,2023.10.9 10:00,238,0,269,507,1
부산시청→연산교차로,2023.10.9 10:00,497,325,236,1058,1
사직운동장→연산교차로,2023.10.9 10:00,163,515,68,746,1
신리→연산교차로,2023.10.9 10:00,404,233,45,682,1
안락→연산교차로,2023.10.9 10:00,466,0,121,587,1
연산터널→연산교차로,2023.10.9 10:00,236,256,31,523,1
교대→연산교차로,2023.10.9 11:00,234,0,284,518,1
부산시청→연산교차로,2023.10.9 11:00,561,348,299,1208,1
사직운동장→연산교차로,2023.10.9 11:00,157,500,52,709,1
신리→연산교차로,2023.10.9 11:00,417,203,32,652,1
안락→연산교차로,2023.10.9 11:00,497,0,145,642,1
연산터널→연산교차로,2023.10.9 11:00,257,275,30,562,1
교대→연산교차로,2023.10.9 12:00,266,0,269,535,1
부산시청→연산교차로,2023.10.9 12:00,532,357,305,1194,1
사직운동장→연산교차로,2023.10.9 12:00,180,507,51,738,1
신리→연산교차로,2023.10.9 12:00,456,221,53,730,1
안락→연산교차로,2023.10.9 12:00,483,0,142,625,1
연산터널→연산교차로,2023.10.9 12:00,265,255,40,560,1
교대→연산교차로,2023.10.9 13:00,269,0,311,580,1
부산시청→연산교차로,2023.10.9 13:00,558,360,316,1234,1
사직운동장→연산교차로,2023.10.9 13:00,230,514,54,798,1
신리→연산교차로,2023.10.9 13:00,400,214,44,658,1
안락→연산교차로,2023.10.9 13:00,515,0,181,696,1
연산터널→연산교차로,2023.10.9 13:00,266,291,43,600,1
교대→연산교차로,2023.10.9 14:00,283,0,348,631,1
부산시청→연산교차로,2023.10.9 14:00,561,353,317,1231,1
사직운동장→연산교차로,2023.10.9 14:00,180,550,62,792,1
신리→연산교차로,2023.10.9 14:00,401,196,46,643,1
안락→연산교차로,2023.10.9 14:00,508,0,155,663,1
연산터널→연산교차로,2023.10.9 14:00,238,268,38,544,1
교대→연산교차로,2023.10.9 15:00,313,0,336,649,1
부산시청→연산교차로,2023.10.9 15:00,563,366,264,1193,1
사직운동장→연산교차로,2023.10.9 15:00,188,574,57,819,1
신리→연산교차로,2023.10.9 15:00,437,189,59,685,1
안락→연산교차로,2023.10.9 15:00,484,0,151,635,1
연산터널→연산교차로,2023.10.9 15:00,254,245,51,550,1
교대→연산교차로,2023.10.9 16:00,295,0,362,657,1
부산시청→연산교차로,2023.10.9 16:00,580,387,276,1243,1
사직운동장→연산교차로,2023.10.9 16:00,191,600,67,858,1
신리→연산교차로,2023.10.9 16:00,431,195,38,664,1
안락→연산교차로,2023.10.9 16:00,510,0,154,664,1
연산터널→연산교차로,2023.10.9 16:00,250,283,53,586,1
교대→연산교차로,2023.10.9 17:00,307,0,334,641,1
부산시청→연산교차로,2023.10.9 17:00,584,383,249,1216,1
사직운동장→연산교차로,2023.10.9 17:00,191,578,43,812,1
신리→연산교차로,2023.10.9 17:00,378,218,33,629,1
안락→연산교차로,2023.10.9 17:00,525,0,130,655,1
연산터널→연산교차로,2023.10.9 17:00,234,277,49,560,1
교대→연산교차로,2023.10.9 18:00,297,0,355,652,1
부산시청→연산교차로,2023.10.9 18:00,490,325,219,1034,1
사직운동장→연산교차로,2023.10.9 18:00,197,516,64,777,1
신리→연산교차로,2023.10.9 18:00,358,211,28,597,1
안락→연산교차로,2023.10.9 18:00,520,0,131,651,1
연산터널→연산교차로,2023.10.9 18:00,215,231,58,504,1
교대→연산교차로,2023.10.9 19:00,272,0,301,573,1
부산시청→연산교차로,2023.10.9 19:00,436,298,184,918,1
사직운동장→연산교차로,2023.10.9 19:00,134,456,60,650,1
신리→연산교차로,2023.10.9 19:00,298,182,31,511,1
안락→연산교차로,2023.10.9 19:00,369,0,121,490,1
연산터널→연산교차로,2023.10.9 19:00,200,243,50,493,1
교대→연산교차로,2023.10.9 20:00,242,0,271,513,1
부산시청→연산교차로,2023.10.9 20:00,411,268,159,838,1
사직운동장→연산교차로,2023.10.9 20:00,143,360,59,562,1
신리→연산교차로,2023.10.9 20:00,319,163,32,514,1
안락→연산교차로,2023.10.9 20:00,365,0,111,476,1
연산터널→연산교차로,2023.10.9 20:00,193,200,52,445,1
교대→연산교차로,2023.10.9 21:00,222,0,229,451,1
부산시청→연산교차로,2023.10.9 21:00,384,261,163,808,1
사직운동장→연산교차로,2023.10.9 21:00,122,329,81,532,1
신리→연산교차로,2023.10.9 21:00,260,163,28,451,1
안락→연산교차로,2023.10.9 21:00,305,0,81,386,1
연산터널→연산교차로,2023.10.9 21:00,179,189,49,417,1
교대→연산교차로,2023.10.9 22:00,202,0,184,386,1
부산시청→연산교차로,2023.10.9 22:00,313,193,130,636,1
사직운동장→연산교차로,2023.10.9 22:00,108,277,59,444,1
신리→연산교차로,2023.10.9 22:00,191,122,19,332,1
안락→연산교차로,2023.10.9 22:00,271,0,73,344,1
연산터널→연산교차로,2023.10.9 22:00,147,185,58,390,1
교대→연산교차로,2023.10.9 23:00,132,0,205,337,1
부산시청→연산교차로,2023.10.9 23:00,267,162,97,526,1
사직운동장→연산교차로,2023.10.9 23:00,59,227,72,358,1
신리→연산교차로,2023.10.9 23:00,149,102,28,279,1
안락→연산교차로,2023.10.9 23:00,198,0,41,239,1
연산터널→연산교차로,2023.10.9 23:00,135,159,74,368,1
교대→연산교차로,2023.10.10 00:00,110,0,158,268,0
부산시청→연산교차로,2023.10.10 00:00,179,108,94,381,0
사직운동장→연산교차로,2023.10.10 00:00,58,179,24,261,0
신리→연산교차로,2023.10.10 00:00,135,62,15,212,0
안락→연산교차로,2023.10.10 00:00,173,0,31,204,0
연산터널→연산교차로,2023.10.10 00:00,113,125,65,303,0
교대→연산교차로,2023.10.10 01:00,86,0,129,215,0
부산시청→연산교차로,2023.10.10 01:00,163,82,65,310,0
사직운동장→연산교차로,2023.10.10 01:00,50,149,30,229,0
신리→연산교차로,2023.10.10 01:00,96,50,14,160,0
안락→연산교차로,2023.10.10 01:00,131,0,34,165,0
연산터널→연산교차로,2023.10.10 01:00,82,108,40,230,0
교대→연산교차로,2023.10.10 02:00,54,0,99,153,0
부산시청→연산교차로,2023.10.10 02:00,125,80,58,263,0
사직운동장→연산교차로,2023.10.10 02:00,33,113,7,153,0
신리→연산교차로,2023.10.10 02:00,70,34,8,112,0
안락→연산교차로,2023.10.10 02:00,109,0,28,137,0
연산터널→연산교차로,2023.10.10 02:00,72,103,49,224,0
교대→연산교차로,2023.10.10 03:00,49,0,92,141,0
부산시청→연산교차로,2023.10.10 03:00,152,62,51,265,0
사직운동장→연산교차로,2023.10.10 03:00,35,121,4,160,0
신리→연산교차로,2023.10.10 03:00,59,42,3,104,0
안락→연산교차로,2023.10.10 03:00,94,0,24,118,0
연산터널→연산교차로,2023.10.10 03:00,56,73,47,176,0
교대→연산교차로,2023.10.10 04:00,49,0,55,104,0
부산시청→연산교차로,2023.10.10 04:00,130,66,41,237,0
사직운동장→연산교차로,2023.10.10 04:00,30,86,9,125,0
신리→연산교차로,2023.10.10 04:00,84,50,9,143,0
안락→연산교차로,2023.10.10 04:00,160,0,29,189,0
연산터널→연산교차로,2023.10.10 04:00,66,70,15,151,0
교대→연산교차로,2023.10.10 05:00,79,0,132,211,0
부산시청→연산교차로,2023.10.10 05:00,248,178,72,498,0
사직운동장→연산교차로,2023.10.10 05:00,48,173,6,227,0
신리→연산교차로,2023.10.10 05:00,217,97,8,322,0
안락→연산교차로,2023.10.10 05:00,317,0,42,359,0
연산터널→연산교차로,2023.10.10 05:00,139,127,11,277,0
교대→연산교차로,2023.10.10 06:00,173,0,234,407,0
부산시청→연산교차로,2023.10.10 06:00,393,270,132,795,0
사직운동장→연산교차로,2023.10.10 06:00,73,283,54,410,0
신리→연산교차로,2023.10.10 06:00,359,190,28,577,0
안락→연산교차로,2023.10.10 06:00,489,0,98,587,0
연산터널→연산교차로,2023.10.10 06:00,245,249,41,535,0
교대→연산교차로,2023.10.10 07:00,265,0,394,659,0
부산시청→연산교차로,2023.10.10 07:00,582,392,247,1221,0
사직운동장→연산교차로,2023.10.10 07:00,181,517,68,766,0
신리→연산교차로,2023.10.10 07:00,504,316,23,843,0
안락→연산교차로,2023.10.10 07:00,618,0,113,731,0
연산터널→연산교차로,2023.10.10 07:00,313,372,20,705,0
교대→연산교차로,2023.10.10 08:00,311,0,523,834,0
부산시청→연산교차로,2023.10.10 08:00,600,451,282,1333,0
사직운동장→연산교차로,2023.10.10 08:00,202,646,64,912,0
신리→연산교차로,2023.10.10 08:00,513,351,26,890,0
안락→연산교차로,2023.10.10 08:00,634,0,87,721,0
연산터널→연산교차로,2023.10.10 08:00,313,384,20,717,0
교대→연산교차로,2023.10.10 09:00,303,0,486,789,0
부산시청→연산교차로,2023.10.10 09:00,521,389,276,1186,0
사직운동장→연산교차로,2023.10.10 09:00,193,584,102,879,0
신리→연산교차로,2023.10.10 09:00,467,332,31,830,0
안락→연산교차로,2023.10.10 09:00,583,0,95,678,0
연산터널→연산교차로,2023.10.10 09:00,293,375,45,713,0
교대→연산교차로,2023.10.10 10:00,277,0,436,713,0
부산시청→연산교차로,2023.10.10 10:00,528,369,269,1166,0
사직운동장→연산교차로,2023.10.10 10:00,181,591,66,838,0
신리→연산교차로,2023.10.10 10:00,474,285,33,792,0
안락→연산교차로,2023.10.10 10:00,523,0,128,651,0
연산터널→연산교차로,2023.10.10 10:00,312,343,48,703,0
교대→연산교차로,2023.10.10 11:00,283,0,452,735,0
부산시청→연산교차로,2023.10.10 11:00,576,388,288,1252,0
사직운동장→연산교차로,2023.10.10 11:00,213,576,103,892,0
신리→연산교차로,2023.10.10 11:00,446,272,54,772,0
안락→연산교차로,2023.10.10 11:00,502,0,185,687,0
연산터널→연산교차로,2023.10.10 11:00,267,290,67,624,0
교대→연산교차로,2023.10.10 12:00,282,0,362,644,0
부산시청→연산교차로,2023.10.10 12:00,554,361,252,1167,0
사직운동장→연산교차로,2023.10.10 12:00,176,524,87,787,0
신리→연산교차로,2023.10.10 12:00,437,242,49,728,0
안락→연산교차로,2023.10.10 12:00,467,0,169,636,0
연산터널→연산교차로,2023.10.10 12:00,265,267,45,577,0
교대→연산교차로,2023.10.10 13:00,323,0,411,734,0
부산시청→연산교차로,2023.10.10 13:00,577,440,275,1292,0
사직운동장→연산교차로,2023.10.10 13:00,199,598,82,879,0
신리→연산교차로,2023.10.10 13:00,407,259,51,717,0
안락→연산교차로,2023.10.10 13:00,459,0,129,588,0
연산터널→연산교차로,2023.10.10 13:00,253,285,38,576,0
교대→연산교차로,2023.10.10 14:00,324,0,494,818,0
부산시청→연산교차로,2023.10.10 14:00,545,454,274,1273,0
사직운동장→연산교차로,2023.10.10 14:00,219,631,87,937,0
신리→연산교차로,2023.10.10 14:00,443,285,59,787,0
안락→연산교차로,2023.10.10 14:00,431,0,120,551,0
연산터널→연산교차로,2023.10.10 14:00,241,280,52,573,0
교대→연산교차로,2023.10.10 15:00,345,0,502,847,0
부산시청→연산교차로,2023.10.10 15:00,608,493,328,1429,0
사직운동장→연산교차로,2023.10.10 15:00,237,618,90,945,0
신리→연산교차로,2023.10.10 15:00,461,291,64,816,0
안락→연산교차로,2023.10.10 15:00,428,0,123,551,0
연산터널→연산교차로,2023.10.10 15:00,245,286,38,569,0
교대→연산교차로,2023.10.10 16:00,342,0,506,848,0
부산시청→연산교차로,2023.10.10 16:00,591,536,330,1457,0
사직운동장→연산교차로,2023.10.10 16:00,208,674,60,942,0
신리→연산교차로,2023.10.10 16:00,514,267,61,842,0
안락→연산교차로,2023.10.10 16:00,459,0,131,590,0
연산터널→연산교차로,2023.10.10 16:00,244,285,50,579,0
교대→연산교차로,2023.10.10 17:00,364,0,507,871,0
부산시청→연산교차로,2023.10.10 17:00,659,564,300,1523,0
사직운동장→연산교차로,2023.10.10 17:00,220,711,51,982,0
신리→연산교차로,2023.10.10 17:00,575,274,49,898,0
안락→연산교차로,2023.10.10 17:00,456,0,110,566,0
연산터널→연산교차로,2023.10.10 17:00,229,296,35,560,0
교대→연산교차로,2023.10.10 18:00,359,0,543,902,0
부산시청→연산교차로,2023.10.10 18:00,571,540,365,1476,0
사직운동장→연산교차로,2023.10.10 18:00,240,677,53,970,0
신리→연산교차로,2023.10.10 18:00,541,264,55,860,0
안락→연산교차로,2023.10.10 18:00,446,0,110,556,0
연산터널→연산교차로,2023.10.10 18:00,229,276,48,553,0
교대→연산교차로,2023.10.10 19:00,328,0,412,740,0
부산시청→연산교차로,2023.10.10 19:00,538,388,286,1212,0
사직운동장→연산교차로,2023.10.10 19:00,202,587,88,877,0
신리→연산교차로,2023.10.10 19:00,303,214,36,553,0
안락→연산교차로,2023.10.10 19:00,404,0,103,507,0
연산터널→연산교차로,2023.10.10 19:00,182,289,44,515,0
교대→연산교차로,2023.10.10 20:00,335,0,323,658,0
부산시청→연산교차로,2023.10.10 20:00,478,344,242,1064,0
사직운동장→연산교차로,2023.10.10 20:00,166,499,77,742,0
신리→연산교차로,2023.10.10 20:00,328,157,49,534,0
안락→연산교차로,2023.10.10 20:00,421,0,105,526,0
연산터널→연산교차로,2023.10.10 20:00,211,272,48,531,0
교대→연산교차로,2023.10.10 21:00,255,0,281,536,0
부산시청→연산교차로,2023.10.10 21:00,481,338,239,1058,0
사직운동장→연산교차로,2023.10.10 21:00,174,451,75,700,0
신리→연산교차로,2023.10.10 21:00,286,183,30,499,0
안락→연산교차로,2023.10.10 21:00,387,0,95,482,0
연산터널→연산교차로,2023.10.10 21:00,202,276,67,545,0
교대→연산교차로,2023.10.10 22:00,268,0,245,513,0
부산시청→연산교차로,2023.10.10 22:00,381,303,159,843,0
사직운동장→연산교차로,2023.10.10 22:00,126,336,74,536,0
신리→연산교차로,2023.10.10 22:00,250,152,33,435,0
안락→연산교차로,2023.10.10 22:00,354,0,81,435,0
연산터널→연산교차로,2023.10.10 22:00,197,241,62,500,0
교대→연산교차로,2023.10.10 23:00,172,0,200,372,0
부산시청→연산교차로,2023.10.10 23:00,333,164,138,635,0
사직운동장→연산교차로,2023.10.10 23:00,93,265,60,418,0
신리→연산교차로,2023.10.10 23:00,200,97,28,325,0
안락→연산교차로,2023.10.10 23:00,240,0,72,312,0
연산터널→연산교차로,2023.10.10 23:00,169,203,82,454,0
교대→연산교차로,2023.10.11 00:00,149,0,192,341,0
부산시청→연산교차로,2023.10.11 00:00,235,156,88,479,0
사직운동장→연산교차로,2023.10.11 00:00,66,197,42,305,0
신리→연산교차로,2023.10.11 00:00,138,75,19,232,0
안락→연산교차로,2023.10.11 00:00,198,0,48,246,0
연산터널→연산교차로,2023.10.11 00:00,136,151,50,337,0
교대→연산교차로,2023.10.11 01:00,99,0,148,247,0
부산시청→연산교차로,2023.10.11 01:00,186,107,77,370,0
사직운동장→연산교차로,2023.10.11 01:00,55,186,28,269,0
신리→연산교차로,2023.10.11 01:00,108,50,21,179,0
안락→연산교차로,2023.10.11 01:00,141,0,36,177,0
연산터널→연산교차로,2023.10.11 01:00,119,133,66,318,0
교대→연산교차로,2023.10.11 02:00,75,0,109,184,0
부산시청→연산교차로,2023.10.11 02:00,153,83,64,300,0
사직운동장→연산교차로,2023.10.11 02:00,37,131,16,184,0
신리→연산교차로,2023.10.11 02:00,95,56,7,158,0
안락→연산교차로,2023.10.11 02:00,137,0,32,169,0
연산터널→연산교차로,2023.10.11 02:00,106,102,34,242,0
교대→연산교차로,2023.10.11 03:00,41,0,96,137,0
부산시청→연산교차로,2023.10.11 03:00,126,70,42,238,0
사직운동장→연산교차로,2023.10.11 03:00,42,132,9,183,0
신리→연산교차로,2023.10.11 03:00,65,39,12,116,0
안락→연산교차로,2023.10.11 03:00,114,0,21,135,0
연산터널→연산교차로,2023.10.11 03:00,94,80,33,207,0
교대→연산교차로,2023.10.11 04:00,51,0,80,131,0
부산시청→연산교차로,2023.10.11 04:00,150,76,38,264,0
사직운동장→연산교차로,2023.10.11 04:00,32,119,11,162,0
신리→연산교차로,2023.10.11 04:00,94,45,7,146,0
안락→연산교차로,2023.10.11 04:00,167,0,41,208,0
연산터널→연산교차로,2023.10.11 04:00,82,88,29,199,0
교대→연산교차로,2023.10.11 05:00,91,0,114,205,0
부산시청→연산교차로,2023.10.11 05:00,240,164,66,470,0
사직운동장→연산교차로,2023.10.11 05:00,42,179,6,227,0
신리→연산교차로,2023.10.11 05:00,208,109,12,329,0
안락→연산교차로,2023.10.11 05:00,302,0,59,361,0
연산터널→연산교차로,2023.10.11 05:00,149,145,26,320,0
교대→연산교차로,2023.10.11 06:00,177,0,226,403,0
부산시청→연산교차로,2023.10.11 06:00,386,258,96,740,0
사직운동장→연산교차로,2023.10.11 06:00,92,270,33,395,0
신리→연산교차로,2023.10.11 06:00,342,185,16,543,0
안락→연산교차로,2023.10.11 06:00,481,0,111,592,0
연산터널→연산교차로,2023.10.11 06:00,215,233,30,478,0
교대→연산교차로,2023.10.11 07:00,249,0,395,644,0
부산시청→연산교차로,2023.10.11 07:00,569,379,238,1186,0
사직운동장→연산교차로,2023.10.11 07:00,180,539,68,787,0
신리→연산교차로,2023.10.11 07:00,493,277,23,793,0
안락→연산교차로,2023.10.11 07:00,634,0,92,726,0
연산터널→연산교차로,2023.10.11 07:00,304,362,17,683,0
교대→연산교차로,2023.10.11 08:00,316,0,480,796,0
부산시청→연산교차로,2023.10.11 08:00,597,421,313,1331,0
사직운동장→연산교차로,2023.10.11 08:00,204,621,69,894,0
신리→연산교차로,2023.10.11 08:00,522,344,21,887,0
안락→연산교차로,2023.10.11 08:00,614,0,99,713,0
연산터널→연산교차로,2023.10.11 08:00,340,362,11,713,0
교대→연산교차로,2023.10.11 09:00,300,0,496,796,0
부산시청→연산교차로,2023.10.11 09:00,530,389,300,1219,0
사직운동장→연산교차로,2023.10.11 09:00,183,602,85,870,0
신리→연산교차로,2023.10.11 09:00,491,311,57,859,0
안락→연산교차로,2023.10.11 09:00,566,0,103,669,0
연산터널→연산교차로,2023.10.11 09:00,295,377,37,709,0
교대→연산교차로,2023.10.11 10:00,280,0,427,707,0
부산시청→연산교차로,2023.10.11 10:00,534,357,271,1162,0
사직운동장→연산교차로,2023.10.11 10:00,199,591,67,857,0
신리→연산교차로,2023.10.11 10:00,502,262,51,815,0
안락→연산교차로,2023.10.11 10:00,555,0,124,679,0
연산터널→연산교차로,2023.10.11 10:00,297,337,46,680,0
교대→연산교차로,2023.10.11 11:00,299,0,456,755,0
부산시청→연산교차로,2023.10.11 11:00,589,366,260,1215,0
사직운동장→연산교차로,2023.10.11 11:00,185,566,84,835,0
신리→연산교차로,2023.10.11 11:00,472,264,54,790,0
안락→연산교차로,2023.10.11 11:00,504,0,163,667,0
연산터널→연산교차로,2023.10.11 11:00,277,300,56,633,0
교대→연산교차로,2023.10.11 12:00,283,0,398,681,0
부산시청→연산교차로,2023.10.11 12:00,593,372,261,1226,0
사직운동장→연산교차로,2023.10.11 12:00,204,544,98,846,0
신리→연산교차로,2023.10.11 12:00,406,245,47,698,0
안락→연산교차로,2023.10.11 12:00,463,0,166,629,0
연산터널→연산교차로,2023.10.11 12:00,261,306,41,608,0
교대→연산교차로,2023.10.11 13:00,321,0,398,719,0
부산시청→연산교차로,2023.10.11 13:00,603,427,278,1308,0
사직운동장→연산교차로,2023.10.11 13:00,196,577,113,886,0
신리→연산교차로,2023.10.11 13:00,440,253,48,741,0
안락→연산교차로,2023.10.11 13:00,424,0,146,570,0
연산터널→연산교차로,2023.10.11 13:00,255,267,38,560,0
교대→연산교차로,2023.10.11 14:00,327,0,432,759,0
부산시청→연산교차로,2023.10.11 14:00,567,432,303,1302,0
사직운동장→연산교차로,2023.10.11 14:00,214,602,92,908,0
신리→연산교차로,2023.10.11 14:00,491,280,57,828,0
안락→연산교차로,2023.10.11 14:00,431,0,97,528,0
연산터널→연산교차로,2023.10.11 14:00,226,272,33,531,0
교대→연산교차로,2023.10.11 15:00,334,0,441,775,0
부산시청→연산교차로,2023.10.11 15:00,580,493,303,1376,0
사직운동장→연산교차로,2023.10.11 15:00,215,624,85,924,0
신리→연산교차로,2023.10.11 15:00,485,288,48,821,0
안락→연산교차로,2023.10.11 15:00,429,0,87,516,0
연산터널→연산교차로,2023.10.11 15:00,240,261,43,544,0
교대→연산교차로,2023.10.11 16:00,363,0,481,844,0
부산시청→연산교차로,2023.10.11 16:00,597,525,297,1419,0
사직운동장→연산교차로,2023.10.11 16:00,237,656,72,965,0
신리→연산교차로,2023.10.11 16:00,497,315,63,875,0
안락→연산교차로,2023.10.11 16:00,435,0,110,545,0
연산터널→연산교차로,2023.10.11 16:00,245,277,36,558,0
교대→연산교차로,2023.10.11 17:00,334,0,491,825,0
부산시청→연산교차로,2023.10.11 17:00,613,578,313,1504,0
사직운동장→연산교차로,2023.10.11 17:00,220,700,51,971,0
신리→연산교차로,2023.10.11 17:00,528,308,42,878,0
안락→연산교차로,2023.10.11 17:00,462,0,108,570,0
연산터널→연산교차로,2023.10.11 17:00,251,280,42,573,0
교대→연산교차로,2023.10.11 18:00,363,0,601,964,0
부산시청→연산교차로,2023.10.11 18:00,586,546,322,1454,0
사직운동장→연산교차로,2023.10.11 18:00,252,662,41,955,0
신리→연산교차로,2023.10.11 18:00,528,230,48,806,0
안락→연산교차로,2023.10.11 18:00,456,0,72,528,0
연산터널→연산교차로,2023.10.11 18:00,236,275,49,560,0
교대→연산교차로,2023.10.11 19:00,319,0,422,741,0
부산시청→연산교차로,2023.10.11 19:00,547,417,266,1230,0
사직운동장→연산교차로,2023.10.11 19:00,179,580,76,835,0
신리→연산교차로,2023.10.11 19:00,343,196,43,582,0
안락→연산교차로,2023.10.11 19:00,412,0,102,514,0
연산터널→연산교차로,2023.10.11 19:00,208,284,53,545,0
교대→연산교차로,2023.10.11 20:00,321,0,342,663,0
부산시청→연산교차로,2023.10.11 20:00,503,362,254,1119,0
사직운동장→연산교차로,2023.10.11 20:00,161,493,73,727,0
신리→연산교차로,2023.10.11 20:00,311,177,27,515,0
안락→연산교차로,2023.10.11 20:00,383,0,99,482,0
연산터널→연산교차로,2023.10.11 20:00,193,252,65,510,0
교대→연산교차로,2023.10.11 21:00,270,0,286,556,0
부산시청→연산교차로,2023.10.11 21:00,459,335,209,1003,0
사직운동장→연산교차로,2023.10.11 21:00,177,453,79,709,0
신리→연산교차로,2023.10.11 21:00,266,168,29,463,0
안락→연산교차로,2023.10.11 21:00,379,0,97,476,0
연산터널→연산교차로,2023.10.11 21:00,214,255,57,526,0
교대→연산교차로,2023.10.11 22:00,219,0,220,439,0
부산시청→연산교차로,2023.10.11 22:00,401,275,164,840,0
사직운동장→연산교차로,2023.10.11 22:00,183,401,71,655,0
신리→연산교차로,2023.10.11 22:00,214,166,26,406,0
안락→연산교차로,2023.10.11 22:00,339,0,98,437,0
연산터널→연산교차로,2023.10.11 22:00,185,244,49,478,0
교대→연산교차로,2023.10.11 23:00,153,0,192,345,0
부산시청→연산교차로,2023.10.11 23:00,299,188,132,619,0
사직운동장→연산교차로,2023.10.11 23:00,100,300,74,474,0
신리→연산교차로,2023.10.11 23:00,204,116,16,336,0
안락→연산교차로,2023.10.11 23:00,259,0,71,330,0
연산터널→연산교차로,2023.10.11 23:00,148,198,61,407,0
교대→연산교차로,2023.10.12 00:00,109,0,148,257,0
부산시청→연산교차로,2023.10.12 00:00,228,138,91,457,0
사직운동장→연산교차로,2023.10.12 00:00,79,204,29,312,0
신리→연산교차로,2023.10.12 00:00,152,73,17,242,0
안락→연산교차로,2023.10.12 00:00,193,0,43,236,0
연산터널→연산교차로,2023.10.12 00:00,111,158,64,333,0
교대→연산교차로,2023.10.12 01:00,100,0,140,240,0
부산시청→연산교차로,2023.10.12 01:00,170,105,74,349,0
사직운동장→연산교차로,2023.10.12 01:00,53,162,22,237,0
신리→연산교차로,2023.10.12 01:00,96,72,10,178,0
안락→연산교차로,2023.10.12 01:00,140,0,43,183,0
연산터널→연산교차로,2023.10.12 01:00,95,119,45,259,0
교대→연산교차로,2023.10.12 02:00,78,0,107,185,0
부산시청→연산교차로,2023.10.12 02:00,146,71,58,275,0
사직운동장→연산교차로,2023.10.12 02:00,37,152,13,202,0
신리→연산교차로,2023.10.12 02:00,82,52,11,145,0
안락→연산교차로,2023.10.12 02:00,108,0,34,142,0
연산터널→연산교차로,2023.10.12 02:00,81,112,27,220,0
교대→연산교차로,2023.10.12 03:00,49,0,95,144,0
부산시청→연산교차로,2023.10.12 03:00,138,74,48,260,0
사직운동장→연산교차로,2023.10.12 03:00,23,127,8,158,0
신리→연산교차로,2023.10.12 03:00,58,35,6,99,0
안락→연산교차로,2023.10.12 03:00,109,0,31,140,0
연산터널→연산교차로,2023.10.12 03:00,57,97,60,214,0
교대→연산교차로,2023.10.12 04:00,55,0,75,130,0
부산시청→연산교차로,2023.10.12 04:00,143,81,40,264,0
사직운동장→연산교차로,2023.10.12 04:00,35,111,10,156,0
신리→연산교차로,2023.10.12 04:00,97,49,11,157,0
안락→연산교차로,2023.10.12 04:00,167,0,36,203,0
연산터널→연산교차로,2023.10.12 04:00,69,93,18,180,0
교대→연산교차로,2023.10.12 05:00,86,0,117,203,0
부산시청→연산교차로,2023.10.12 05:00,240,154,88,482,0
사직운동장→연산교차로,2023.10.12 05:00,55,169,9,233,0
신리→연산교차로,2023.10.12 05:00,192,103,10,305,0
안락→연산교차로,2023.10.12 05:00,313,0,63,376,0
연산터널→연산교차로,2023.10.12 05:00,129,138,37,304,0
교대→연산교차로,2023.10.12 06:00,185,0,231,416,0
부산시청→연산교차로,2023.10.12 06:00,367,262,110,739,0
사직운동장→연산교차로,2023.10.12 06:00,96,297,49,442,0
신리→연산교차로,2023.10.12 06:00,364,195,23,582,0
안락→연산교차로,2023.10.12 06:00,466,0,95,561,0
연산터널→연산교차로,2023.10.12 06:00,226,210,30,466,0
교대→연산교차로,2023.10.12 07:00,262,0,411,673,0
부산시청→연산교차로,2023.10.12 07:00,588,376,195,1159,0
사직운동장→연산교차로,2023.10.12 07:00,206,523,74,803,0
신리→연산교차로,2023.10.12 07:00,477,304,27,808,0
안락→연산교차로,2023.10.12 07:00,631,0,89,720,0
연산터널→연산교차로,2023.10.12 07:00,284,423,36,743,0
교대→연산교차로,2023.10.12 08:00,300,0,507,807,0
부산시청→연산교차로,2023.10.12 08:00,569,430,314,1313,0
사직운동장→연산교차로,2023.10.12 08:00,197,644,74,915,0
신리→연산교차로,2023.10.12 08:00,513,334,28,875,0
안락→연산교차로,2023.10.12 08:00,634,0,107,741,0
연산터널→연산교차로,2023.10.12 08:00,326,386,27,739,0
교대→연산교차로,2023.10.12 09:00,281,0,465,746,0
부산시청→연산교차로,2023.10.12 09:00,546,384,290,1220,0
사직운동장→연산교차로,2023.10.12 09:00,183,600,107,890,0
신리→연산교차로,2023.10.12 09:00,464,325,38,827,0
안락→연산교차로,2023.10.12 09:00,568,0,131,699,0
연산터널→연산교차로,2023.10.12 09:00,321,355,44,720,0
교대→연산교차로,2023.10.12 10:00,273,0,450,723,0
부산시청→연산교차로,2023.10.12 10:00,604,357,256,1217,0
사직운동장→연산교차로,2023.10.12 10:00,205,559,71,835,0
신리→연산교차로,2023.10.12 10:00,469,314,45,828,0
안락→연산교차로,2023.10.12 10:00,553,0,142,695,0
연산터널→연산교차로,2023.10.12 10:00,280,290,48,618,0
교대→연산교차로,2023.10.12 11:00,289,0,408,697,0
부산시청→연산교차로,2023.10.12 11:00,565,345,267,1177,0
사직운동장→연산교차로,2023.10.12 11:00,207,574,85,866,0
신리→연산교차로,2023.10.12 11:00,428,249,68,745,0
안락→연산교차로,2023.10.12 11:00,493,0,193,686,0
연산터널→연산교차로,2023.10.12 11:00,268,315,48,631,0
교대→연산교차로,2023.10.12 12:00,291,0,344,635,0
부산시청→연산교차로,2023.10.12 12:00,503,348,277,1128,0
사직운동장→연산교차로,2023.10.12 12:00,168,522,100,790,0
신리→연산교차로,2023.10.12 12:00,414,242,49,705,0
안락→연산교차로,2023.10.12 12:00,462,0,158,620,0
연산터널→연산교차로,2023.10.12 12:00,244,256,51,551,0
교대→연산교차로,2023.10.12 13:00,305,0,432,737,0
부산시청→연산교차로,2023.10.12 13:00,587,452,292,1331,0
사직운동장→연산교차로,2023.10.12 13:00,204,624,70,898,0
신리→연산교차로,2023.10.12 13:00,422,268,64,754,0
안락→연산교차로,2023.10.12 13:00,440,0,117,557,0
연산터널→연산교차로,2023.10.12 13:00,223,278,45,546,0
교대→연산교차로,2023.10.12 14:00,349,0,466,815,0
부산시청→연산교차로,2023.10.12 14:00,570,439,289,1298,0
사직운동장→연산교차로,2023.10.12 14:00,191,627,82,900,0
신리→연산교차로,2023.10.12 14:00,452,254,73,779,0
안락→연산교차로,2023.10.12 14:00,427,0,91,518,0
연산터널→연산교차로,2023.10.12 14:00,224,263,38,525,0
교대→연산교차로,2023.10.12 15:00,347,0,467,814,0
부산시청→연산교차로,2023.10.12 15:00,574,465,291,1330,0
사직운동장→연산교차로,2023.10.12 15:00,232,614,101,947,0
신리→연산교차로,2023.10.12 15:00,482,256,58,796,0
안락→연산교차로,2023.10.12 15:00,410,0,99,509,0
연산터널→연산교차로,2023.10.12 15:00,222,277,52,551,0
교대→연산교차로,2023.10.12 16:00,337,0,498,835,0
부산시청→연산교차로,2023.10.12 16:00,635,518,300,1453,0
사직운동장→연산교차로,2023.10.12 16:00,236,641,87,964,0
신리→연산교차로,2023.10.12 16:00,544,288,60,892,0
안락→연산교차로,2023.10.12 16:00,448,0,90,538,0
연산터널→연산교차로,2023.10.12 16:00,260,256,43,559,0
교대→연산교차로,2023.10.12 17:00,352,0,534,886,0
부산시청→연산교차로,2023.10.12 17:00,628,557,326,1511,0
사직운동장→연산교차로,2023.10.12 17:00,247,684,47,978,0
신리→연산교차로,2023.10.12 17:00,486,311,46,843,0
안락→연산교차로,2023.10.12 17:00,424,0,110,534,0
연산터널→연산교차로,2023.10.12 17:00,239,273,42,554,0
교대→연산교차로,2023.10.12 18:00,344,0,512,856,0
부산시청→연산교차로,2023.10.12 18:00,578,583,326,1487,0
사직운동장→연산교차로,2023.10.12 18:00,249,645,46,940,0
신리→연산교차로,2023.10.12 18:00,511,281,36,828,0
안락→연산교차로,2023.10.12 18:00,443,0,93,536,0
연산터널→연산교차로,2023.10.12 18:00,213,266,54,533,0
교대→연산교차로,2023.10.12 19:00,303,0,389,692,0
부산시청→연산교차로,2023.10.12 19:00,499,380,273,1152,0
사직운동장→연산교차로,2023.10.12 19:00,182,573,71,826,0
신리→연산교차로,2023.10.12 19:00,378,238,42,658,0
안락→연산교차로,2023.10.12 19:00,434,0,98,532,0
연산터널→연산교차로,2023.10.12 19:00,194,250,49,493,0
교대→연산교차로,2023.10.12 20:00,296,0,350,646,0
부산시청→연산교차로,2023.10.12 20:00,488,372,246,1106,0
사직운동장→연산교차로,2023.10.12 20:00,174,550,94,818,0
신리→연산교차로,2023.10.12 20:00,310,165,34,509,0
안락→연산교차로,2023.10.12 20:00,403,0,94,497,0
연산터널→연산교차로,2023.10.12 20:00,209,266,57,532,0
교대→연산교차로,2023.10.12 21:00,277,0,280,557,0
부산시청→연산교차로,2023.10.12 21:00,461,323,206,990,0
사직운동장→연산교차로,2023.10.12 21:00,171,489,72,732,0
신리→연산교차로,2023.10.12 21:00,297,184,27,508,0
안락→연산교차로,2023.10.12 21:00,383,0,118,501,0
연산터널→연산교차로,2023.10.12 21:00,225,268,67,560,0
교대→연산교차로,2023.10.12 22:00,240,0,219,459,0
부산시청→연산교차로,2023.10.12 22:00,395,285,151,831,0
사직운동장→연산교차로,2023.10.12 22:00,182,476,71,729,0
신리→연산교차로,2023.10.12 22:00,242,150,17,409,0
안락→연산교차로,2023.10.12 22:00,333,0,99,432,0
연산터널→연산교차로,2023.10.12 22:00,177,233,50,460,0
교대→연산교차로,2023.10.12 23:00,175,0,201,376,0
부산시청→연산교차로,2023.10.12 23:00,320,175,121,616,0
사직운동장→연산교차로,2023.10.12 23:00,107,256,46,409,0
신리→연산교차로,2023.10.12 23:00,191,128,23,342,0
안락→연산교차로,2023.10.12 23:00,266,0,56,322,0
연산터널→연산교차로,2023.10.12 23:00,157,187,56,400,0
교대→연산교차로,2023.10.13 00:00,136,0,209,345,0
부산시청→연산교차로,2023.10.13 00:00,273,162,106,541,0
사직운동장→연산교차로,2023.10.13 00:00,80,205,69,354,0
신리→연산교차로,2023.10.13 00:00,156,92,19,267,0
안락→연산교차로,2023.10.13 00:00,202,0,60,262,0
연산터널→연산교차로,2023.10.13 00:00,132,166,66,364,0
교대→연산교차로,2023.10.13 01:00,108,0,175,283,0
부산시청→연산교차로,2023.10.13 01:00,202,121,80,403,0
사직운동장→연산교차로,2023.10.13 01:00,56,183,38,277,0
신리→연산교차로,2023.10.13 01:00,132,58,23,213,0
안락→연산교차로,2023.10.13 01:00,142,0,67,209,0
연산터널→연산교차로,2023.10.13 01:00,119,141,60,320,0
교대→연산교차로,2023.10.13 02:00,104,0,122,226,0
부산시청→연산교차로,2023.10.13 02:00,160,92,82,334,0
사직운동장→연산교차로,2023.10.13 02:00,36,165,20,221,0
신리→연산교차로,2023.10.13 02:00,92,63,15,170,0
안락→연산교차로,2023.10.13 02:00,126,0,26,152,0
연산터널→연산교차로,2023.10.13 02:00,92,143,53,288,0
교대→연산교차로,2023.10.13 03:00,67,0,130,197,0
부산시청→연산교차로,2023.10.13 03:00,163,78,55,296,0
사직운동장→연산교차로,2023.10.13 03:00,35,135,14,184,0
신리→연산교차로,2023.10.13 03:00,70,37,15,122,0
안락→연산교차로,2023.10.13 03:00,113,0,38,151,0
연산터널→연산교차로,2023.10.13 03:00,91,98,44,233,0
교대→연산교차로,2023.10.13 04:00,62,0,98,160,0
부산시청→연산교차로,2023.10.13 04:00,158,87,46,291,0
사직운동장→연산교차로,2023.10.13 04:00,31,138,8,177,0
신리→연산교차로,2023.10.13 04:00,91,47,11,149,0
안락→연산교차로,2023.10.13 04:00,176,0,33,209,0
연산터널→연산교차로,2023.10.13 04:00,85,86,41,212,0
교대→연산교차로,2023.10.13 05:00,85,0,131,216,0
부산시청→연산교차로,2023.10.13 05:00,234,141,70,445,0
사직운동장→연산교차로,2023.10.13 05:00,52,218,6,276,0
신리→연산교차로,2023.10.13 05:00,226,89,14,329,0
안락→연산교차로,2023.10.13 05:00,311,0,56,367,0
연산터널→연산교차로,2023.10.13 05:00,130,133,25,288,0
교대→연산교차로,2023.10.13 06:00,150,0,210,360,0
부산시청→연산교차로,2023.10.13 06:00,387,259,116,762,0
사직운동장→연산교차로,2023.10.13 06:00,99,313,42,454,0
신리→연산교차로,2023.10.13 06:00,367,175,18,560,0
안락→연산교차로,2023.10.13 06:00,484,0,96,580,0
연산터널→연산교차로,2023.10.13 06:00,217,246,34,497,0
교대→연산교차로,2023.10.13 07:00,251,0,372,623,0
부산시청→연산교차로,2023.10.13 07:00,552,386,220,1158,0
사직운동장→연산교차로,2023.10.13 07:00,175,497,61,733,0
신리→연산교차로,2023.10.13 07:00,472,300,20,792,0
안락→연산교차로,2023.10.13 07:00,622,0,86,708,0
연산터널→연산교차로,2023.10.13 07:00,296,367,34,697,0
교대→연산교차로,2023.10.13 08:00,309,0,467,776,0
부산시청→연산교차로,2023.10.13 08:00,601,445,368,1414,0
사직운동장→연산교차로,2023.10.13 08:00,186,675,90,951,0
신리→연산교차로,2023.10.13 08:00,483,349,22,854,0
안락→연산교차로,2023.10.13 08:00,624,0,103,727,0
연산터널→연산교차로,2023.10.13 08:00,302,380,19,701,0
교대→연산교차로,2023.10.13 09:00,304,0,509,813,0
부산시청→연산교차로,2023.10.13 09:00,559,383,304,1246,0
사직운동장→연산교차로,2023.10.13 09:00,191,600,73,864,0
신리→연산교차로,2023.10.13 09:00,535,314,37,886,0
안락→연산교차로,2023.10.13 09:00,588,0,103,691,0
연산터널→연산교차로,2023.10.13 09:00,297,369,35,701,0
교대→연산교차로,2023.10.13 10:00,300,0,465,765,0
부산시청→연산교차로,2023.10.13 10:00,588,395,282,1265,0
사직운동장→연산교차로,2023.10.13 10:00,210,601,66,877,0
신리→연산교차로,2023.10.13 10:00,466,274,46,786,0
안락→연산교차로,2023.10.13 10:00,535,0,132,667,0
연산터널→연산교차로,2023.10.13 10:00,293,349,39,681,0
교대→연산교차로,2023.10.13 11:00,297,0,429,726,0
부산시청→연산교차로,2023.10.13 11:00,565,374,266,1205,0
사직운동장→연산교차로,2023.10.13 11:00,192,604,93,889,0
신리→연산교차로,2023.10.13 11:00,454,233,52,739,0
안락→연산교차로,2023.10.13 11:00,526,0,191,717,0
연산터널→연산교차로,2023.10.13 11:00,283,317,63,663,0
교대→연산교차로,2023.10.13 12:00,274,0,375,649,0
부산시청→연산교차로,2023.10.13 12:00,583,376,272,1231,0
사직운동장→연산교차로,2023.10.13 12:00,181,571,88,840,0
신리→연산교차로,2023.10.13 12:00,414,242,58,714,0
안락→연산교차로,2023.10.13 12:00,488,0,130,618,0
연산터널→연산교차로,2023.10.13 12:00,249,280,46,575,0
교대→연산교차로,2023.10.13 13:00,321,0,400,721,0
부산시청→연산교차로,2023.10.13 13:00,575,411,295,1281,0
사직운동장→연산교차로,2023.10.13 13:00,216,599,93,908,0
신리→연산교차로,2023.10.13 13:00,456,248,61,765,0
안락→연산교차로,2023.10.13 13:00,457,0,108,565,0
연산터널→연산교차로,2023.10.13 13:00,257,256,45,558,0
교대→연산교차로,2023.10.13 14:00,331,0,486,817,0
부산시청→연산교차로,2023.10.13 14:00,585,473,294,1352,0
사직운동장→연산교차로,2023.10.13 14:00,227,628,85,940,0
신리→연산교차로,2023.10.13 14:00,432,289,65,786,0
안락→연산교차로,2023.10.13 14:00,401,0,136,537,0
연산터널→연산교차로,2023.10.13 14:00,233,283,41,557,0
교대→연산교차로,2023.10.13 15:00,354,0,435,789,0
부산시청→연산교차로,2023.10.13 15:00,621,472,298,1391,0
사직운동장→연산교차로,2023.10.13 15:00,221,651,95,967,0
신리→연산교차로,2023.10.13 15:00,459,269,66,794,0
안락→연산교차로,2023.10.13 15:00,457,0,113,570,0
연산터널→연산교차로,2023.10.13 15:00,219,290,51,560,0
교대→연산교차로,2023.10.13 16:00,343,0,467,810,0
부산시청→연산교차로,2023.10.13 16:00,663,535,328,1526,0
사직운동장→연산교차로,2023.10.13 16:00,232,690,76,998,0
신리→연산교차로,2023.10.13 16:00,549,277,63,889,0
안락→연산교차로,2023.10.13 16:00,469,0,107,576,0
연산터널→연산교차로,2023.10.13 16:00,243,297,36,576,0
교대→연산교차로,2023.10.13 17:00,381,0,507,888,0
부산시청→연산교차로,2023.10.13 17:00,620,551,301,1472,0
사직운동장→연산교차로,2023.10.13 17:00,241,701,48,990,0
신리→연산교차로,2023.10.13 17:00,511,283,53,847,0
안락→연산교차로,2023.10.13 17:00,454,0,110,564,0
연산터널→연산교차로,2023.10.13 17:00,234,277,45,556,0
교대→연산교차로,2023.10.13 18:00,365,0,516,881,0
부산시청→연산교차로,2023.10.13 18:00,576,568,341,1485,0
사직운동장→연산교차로,2023.10.13 18:00,260,667,49,976,0
신리→연산교차로,2023.10.13 18:00,525,254,38,817,0
안락→연산교차로,2023.10.13 18:00,453,0,99,552,0
연산터널→연산교차로,2023.10.13 18:00,212,296,49,557,0
교대→연산교차로,2023.10.13 19:00,321,0,464,785,0
부산시청→연산교차로,2023.10.13 19:00,532,406,290,1228,0
사직운동장→연산교차로,2023.10.13 19:00,212,568,73,853,0
신리→연산교차로,2023.10.13 19:00,401,233,29,663,0
안락→연산교차로,2023.10.13 19:00,447,0,89,536,0
연산터널→연산교차로,2023.10.13 19:00,225,240,57,522,0
교대→연산교차로,2023.10.13 20:00,325,0,409,734,0
부산시청→연산교차로,2023.10.13 20:00,482,374,224,1080,0
사직운동장→연산교차로,2023.10.13 20:00,182,540,94,816,0
신리→연산교차로,2023.10.13 20:00,312,183,43,538,0
안락→연산교차로,2023.10.13 20:00,424,0,89,513,0
연산터널→연산교차로,2023.10.13 20:00,228,274,41,543,0
교대→연산교차로,2023.10.13 21:00,299,0,364,663,0
부산시청→연산교차로,2023.10.13 21:00,500,333,236,1069,0
사직운동장→연산교차로,2023.10.13 21:00,174,471,82,727,0
신리→연산교차로,2023.10.13 21:00,307,206,34,547,0
안락→연산교차로,2023.10.13 21:00,446,0,104,550,0
연산터널→연산교차로,2023.10.13 21:00,231,271,72,574,0
교대→연산교차로,2023.10.13 22:00,268,0,303,571,0
부산시청→연산교차로,2023.10.13 22:00,451,294,193,938,0
사직운동장→연산교차로,2023.10.13 22:00,136,432,86,654,0
신리→연산교차로,2023.10.13 22:00,299,179,36,514,0
안락→연산교차로,2023.10.13 22:00,383,0,96,479,0
연산터널→연산교차로,2023.10.13 22:00,223,278,81,582,0
교대→연산교차로,2023.10.13 23:00,226,0,260,486,0
부산시청→연산교차로,2023.10.13 23:00,376,226,156,758,0
사직운동장→연산교차로,2023.10.13 23:00,105,290,69,464,0
신리→연산교차로,2023.10.13 23:00,228,134,32,394,0
안락→연산교차로,2023.10.13 23:00,284,0,107,391,0
연산터널→연산교차로,2023.10.13 23:00,181,243,85,509,0
교대→연산교차로,2023.10.14 00:00,187,0,225,412,0
부산시청→연산교차로,2023.10.14 00:00,324,217,129,670,0
사직운동장→연산교차로,2023.10.14 00:00,87,278,54,419,0
신리→연산교차로,2023.10.14 00:00,239,113,20,372,0
안락→연산교차로,2023.10.14 00:00,244,0,84,328,0
연산터널→연산교차로,2023.10.14 00:00,148,219,53,420,0
교대→연산교차로,2023.10.14 01:00,137,0,204,341,0
부산시청→연산교차로,2023.10.14 01:00,241,121,82,444,0
사직운동장→연산교차로,2023.10.14 01:00,73,225,44,342,0
신리→연산교차로,2023.10.14 01:00,169,104,26,299,0
안락→연산교차로,2023.10.14 01:00,189,0,47,236,0
연산터널→연산교차로,2023.10.14 01:00,124,190,54,368,0
교대→연산교차로,2023.10.14 02:00,114,0,176,290,0
부산시청→연산교차로,2023.10.14 02:00,216,109,84,409,0
사직운동장→연산교차로,2023.10.14 02:00,70,198,13,281,0
신리→연산교차로,2023.10.14 02:00,137,81,12,230,0
안락→연산교차로,2023.10.14 02:00,164,0,50,214,0
연산터널→연산교차로,2023.10.14 02:00,124,153,37,314,0
교대→연산교차로,2023.10.14 03:00,74,0,179,253,0
부산시청→연산교차로,2023.10.14 03:00,212,124,68,404,0
사직운동장→연산교차로,2023.10.14 03:00,55,156,10,221,0
신리→연산교차로,2023.10.14 03:00,105,64,8,177,0
안락→연산교차로,2023.10.14 03:00,153,0,45,198,0
연산터널→연산교차로,2023.10.14 03:00,109,136,31,276,0
교대→연산교차로,2023.10.14 04:00,81,0,120,201,0
부산시청→연산교차로,2023.10.14 04:00,218,95,54,367,0
사직운동장→연산교차로,2023.10.14 04:00,42,182,10,234,0
신리→연산교차로,2023.10.14 04:00,115,44,9,168,0
안락→연산교차로,2023.10.14 04:00,171,0,50,221,0
연산터널→연산교차로,2023.10.14 04:00,95,129,33,257,0
교대→연산교차로,2023.10.14 05:00,95,0,138,233,0
부산시청→연산교차로,2023.10.14 05:00,214,174,79,467,0
사직운동장→연산교차로,2023.10.14 05:00,55,253,6,314,0
신리→연산교차로,2023.10.14 05:00,178,90,4,272,0
안락→연산교차로,2023.10.14 05:00,300,0,55,355,0
연산터널→연산교차로,2023.10.14 05:00,122,138,23,283,0
교대→연산교차로,2023.10.14 06:00,157,0,174,331,0
부산시청→연산교차로,2023.10.14 06:00,336,256,76,668,0
사직운동장→연산교차로,2023.10.14 06:00,60,237,40,337,0
신리→연산교차로,2023.10.14 06:00,283,154,12,449,0
안락→연산교차로,2023.10.14 06:00,391,0,70,461,0
연산터널→연산교차로,2023.10.14 06:00,206,179,24,409,0
교대→연산교차로,2023.10.14 07:00,189,0,228,417,0
부산시청→연산교차로,2023.10.14 07:00,405,266,149,820,0
사직운동장→연산교차로,2023.10.14 07:00,125,347,42,514,0
신리→연산교차로,2023.10.14 07:00,312,160,23,495,0
안락→연산교차로,2023.10.14 07:00,451,0,96,547,0
연산터널→연산교차로,2023.10.14 07:00,195,208,33,436,0
교대→연산교차로,2023.10.14 08:00,275,0,371,646,0
부산시청→연산교차로,2023.10.14 08:00,484,329,212,1025,0
사직운동장→연산교차로,2023.10.14 08:00,182,525,71,778,0
신리→연산교차로,2023.10.14 08:00,470,245,38,753,0
안락→연산교차로,2023.10.14 08:00,550,0,135,685,0
연산터널→연산교차로,2023.10.14 08:00,308,287,56,651,0
교대→연산교차로,2023.10.14 09:00,301,0,401,702,0
부산시청→연산교차로,2023.10.14 09:00,580,369,251,1200,0
사직운동장→연산교차로,2023.10.14 09:00,181,618,81,880,0
신리→연산교차로,2023.10.14 09:00,507,298,50,855,0
안락→연산교차로,2023.10.14 09:00,587,0,133,720,0
연산터널→연산교차로,2023.10.14 09:00,312,334,53,699,0
교대→연산교차로,2023.10.14 10:00,270,0,438,708,0
부산시청→연산교차로,2023.10.14 10:00,593,388,271,1252,0
사직운동장→연산교차로,2023.10.14 10:00,202,621,65,888,0
신리→연산교차로,2023.10.14 10:00,518,294,76,888,0
안락→연산교차로,2023.10.14 10:00,595,0,134,729,0
연산터널→연산교차로,2023.10.14 10:00,305,338,57,700,0
교대→연산교차로,2023.10.14 11:00,262,0,479,741,0
부산시청→연산교차로,2023.10.14 11:00,602,394,303,1299,0
사직운동장→연산교차로,2023.10.14 11:00,178,545,68,791,0
신리→연산교차로,2023.10.14 11:00,506,308,48,862,0
안락→연산교차로,2023.10.14 11:00,564,0,175,739,0
연산터널→연산교차로,2023.10.14 11:00,284,336,50,670,0
교대→연산교차로,2023.10.14 12:00,313,0,446,759,0
부산시청→연산교차로,2023.10.14 12:00,644,401,248,1293,0
사직운동장→연산교차로,2023.10.14 12:00,200,621,49,870,0
신리→연산교차로,2023.10.14 12:00,535,289,77,901,0
안락→연산교차로,2023.10.14 12:00,577,0,113,690,0
연산터널→연산교차로,2023.10.14 12:00,329,318,39,686,0
교대→연산교차로,2023.10.14 13:00,388,0,491,879,0
부산시청→연산교차로,2023.10.14 13:00,655,515,310,1480,0
사직운동장→연산교차로,2023.10.14 13:00,233,663,60,956,0
신리→연산교차로,2023.10.14 13:00,497,294,51,842,0
안락→연산교차로,2023.10.14 13:00,461,0,109,570,0
연산터널→연산교차로,2023.10.14 13:00,255,303,38,596,0
교대→연산교차로,2023.10.14 14:00,368,0,468,836,0
부산시청→연산교차로,2023.10.14 14:00,661,490,323,1474,0
사직운동장→연산교차로,2023.10.14 14:00,199,667,68,934,0
신리→연산교차로,2023.10.14 14:00,472,292,66,830,0
안락→연산교차로,2023.10.14 14:00,465,0,86,551,0
연산터널→연산교차로,2023.10.14 14:00,230,277,49,556,0
교대→연산교차로,2023.10.14 15:00,348,0,467,815,0
부산시청→연산교차로,2023.10.14 15:00,659,525,308,1492,0
사직운동장→연산교차로,2023.10.14 15:00,230,671,57,958,0
신리→연산교차로,2023.10.14 15:00,496,258,61,815,0
안락→연산교차로,2023.10.14 15:00,466,0,86,552,0
연산터널→연산교차로,2023.10.14 15:00,224,293,46,563,0
교대→연산교차로,2023.10.14 16:00,336,0,448,784,0
부산시청→연산교차로,2023.10.14 16:00,678,455,311,1444,0
사직운동장→연산교차로,2023.10.14 16:00,225,655,51,931,0
신리→연산교차로,2023.10.14 16:00,448,269,57,774,0
안락→연산교차로,2023.10.14 16:00,466,0,86,552,0
연산터널→연산교차로,2023.10.14 16:00,240,289,39,568,0
교대→연산교차로,2023.10.14 17:00,341,0,402,743,0
부산시청→연산교차로,2023.10.14 17:00,600,454,271,1325,0
사직운동장→연산교차로,2023.10.14 17:00,211,667,75,953,0
신리→연산교차로,2023.10.14 17:00,413,253,33,699,0
안락→연산교차로,2023.10.14 17:00,449,0,123,572,0
연산터널→연산교차로,2023.10.14 17:00,225,278,48,551,0
교대→연산교차로,2023.10.14 18:00,332,0,399,731,0
부산시청→연산교차로,2023.10.14 18:00,586,427,252,1265,0
사직운동장→연산교차로,2023.10.14 18:00,234,602,68,904,0
신리→연산교차로,2023.10.14 18:00,437,219,32,688,0
안락→연산교차로,2023.10.14 18:00,446,0,99,545,0
연산터널→연산교차로,2023.10.14 18:00,220,272,51,543,0
교대→연산교차로,2023.10.14 19:00,320,0,399,719,0
부산시청→연산교차로,2023.10.14 19:00,489,336,206,1031,0
사직운동장→연산교차로,2023.10.14 19:00,168,482,87,737,0
신리→연산교차로,2023.10.14 19:00,332,213,36,581,0
안락→연산교차로,2023.10.14 19:00,436,0,94,530,0
연산터널→연산교차로,2023.10.14 19:00,226,272,52,550,0
교대→연산교차로,2023.10.14 20:00,307,0,337,644,0
부산시청→연산교차로,2023.10.14 20:00,428,349,202,979,0
사직운동장→연산교차로,2023.10.14 20:00,174,469,87,730,0
신리→연산교차로,2023.10.14 20:00,353,180,37,570,0
안락→연산교차로,2023.10.14 20:00,430,0,97,527,0
연산터널→연산교차로,2023.10.14 20:00,227,269,54,550,0
교대→연산교차로,2023.10.14 21:00,265,0,316,581,0
부산시청→연산교차로,2023.10.14 21:00,478,324,186,988,0
사직운동장→연산교차로,2023.10.14 21:00,158,506,76,740,0
신리→연산교차로,2023.10.14 21:00,316,204,30,550,0
안락→연산교차로,2023.10.14 21:00,386,0,99,485,0
연산터널→연산교차로,2023.10.14 21:00,213,253,55,521,0
교대→연산교차로,2023.10.14 22:00,268,0,279,547,0
부산시청→연산교차로,2023.10.14 22:00,379,267,164,810,0
사직운동장→연산교차로,2023.10.14 22:00,132,369,73,574,0
신리→연산교차로,2023.10.14 22:00,300,182,27,509,0
안락→연산교차로,2023.10.14 22:00,347,0,89,436,0
연산터널→연산교차로,2023.10.14 22:00,187,233,53,473,0
교대→연산교차로,2023.10.14 23:00,201,0,249,450,0
부산시청→연산교차로,2023.10.14 23:00,371,234,130,735,0
사직운동장→연산교차로,2023.10.14 23:00,104,309,59,472,0
신리→연산교차로,2023.10.14 23:00,248,153,28,429,0
안락→연산교차로,2023.10.14 23:00,280,0,71,351,0
연산터널→연산교차로,2023.10.14 23:00,151,190,42,383,0
교대→연산교차로,2023.10.15 00:00,177,0,223,400,1
부산시청→연산교차로,2023.10.15 00:00,346,207,125,678,1
사직운동장→연산교차로,2023.10.15 00:00,72,256,49,377,1
신리→연산교차로,2023.10.15 00:00,241,149,19,409,1
안락→연산교차로,2023.10.15 00:00,265,0,76,341,1
연산터널→연산교차로,2023.10.15 00:00,144,183,60,387,1
교대→연산교차로,2023.10.15 01:00,144,0,256,400,1
부산시청→연산교차로,2023.10.15 01:00,279,170,93,542,1
사직운동장→연산교차로,2023.10.15 01:00,54,293,38,385,1
신리→연산교차로,2023.10.15 01:00,177,88,15,280,1
안락→연산교차로,2023.10.15 01:00,262,0,65,327,1
연산터널→연산교차로,2023.10.15 01:00,144,183,52,379,1
교대→연산교차로,2023.10.15 02:00,123,0,219,342,1
부산시청→연산교차로,2023.10.15 02:00,231,149,80,460,1
사직운동장→연산교차로,2023.10.15 02:00,49,201,22,272,1
신리→연산교차로,2023.10.15 02:00,139,80,15,234,1
안락→연산교차로,2023.10.15 02:00,167,0,43,210,1
연산터널→연산교차로,2023.10.15 02:00,106,133,28,267,1
교대→연산교차로,2023.10.15 03:00,80,0,168,248,1
부산시청→연산교차로,2023.10.15 03:00,203,87,64,354,1
사직운동장→연산교차로,2023.10.15 03:00,44,181,9,234,1
신리→연산교차로,2023.10.15 03:00,102,57,12,171,1
안락→연산교차로,2023.10.15 03:00,144,0,39,183,1
연산터널→연산교차로,2023.10.15 03:00,107,117,44,268,1
교대→연산교차로,2023.10.15 04:00,71,0,108,179,1
부산시청→연산교차로,2023.10.15 04:00,180,93,61,334,1
사직운동장→연산교차로,2023.10.15 04:00,34,132,7,173,1
신리→연산교차로,2023.10.15 04:00,86,63,6,155,1
안락→연산교차로,2023.10.15 04:00,115,0,40,155,1
연산터널→연산교차로,2023.10.15 04:00,73,111,28,212,1
교대→연산교차로,2023.10.15 05:00,73,0,110,183,1
부산시청→연산교차로,2023.10.15 05:00,168,107,40,315,1
사직운동장→연산교차로,2023.10.15 05:00,40,141,5,186,1
신리→연산교차로,2023.10.15 05:00,129,65,8,202,1
안락→연산교차로,2023.10.15 05:00,188,0,50,238,1
연산터널→연산교차로,2023.10.15 05:00,91,86,18,195,1
교대→연산교차로,2023.10.15 06:00,121,0,137,258,1
부산시청→연산교차로,2023.10.15 06:00,212,167,60,439,1
사직운동장→연산교차로,2023.10.15 06:00,51,158,39,248,1
신리→연산교차로,2023.10.15 06:00,190,95,16,301,1
안락→연산교차로,2023.10.15 06:00,247,0,50,297,1
연산터널→연산교차로,2023.10.15 06:00,125,109,33,267,1
교대→연산교차로,2023.10.15 07:00,135,0,167,302,1
부산시청→연산교차로,2023.10.15 07:00,244,210,120,574,1
사직운동장→연산교차로,2023.10.15 07:00,76,244,46,366,1
신리→연산교차로,2023.10.15 07:00,232,88,17,337,1
안락→연산교차로,2023.10.15 07:00,262,0,67,329,1
연산터널→연산교차로,2023.10.15 07:00,148,132,15,295,1
교대→연산교차로,2023.10.15 08:00,169,0,169,338,1
부산시청→연산교차로,2023.10.15 08:00,335,228,180,743,1
사직운동장→연산교차로,2023.10.15 08:00,103,309,43,455,1
신리→연산교차로,2023.10.15 08:00,302,131,20,453,1
안락→연산교차로,2023.10.15 08:00,328,0,77,405,1
연산터널→연산교차로,2023.10.15 08:00,174,157,22,353,1
교대→연산교차로,2023.10.15 09:00,223,0,260,483,1
부산시청→연산교차로,2023.10.15 09:00,382,314,162,858,1
사직운동장→연산교차로,2023.10.15 09:00,128,443,46,617,1
신리→연산교차로,2023.10.15 09:00,397,200,21,618,1
안락→연산교차로,2023.10.15 09:00,420,0,87,507,1
연산터널→연산교차로,2023.10.15 09:00,282,219,22,523,1
교대→연산교차로,2023.10.15 10:00,266,0,306,572,1
부산시청→연산교차로,2023.10.15 10:00,459,326,199,984,1
사직운동장→연산교차로,2023.10.15 10:00,182,498,54,734,1
신리→연산교차로,2023.10.15 10:00,470,202,34,706,1
안락→연산교차로,2023.10.15 10:00,499,0,117,616,1
연산터널→연산교차로,2023.10.15 10:00,277,238,32,547,1
교대→연산교차로,2023.10.15 11:00,236,0,322,558,1
부산시청→연산교차로,2023.10.15 11:00,487,354,202,1043,1
사직운동장→연산교차로,2023.10.15 11:00,197,521,70,788,1
신리→연산교차로,2023.10.15 11:00,455,213,37,705,1
안락→연산교차로,2023.10.15 11:00,495,0,122,617,1
연산터널→연산교차로,2023.10.15 11:00,233,235,43,511,1
교대→연산교차로,2023.10.15 12:00,270,0,308,578,1
부산시청→연산교차로,2023.10.15 12:00,543,347,219,1109,1
사직운동장→연산교차로,2023.10.15 12:00,175,511,67,753,1
신리→연산교차로,2023.10.15 12:00,408,199,39,646,1
안락→연산교차로,2023.10.15 12:00,523,0,121,644,1
연산터널→연산교차로,2023.10.15 12:00,264,256,39,559,1
교대→연산교차로,2023.10.15 13:00,310,0,386,696,1
부산시청→연산교차로,2023.10.15 13:00,562,400,218,1180,1
사직운동장→연산교차로,2023.10.15 13:00,206,541,72,819,1
신리→연산교차로,2023.10.15 13:00,432,217,40,689,1
안락→연산교차로,2023.10.15 13:00,542,0,120,662,1
연산터널→연산교차로,2023.10.15 13:00,233,263,52,548,1
교대→연산교차로,2023.10.15 14:00,295,0,338,633,1
부산시청→연산교차로,2023.10.15 14:00,572,373,231,1176,1
사직운동장→연산교차로,2023.10.15 14:00,186,567,57,810,1
신리→연산교차로,2023.10.15 14:00,384,226,50,660,1
안락→연산교차로,2023.10.15 14:00,575,0,109,684,1
연산터널→연산교차로,2023.10.15 14:00,257,258,43,558,1
교대→연산교차로,2023.10.15 15:00,292,0,316,608,1
부산시청→연산교차로,2023.10.15 15:00,557,388,220,1165,1
사직운동장→연산교차로,2023.10.15 15:00,196,557,57,810,1
신리→연산교차로,2023.10.15 15:00,422,209,28,659,1
안락→연산교차로,2023.10.15 15:00,549,0,96,645,1
연산터널→연산교차로,2023.10.15 15:00,231,245,29,505,1
교대→연산교차로,2023.10.15 16:00,293,0,345,638,1
부산시청→연산교차로,2023.10.15 16:00,586,365,240,1191,1
사직운동장→연산교차로,2023.10.15 16:00,200,535,59,794,1
신리→연산교차로,2023.10.15 16:00,411,242,23,676,1
안락→연산교차로,2023.10.15 16:00,565,0,126,691,1
연산터널→연산교차로,2023.10.15 16:00,249,278,45,572,1
교대→연산교차로,2023.10.15 17:00,285,0,345,630,1
부산시청→연산교차로,2023.10.15 17:00,531,380,223,1134,1
사직운동장→연산교차로,2023.10.15 17:00,225,469,66,760,1
신리→연산교차로,2023.10.15 17:00,360,225,23,608,1
안락→연산교차로,2023.10.15 17:00,535,0,129,664,1
연산터널→연산교차로,2023.10.15 17:00,236,292,43,571,1
교대→연산교차로,2023.10.15 18:00,299,0,333,632,1
부산시청→연산교차로,2023.10.15 18:00,516,343,205,1064,1
사직운동장→연산교차로,2023.10.15 18:00,182,514,51,747,1
신리→연산교차로,2023.10.15 18:00,311,176,33,520,1
안락→연산교차로,2023.10.15 18:00,494,0,134,628,1
연산터널→연산교차로,2023.10.15 18:00,235,231,41,507,1
교대→연산교차로,2023.10.15 19:00,264,0,300,564,1
부산시청→연산교차로,2023.10.15 19:00,440,301,178,919,1
사직운동장→연산교차로,2023.10.15 19:00,155,451,65,671,1
신리→연산교차로,2023.10.15 19:00,304,190,24,518,1
안락→연산교차로,2023.10.15 19:00,440,0,131,571,1
연산터널→연산교차로,2023.10.15 19:00,231,240,48,519,1
교대→연산교차로,2023.10.15 20:00,287,0,246,533,1
부산시청→연산교차로,2023.10.15 20:00,408,267,164,839,1
사직운동장→연산교차로,2023.10.15 20:00,130,368,66,564,1
신리→연산교차로,2023.10.15 20:00,296,147,28,471,1
안락→연산교차로,2023.10.15 20:00,427,0,123,550,1
연산터널→연산교차로,2023.10.15 20:00,209,223,46,478,1
교대→연산교차로,2023.10.15 21:00,237,0,223,460,1
부산시청→연산교차로,2023.10.15 21:00,351,243,147,741,1
사직운동장→연산교차로,2023.10.15 21:00,131,349,63,543,1
신리→연산교차로,2023.10.15 21:00,286,158,24,468,1
안락→연산교차로,2023.10.15 21:00,379,0,94,473,1
연산터널→연산교차로,2023.10.15 21:00,160,202,50,412,1
교대→연산교차로,2023.10.15 22:00,192,0,208,400,1
부산시청→연산교차로,2023.10.15 22:00,291,225,129,645,1
사직운동장→연산교차로,2023.10.15 22:00,105,282,57,444,1
신리→연산교차로,2023.10.15 22:00,232,110,28,370,1
안락→연산교차로,2023.10.15 22:00,254,0,59,313,1
연산터널→연산교차로,2023.10.15 22:00,131,168,39,338,1
교대→연산교차로,2023.10.15 23:00,152,0,152,304,1
부산시청→연산교차로,2023.10.15 23:00,248,151,101,500,1
사직운동장→연산교차로,2023.10.15 23:00,66,211,46,323,1
신리→연산교차로,2023.10.15 23:00,171,94,19,284,1
안락→연산교차로,2023.10.15 23:00,192,0,55,247,1
연산터널→연산교차로,2023.10.15 23:00,115,153,58,326,1
교대→연산교차로,2023.10.16 00:00,120,0,139,259,0
부산시청→연산교차로,2023.10.16 00:00,201,139,65,405,0
사직운동장→연산교차로,2023.10.16 00:00,54,163,29,246,0
신리→연산교차로,2023.10.16 00:00,129,67,23,219,0
안락→연산교차로,2023.10.16 00:00,170,0,39,209,0
연산터널→연산교차로,2023.10.16 00:00,83,115,59,257,0
교대→연산교차로,2023.10.16 01:00,59,0,108,167,0
부산시청→연산교차로,2023.10.16 01:00,145,108,66,319,0
사직운동장→연산교차로,2023.10.16 01:00,38,116,17,171,0
신리→연산교차로,2023.10.16 01:00,91,47,10,148,0
안락→연산교차로,2023.10.16 01:00,123,0,31,154,0
연산터널→연산교차로,2023.10.16 01:00,80,99,46,225,0
교대→연산교차로,2023.10.16 02:00,65,0,102,167,0
부산시청→연산교차로,2023.10.16 02:00,134,62,34,230,0
사직운동장→연산교차로,2023.10.16 02:00,28,101,12,141,0
신리→연산교차로,2023.10.16 02:00,61,37,10,108,0
안락→연산교차로,2023.10.16 02:00,100,0,29,129,0
연산터널→연산교차로,2023.10.16 02:00,67,79,33,179,0
교대→연산교차로,2023.10.16 03:00,46,0,88,134,0
부산시청→연산교차로,2023.10.16 03:00,125,63,36,224,0
사직운동장→연산교차로,2023.10.16 03:00,29,106,8,143,0
신리→연산교차로,2023.10.16 03:00,68,32,13,113,0
안락→연산교차로,2023.10.16 03:00,107,0,15,122,0
연산터널→연산교차로,2023.10.16 03:00,56,80,29,165,0
교대→연산교차로,2023.10.16 04:00,40,0,58,98,0
부산시청→연산교차로,2023.10.16 04:00,139,68,44,251,0
사직운동장→연산교차로,2023.10.16 04:00,22,103,3,128,0
신리→연산교차로,2023.10.16 04:00,94,32,3,129,0
안락→연산교차로,2023.10.16 04:00,160,0,25,185,0
연산터널→연산교차로,2023.10.16 04:00,49,76,14,139,0
교대→연산교차로,2023.10.16 05:00,71,0,123,194,0
부산시청→연산교차로,2023.10.16 05:00,213,177,69,459,0
사직운동장→연산교차로,2023.10.16 05:00,45,152,2,199,0
신리→연산교차로,2023.10.16 05:00,227,89,8,324,0
안락→연산교차로,2023.10.16 05:00,309,0,46,355,0
연산터널→연산교차로,2023.10.16 05:00,118,114,15,247,0
교대→연산교차로,2023.10.16 06:00,180,0,213,393,0
부산시청→연산교차로,2023.10.16 06:00,417,271,105,793,0
사직운동장→연산교차로,2023.10.16 06:00,92,289,30,411,0
신리→연산교차로,2023.10.16 06:00,353,186,27,566,0
안락→연산교차로,2023.10.16 06:00,492,0,107,599,0
연산터널→연산교차로,2023.10.16 06:00,238,243,34,515,0
교대→연산교차로,2023.10.16 07:00,255,0,395,650,0
부산시청→연산교차로,2023.10.16 07:00,573,416,223,1212,0
사직운동장→연산교차로,2023.10.16 07:00,186,539,67,792,0
신리→연산교차로,2023.10.16 07:00,477,333,26,836,0
안락→연산교차로,2023.10.16 07:00,649,0,77,726,0
연산터널→연산교차로,2023.10.16 07:00,297,376,15,688,0
교대→연산교차로,2023.10.16 08:00,315,0,502,817,0
부산시청→연산교차로,2023.10.16 08:00,607,441,315,1363,0
사직운동장→연산교차로,2023.10.16 08:00,190,652,71,913,0
신리→연산교차로,2023.10.16 08:00,512,331,34,877,0
안락→연산교차로,2023.10.16 08:00,604,0,98,702,0
연산터널→연산교차로,2023.10.16 08:00,314,374,24,712,0
교대→연산교차로,2023.10.16 09:00,300,0,488,788,0
부산시청→연산교차로,2023.10.16 09:00,546,399,281,1226,0
사직운동장→연산교차로,2023.10.16 09:00,182,612,104,898,0
신리→연산교차로,2023.10.16 09:00,464,333,54,851,0
안락→연산교차로,2023.10.16 09:00,567,0,101,668,0
연산터널→연산교차로,2023.10.16 09:00,312,336,39,687,0
교대→연산교차로,2023.10.16 10:00,289,0,483,772,0
부산시청→연산교차로,2023.10.16 10:00,542,363,261,1166,0
사직운동장→연산교차로,2023.10.16 10:00,204,594,73,871,0
신리→연산교차로,2023.10.16 10:00,485,255,41,781,0
안락→연산교차로,2023.10.16 10:00,545,0,130,675,0
연산터널→연산교차로,2023.10.16 10:00,276,336,44,656,0
교대→연산교차로,2023.10.16 11:00,286,0,418,704,0
부산시청→연산교차로,2023.10.16 11:00,579,368,265,1212,0
사직운동장→연산교차로,2023.10.16 11:00,199,521,76,796,0
신리→연산교차로,2023.10.16 11:00,456,221,51,728,0
안락→연산교차로,2023.10.16 11:00,482,0,160,642,0
연산터널→연산교차로,2023.10.16 11:00,256,290,56,602,0
교대→연산교차로,2023.10.16 12:00,286,0,372,658,0
부산시청→연산교차로,2023.10.16 12:00,602,364,231,1197,0
사직운동장→연산교차로,2023.10.16 12:00,196,512,96,804,0
신리→연산교차로,2023.10.16 12:00,425,242,52,719,0
안락→연산교차로,2023.10.16 12:00,474,0,150,624,0
연산터널→연산교차로,2023.10.16 12:00,262,289,49,600,0
교대→연산교차로,2023.10.16 13:00,291,0,413,704,0
부산시청→연산교차로,2023.10.16 13:00,537,439,275,1251,0
사직운동장→연산교차로,2023.10.16 13:00,196,587,96,879,0
신리→연산교차로,2023.10.16 13:00,461,272,38,771,0
안락→연산교차로,2023.10.16 13:00,425,0,108,533,0
연산터널→연산교차로,2023.10.16 13:00,225,274,31,530,0
교대→연산교차로,2023.10.16 14:00,355,0,475,830,0
부산시청→연산교차로,2023.10.16 14:00,575,462,423,1460,0
사직운동장→연산교차로,2023.10.16 14:00,213,615,72,900,0
신리→연산교차로,2023.10.16 14:00,481,292,47,820,0
안락→연산교차로,2023.10.16 14:00,422,0,103,525,0
연산터널→연산교차로,2023.10.16 14:00,221,282,39,542,0
교대→연산교차로,2023.10.16 15:00,358,0,463,821,0
부산시청→연산교차로,2023.10.16 15:00,609,489,277,1375,0
사직운동장→연산교차로,2023.10.16 15:00,226,618,90,934,0
신리→연산교차로,2023.10.16 15:00,456,280,54,790,0
안락→연산교차로,2023.10.16 15:00,439,0,100,539,0
연산터널→연산교차로,2023.10.16 15:00,241,285,33,559,0
교대→연산교차로,2023.10.16 16:00,350,0,499,849,0
부산시청→연산교차로,2023.10.16 16:00,609,533,344,1486,0
사직운동장→연산교차로,2023.10.16 16:00,233,677,69,979,0
신리→연산교차로,2023.10.16 16:00,483,281,62,826,0
안락→연산교차로,2023.10.16 16:00,442,0,102,544,0
연산터널→연산교차로,2023.10.16 16:00,230,264,48,542,0
교대→연산교차로,2023.10.16 17:00,349,0,562,911,0
부산시청→연산교차로,2023.10.16 17:00,637,552,291,1480,0
사직운동장→연산교차로,2023.10.16 17:00,225,682,60,967,0
신리→연산교차로,2023.10.16 17:00,508,264,57,829,0
안락→연산교차로,2023.10.16 17:00,441,0,92,533,0
연산터널→연산교차로,2023.10.16 17:00,226,284,45,555,0
교대→연산교차로,2023.10.16 18:00,358,0,541,899,0
부산시청→연산교차로,2023.10.16 18:00,603,564,336,1503,0
사직운동장→연산교차로,2023.10.16 18:00,260,666,52,978,0
신리→연산교차로,2023.10.16 18:00,508,255,43,806,0
안락→연산교차로,2023.10.16 18:00,447,0,94,541,0
연산터널→연산교차로,2023.10.16 18:00,227,280,47,554,0
교대→연산교차로,2023.10.16 19:00,327,0,415,742,0
부산시청→연산교차로,2023.10.16 19:00,491,396,273,1160,0
사직운동장→연산교차로,2023.10.16 19:00,190,549,58,797,0
신리→연산교차로,2023.10.16 19:00,362,230,37,629,0
안락→연산교차로,2023.10.16 19:00,445,0,104,549,0
연산터널→연산교차로,2023.10.16 19:00,210,250,51,511,0
교대→연산교차로,2023.10.16 20:00,281,0,340,621,0
부산시청→연산교차로,2023.10.16 20:00,474,364,211,1049,0
사직운동장→연산교차로,2023.10.16 20:00,171,478,81,730,0
신리→연산교차로,2023.10.16 20:00,294,168,35,497,0
안락→연산교차로,2023.10.16 20:00,371,0,104,475,0
연산터널→연산교차로,2023.10.16 20:00,208,242,49,499,0
교대→연산교차로,2023.10.16 21:00,251,0,278,529,0
부산시청→연산교차로,2023.10.16 21:00,460,295,197,952,0
사직운동장→연산교차로,2023.10.16 21:00,134,405,93,632,0
신리→연산교차로,2023.10.16 21:00,271,175,30,476,0
안락→연산교차로,2023.10.16 21:00,374,0,109,483,0
연산터널→연산교차로,2023.10.16 21:00,221,270,52,543,0
교대→연산교차로,2023.10.16 22:00,211,0,248,459,0
부산시청→연산교차로,2023.10.16 22:00,361,246,144,751,0
사직운동장→연산교차로,2023.10.16 22:00,126,349,71,546,0
신리→연산교차로,2023.10.16 22:00,225,132,29,386,0
안락→연산교차로,2023.10.16 22:00,326,0,85,411,0
연산터널→연산교차로,2023.10.16 22:00,172,220,81,473,0
교대→연산교차로,2023.10.16 23:00,149,0,185,334,0
부산시청→연산교차로,2023.10.16 23:00,302,162,117,581,0
사직운동장→연산교차로,2023.10.16 23:00,85,272,66,423,0
신리→연산교차로,2023.10.16 23:00,171,97,18,286,0
안락→연산교차로,2023.10.16 23:00,219,0,89,308,0
연산터널→연산교차로,2023.10.16 23:00,135,181,103,419,0
교대→연산교차로,2023.10.17 00:00,122,0,177,299,0
부산시청→연산교차로,2023.10.17 00:00,234,145,100,479,0
사직운동장→연산교차로,2023.10.17 00:00,61,197,30,288,0
신리→연산교차로,2023.10.17 00:00,151,77,22,250,0
안락→연산교차로,2023.10.17 00:00,173,0,50,223,0
연산터널→연산교차로,2023.10.17 00:00,117,193,70,380,0
교대→연산교차로,2023.10.17 01:00,85,0,138,223,0
부산시청→연산교차로,2023.10.17 01:00,147,78,64,289,0
사직운동장→연산교차로,2023.10.17 01:00,54,147,45,246,0
신리→연산교차로,2023.10.17 01:00,92,55,17,164,0
안락→연산교차로,2023.10.17 01:00,109,0,34,143,0
연산터널→연산교차로,2023.10.17 01:00,98,120,59,277,0
교대→연산교차로,2023.10.17 02:00,63,0,114,177,0
부산시청→연산교차로,2023.10.17 02:00,109,62,43,214,0
사직운동장→연산교차로,2023.10.17 02:00,38,130,14,182,0
신리→연산교차로,2023.10.17 02:00,73,38,19,130,0
안락→연산교차로,2023.10.17 02:00,100,0,31,131,0
연산터널→연산교차로,2023.10.17 02:00,65,98,42,205,0
교대→연산교차로,2023.10.17 03:00,59,0,104,163,0
부산시청→연산교차로,2023.10.17 03:00,130,71,36,237,0
사직운동장→연산교차로,2023.10.17 03:00,42,124,10,176,0
신리→연산교차로,2023.10.17 03:00,86,33,6,125,0
안락→연산교차로,2023.10.17 03:00,103,0,23,126,0
연산터널→연산교차로,2023.10.17 03:00,79,77,29,185,0
교대→연산교차로,2023.10.17 04:00,41,0,77,118,0
부산시청→연산교차로,2023.10.17 04:00,116,85,42,243,0
사직운동장→연산교차로,2023.10.17 04:00,27,125,10,162,0
신리→연산교차로,2023.10.17 04:00,89,37,9,135,0
안락→연산교차로,2023.10.17 04:00,144,0,34,178,0
연산터널→연산교차로,2023.10.17 04:00,69,95,27,191,0
교대→연산교차로,2023.10.17 05:00,87,0,143,230,0
부산시청→연산교차로,2023.10.17 05:00,220,171,76,467,0
사직운동장→연산교차로,2023.10.17 05:00,43,197,10,250,0
신리→연산교차로,2023.10.17 05:00,219,87,19,325,0
안락→연산교차로,2023.10.17 05:00,296,0,63,359,0
연산터널→연산교차로,2023.10.17 05:00,136,125,25,286,0
교대→연산교차로,2023.10.17 06:00,177,0,220,397,0
부산시청→연산교차로,2023.10.17 06:00,350,257,138,745,0
사직운동장→연산교차로,2023.10.17 06:00,100,284,45,429,0
신리→연산교차로,2023.10.17 06:00,344,195,22,561,0
안락→연산교차로,2023.10.17 06:00,453,0,96,549,0
연산터널→연산교차로,2023.10.17 06:00,261,222,34,517,0
교대→연산교차로,2023.10.17 07:00,275,0,358,633,0
부산시청→연산교차로,2023.10.17 07:00,559,374,229,1162,0
사직운동장→연산교차로,2023.10.17 07:00,183,505,66,754,0
신리→연산교차로,2023.10.17 07:00,481,300,28,809,0
안락→연산교차로,2023.10.17 07:00,647,0,100,747,0
연산터널→연산교차로,2023.10.17 07:00,278,344,19,641,0
교대→연산교차로,2023.10.17 08:00,318,0,499,817,0
부산시청→연산교차로,2023.10.17 08:00,614,424,337,1375,0
사직운동장→연산교차로,2023.10.17 08:00,203,651,61,915,0
신리→연산교차로,2023.10.17 08:00,526,353,24,903,0
안락→연산교차로,2023.10.17 08:00,617,0,85,702,0
연산터널→연산교차로,2023.10.17 08:00,322,375,19,716,0
교대→연산교차로,2023.10.17 09:00,273,0,499,772,0
부산시청→연산교차로,2023.10.17 09:00,540,376,302,1218,0
사직운동장→연산교차로,2023.10.17 09:00,184,575,67,826,0
신리→연산교차로,2023.10.17 09:00,448,333,52,833,0
안락→연산교차로,2023.10.17 09:00,573,0,97,670,0
연산터널→연산교차로,2023.10.17 09:00,279,372,50,701,0
교대→연산교차로,2023.10.17 10:00,301,0,475,776,0
부산시청→연산교차로,2023.10.17 10:00,569,372,260,1201,0
사직운동장→연산교차로,2023.10.17 10:00,201,564,66,831,0
신리→연산교차로,2023.10.17 10:00,447,278,63,788,0
안락→연산교차로,2023.10.17 10:00,513,0,127,640,0
연산터널→연산교차로,2023.10.17 10:00,289,338,61,688,0
교대→연산교차로,2023.10.17 11:00,279,0,398,677,0
부산시청→연산교차로,2023.10.17 11:00,569,375,283,1227,0
사직운동장→연산교차로,2023.10.17 11:00,170,569,69,808,0
신리→연산교차로,2023.10.17 11:00,434,227,45,706,0
안락→연산교차로,2023.10.17 11:00,468,0,168,636,0
연산터널→연산교차로,2023.10.17 11:00,263,276,54,593,0
교대→연산교차로,2023.10.17 12:00,270,0,360,630,0
부산시청→연산교차로,2023.10.17 12:00,530,357,247,1134,0
사직운동장→연산교차로,2023.10.17 12:00,173,554,91,818,0
신리→연산교차로,2023.10.17 12:00,432,221,53,706,0
안락→연산교차로,2023.10.17 12:00,465,0,145,610,0
연산터널→연산교차로,2023.10.17 12:00,286,276,39,601,0
교대→연산교차로,2023.10.17 13:00,304,0,446,750,0
부산시청→연산교차로,2023.10.17 13:00,575,415,281,1271,0
사직운동장→연산교차로,2023.10.17 13:00,245,546,56,847,0
신리→연산교차로,2023.10.17 13:00,404,260,72,736,0
안락→연산교차로,2023.10.17 13:00,437,0,116,553,0
연산터널→연산교차로,2023.10.17 13:00,252,270,32,554,0
교대→연산교차로,2023.10.17 14:00,331,0,493,824,0
부산시청→연산교차로,2023.10.17 14:00,628,443,307,1378,0
사직운동장→연산교차로,2023.10.17 14:00,274,609,0,883,0
신리→연산교차로,2023.10.17 14:00,442,258,59,759,0
안락→연산교차로,2023.10.17 14:00,411,0,109,520,0
연산터널→연산교차로,2023.10.17 14:00,234,268,44,546,0
교대→연산교차로,2023.10.17 15:00,353,0,532,885,0
부산시청→연산교차로,2023.10.17 15:00,619,498,277,1394,0
사직운동장→연산교차로,2023.10.17 15:00,276,615,26,917,0
신리→연산교차로,2023.10.17 15:00,436,273,76,785,0
안락→연산교차로,2023.10.17 15:00,427,0,119,546,0
연산터널→연산교차로,2023.10.17 15:00,234,269,35,538,0
교대→연산교차로,2023.10.17 16:00,355,0,508,863,0
부산시청→연산교차로,2023.10.17 16:00,609,520,330,1459,0
사직운동장→연산교차로,2023.10.17 16:00,248,677,71,996,0
신리→연산교차로,2023.10.17 16:00,499,267,51,817,0
안락→연산교차로,2023.10.17 16:00,458,0,101,559,0
연산터널→연산교차로,2023.10.17 16:00,241,264,42,547,0
교대→연산교차로,2023.10.17 17:00,356,0,526,882,0
부산시청→연산교차로,2023.10.17 17:00,648,558,299,1505,0
사직운동장→연산교차로,2023.10.17 17:00,213,714,69,996,0
신리→연산교차로,2023.10.17 17:00,534,252,66,852,0
안락→연산교차로,2023.10.17 17:00,427,0,132,559,0
연산터널→연산교차로,2023.10.17 17:00,212,293,39,544,0
교대→연산교차로,2023.10.17 18:00,363,0,559,922,0
부산시청→연산교차로,2023.10.17 18:00,581,578,325,1484,0
사직운동장→연산교차로,2023.10.17 18:00,246,676,39,961,0
신리→연산교차로,2023.10.17 18:00,498,267,38,803,0
안락→연산교차로,2023.10.17 18:00,452,0,73,525,0
연산터널→연산교차로,2023.10.17 18:00,199,274,46,519,0
교대→연산교차로,2023.10.17 19:00,357,0,429,786,0
부산시청→연산교차로,2023.10.17 19:00,526,391,278,1195,0
사직운동장→연산교차로,2023.10.17 19:00,185,577,72,834,0
신리→연산교차로,2023.10.17 19:00,327,218,43,588,0
안락→연산교차로,2023.10.17 19:00,441,0,95,536,0
연산터널→연산교차로,2023.10.17 19:00,210,272,57,539,0
교대→연산교차로,2023.10.17 20:00,290,0,310,600,0
부산시청→연산교차로,2023.10.17 20:00,470,352,261,1083,0
사직운동장→연산교차로,2023.10.17 20:00,159,486,75,720,0
신리→연산교차로,2023.10.17 20:00,334,166,26,526,0
안락→연산교차로,2023.10.17 20:00,394,0,101,495,0
연산터널→연산교차로,2023.10.17 20:00,198,266,49,513,0
교대→연산교차로,2023.10.17 21:00,252,0,277,529,0
부산시청→연산교차로,2023.10.17 21:00,462,322,193,977,0
사직운동장→연산교차로,2023.10.17 21:00,165,417,74,656,0
신리→연산교차로,2023.10.17 21:00,296,155,35,486,0
안락→연산교차로,2023.10.17 21:00,362,0,115,477,0
연산터널→연산교차로,2023.10.17 21:00,213,278,58,549,0
교대→연산교차로,2023.10.17 22:00,217,0,241,458,0
부산시청→연산교차로,2023.10.17 22:00,414,255,162,831,0
사직운동장→연산교차로,2023.10.17 22:00,135,355,90,580,0
신리→연산교차로,2023.10.17 22:00,249,142,28,419,0
안락→연산교차로,2023.10.17 22:00,323,0,101,424,0
연산터널→연산교차로,2023.10.17 22:00,189,240,69,498,0
교대→연산교차로,2023.10.17 23:00,165,0,227,392,0
부산시청→연산교차로,2023.10.17 23:00,310,180,135,625,0
사직운동장→연산교차로,2023.10.17 23:00,100,259,63,422,0
신리→연산교차로,2023.10.17 23:00,189,128,31,348,0
안락→연산교차로,2023.10.17 23:00,238,0,68,306,0
연산터널→연산교차로,2023.10.17 23:00,142,172,68,382,0
교대→연산교차로,2023.10.18 00:00,132,0,207,339,0
부산시청→연산교차로,2023.10.18 00:00,249,160,103,512,0
사직운동장→연산교차로,2023.10.18 00:00,48,224,52,324,0
신리→연산교차로,2023.10.18 00:00,149,94,17,260,0
안락→연산교차로,2023.10.18 00:00,198,0,61,259,0
연산터널→연산교차로,2023.10.18 00:00,140,162,68,370,0
교대→연산교차로,2023.10.18 01:00,80,0,130,210,0
부산시청→연산교차로,2023.10.18 01:00,167,102,67,336,0
사직운동장→연산교차로,2023.10.18 01:00,43,157,29,229,0
신리→연산교차로,2023.10.18 01:00,108,61,16,185,0
안락→연산교차로,2023.10.18 01:00,125,0,42,167,0
연산터널→연산교차로,2023.10.18 01:00,100,137,62,299,0
교대→연산교차로,2023.10.18 02:00,56,0,122,178,0
부산시청→연산교차로,2023.10.18 02:00,147,86,66,299,0
사직운동장→연산교차로,2023.10.18 02:00,39,132,13,184,0
신리→연산교차로,2023.10.18 02:00,65,43,20,128,0
안락→연산교차로,2023.10.18 02:00,117,0,36,153,0
연산터널→연산교차로,2023.10.18 02:00,96,117,43,256,0
교대→연산교차로,2023.10.18 03:00,47,0,88,135,0
부산시청→연산교차로,2023.10.18 03:00,143,83,55,281,0
사직운동장→연산교차로,2023.10.18 03:00,32,129,6,167,0
신리→연산교차로,2023.10.18 03:00,75,29,10,114,0
안락→연산교차로,2023.10.18 03:00,103,0,25,128,0
연산터널→연산교차로,2023.10.18 03:00,68,76,47,191,0
교대→연산교차로,2023.10.18 04:00,48,0,89,137,0
부산시청→연산교차로,2023.10.18 04:00,137,63,40,240,0
사직운동장→연산교차로,2023.10.18 04:00,35,126,7,168,0
신리→연산교차로,2023.10.18 04:00,79,43,7,129,0
안락→연산교차로,2023.10.18 04:00,164,0,32,196,0
연산터널→연산교차로,2023.10.18 04:00,90,83,41,214,0
교대→연산교차로,2023.10.18 05:00,90,0,115,205,0
부산시청→연산교차로,2023.10.18 05:00,246,169,81,496,0
사직운동장→연산교차로,2023.10.18 05:00,52,171,7,230,0
신리→연산교차로,2023.10.18 05:00,185,95,10,290,0
안락→연산교차로,2023.10.18 05:00,283,0,58,341,0
연산터널→연산교차로,2023.10.18 05:00,126,167,26,319,0
교대→연산교차로,2023.10.18 06:00,163,0,237,400,0
부산시청→연산교차로,2023.10.18 06:00,368,275,109,752,0
사직운동장→연산교차로,2023.10.18 06:00,85,267,30,382,0
신리→연산교차로,2023.10.18 06:00,331,188,22,541,0
안락→연산교차로,2023.10.18 06:00,495,0,116,611,0
연산터널→연산교차로,2023.10.18 06:00,233,226,22,481,0
교대→연산교차로,2023.10.18 07:00,264,0,372,636,0
부산시청→연산교차로,2023.10.18 07:00,561,374,243,1178,0
사직운동장→연산교차로,2023.10.18 07:00,177,515,69,761,0
신리→연산교차로,2023.10.18 07:00,475,305,22,802,0
안락→연산교차로,2023.10.18 07:00,614,0,80,694,0
연산터널→연산교차로,2023.10.18 07:00,308,340,36,684,0
교대→연산교차로,2023.10.18 08:00,307,0,504,811,0
부산시청→연산교차로,2023.10.18 08:00,611,419,356,1386,0
사직운동장→연산교차로,2023.10.18 08:00,190,630,51,871,0
신리→연산교차로,2023.10.18 08:00,531,323,24,878,0
안락→연산교차로,2023.10.18 08:00,564,0,90,654,0
연산터널→연산교차로,2023.10.18 08:00,297,394,22,713,0
교대→연산교차로,2023.10.18 09:00,268,0,503,771,0
부산시청→연산교차로,2023.10.18 09:00,563,399,279,1241,0
사직운동장→연산교차로,2023.10.18 09:00,187,551,82,820,0
신리→연산교차로,2023.10.18 09:00,459,328,41,828,0
안락→연산교차로,2023.10.18 09:00,578,0,97,675,0
연산터널→연산교차로,2023.10.18 09:00,281,357,43,681,0
교대→연산교차로,2023.10.18 10:00,287,0,445,732,0
부산시청→연산교차로,2023.10.18 10:00,548,381,267,1196,0
사직운동장→연산교차로,2023.10.18 10:00,208,573,67,848,0
신리→연산교차로,2023.10.18 10:00,455,292,58,805,0
안락→연산교차로,2023.10.18 10:00,554,0,112,666,0
연산터널→연산교차로,2023.10.18 10:00,262,307,37,606,0
교대→연산교차로,2023.10.18 11:00,283,0,434,717,0
부산시청→연산교차로,2023.10.18 11:00,559,376,254,1189,0
사직운동장→연산교차로,2023.10.18 11:00,207,535,61,803,0
신리→연산교차로,2023.10.18 11:00,416,259,60,735,0
안락→연산교차로,2023.10.18 11:00,487,0,123,610,0
연산터널→연산교차로,2023.10.18 11:00,279,302,39,620,0
교대→연산교차로,2023.10.18 12:00,276,0,363,639,0
부산시청→연산교차로,2023.10.18 12:00,552,315,219,1086,0
사직운동장→연산교차로,2023.10.18 12:00,199,564,85,848,0
신리→연산교차로,2023.10.18 12:00,397,235,48,680,0
안락→연산교차로,2023.10.18 12:00,476,0,147,623,0
연산터널→연산교차로,2023.10.18 12:00,258,281,42,581,0
교대→연산교차로,2023.10.18 13:00,314,0,382,696,0
부산시청→연산교차로,2023.10.18 13:00,546,429,262,1237,0
사직운동장→연산교차로,2023.10.18 13:00,193,567,109,869,0
신리→연산교차로,2023.10.18 13:00,420,289,63,772,0
안락→연산교차로,2023.10.18 13:00,431,0,112,543,0
연산터널→연산교차로,2023.10.18 13:00,228,288,33,549,0
교대→연산교차로,2023.10.18 14:00,337,0,457,794,0
부산시청→연산교차로,2023.10.18 14:00,554,428,273,1255,0
사직운동장→연산교차로,2023.10.18 14:00,224,650,89,963,0
신리→연산교차로,2023.10.18 14:00,450,282,59,791,0
안락→연산교차로,2023.10.18 14:00,411,0,112,523,0
연산터널→연산교차로,2023.10.18 14:00,250,253,41,544,0
교대→연산교차로,2023.10.18 15:00,358,0,445,803,0
부산시청→연산교차로,2023.10.18 15:00,582,468,286,1336,0
사직운동장→연산교차로,2023.10.18 15:00,234,651,87,972,0
신리→연산교차로,2023.10.18 15:00,437,279,52,768,0
안락→연산교차로,2023.10.18 15:00,431,0,114,545,0
연산터널→연산교차로,2023.10.18 15:00,226,277,46,549,0
교대→연산교차로,2023.10.18 16:00,343,0,443,786,0
부산시청→연산교차로,2023.10.18 16:00,662,500,292,1454,0
사직운동장→연산교차로,2023.10.18 16:00,224,672,68,964,0
신리→연산교차로,2023.10.18 16:00,522,271,55,848,0
안락→연산교차로,2023.10.18 16:00,448,0,98,546,0
연산터널→연산교차로,2023.10.18 16:00,240,298,42,580,0
교대→연산교차로,2023.10.18 17:00,352,0,516,868,0
부산시청→연산교차로,2023.10.18 17:00,630,533,314,1477,0
사직운동장→연산교차로,2023.10.18 17:00,232,667,79,978,0
신리→연산교차로,2023.10.18 17:00,519,285,58,862,0
안락→연산교차로,2023.10.18 17:00,456,0,92,548,0
연산터널→연산교차로,2023.10.18 17:00,216,283,52,551,0
교대→연산교차로,2023.10.18 18:00,356,0,535,891,0
부산시청→연산교차로,2023.10.18 18:00,609,587,347,1543,0
사직운동장→연산교차로,2023.10.18 18:00,226,669,58,953,0
신리→연산교차로,2023.10.18 18:00,501,208,50,759,0
안락→연산교차로,2023.10.18 18:00,466,0,79,545,0
연산터널→연산교차로,2023.10.18 18:00,225,273,50,548,0
교대→연산교차로,2023.10.18 19:00,303,0,406,709,0
부산시청→연산교차로,2023.10.18 19:00,512,404,254,1170,0
사직운동장→연산교차로,2023.10.18 19:00,210,547,63,820,0
신리→연산교차로,2023.10.18 19:00,340,208,49,597,0
안락→연산교차로,2023.10.18 19:00,430,0,94,524,0
연산터널→연산교차로,2023.10.18 19:00,216,268,55,539,0
교대→연산교차로,2023.10.18 20:00,318,0,336,654,0
부산시청→연산교차로,2023.10.18 20:00,491,354,231,1076,0
사직운동장→연산교차로,2023.10.18 20:00,177,470,80,727,0
신리→연산교차로,2023.10.18 20:00,301,178,25,504,0
안락→연산교차로,2023.10.18 20:00,418,0,91,509,0
연산터널→연산교차로,2023.10.18 20:00,176,263,56,495,0
교대→연산교차로,2023.10.18 21:00,256,0,270,526,0
부산시청→연산교차로,2023.10.18 21:00,482,330,190,1002,0
사직운동장→연산교차로,2023.10.18 21:00,162,389,73,624,0
신리→연산교차로,2023.10.18 21:00,306,166,41,513,0
안락→연산교차로,2023.10.18 21:00,387,0,97,484,0
연산터널→연산교차로,2023.10.18 21:00,206,246,63,515,0
교대→연산교차로,2023.10.18 22:00,230,0,239,469,0
부산시청→연산교차로,2023.10.18 22:00,382,233,180,795,0
사직운동장→연산교차로,2023.10.18 22:00,133,337,54,524,0
신리→연산교차로,2023.10.18 22:00,251,177,32,460,0
안락→연산교차로,2023.10.18 22:00,360,0,102,462,0
연산터널→연산교차로,2023.10.18 22:00,155,230,59,444,0
교대→연산교차로,2023.10.18 23:00,201,0,204,405,0
부산시청→연산교차로,2023.10.18 23:00,295,193,127,615,0
사직운동장→연산교차로,2023.10.18 23:00,96,295,66,457,0
신리→연산교차로,2023.10.18 23:00,213,107,27,347,0
안락→연산교차로,2023.10.18 23:00,258,0,64,322,0
연산터널→연산교차로,2023.10.18 23:00,135,199,70,404,0
교대→연산교차로,2023.10.19 00:00,129,0,201,330,0
부산시청→연산교차로,2023.10.19 00:00,264,149,117,530,0
사직운동장→연산교차로,2023.10.19 00:00,55,231,48,334,0
신리→연산교차로,2023.10.19 00:00,157,95,23,275,0
안락→연산교차로,2023.10.19 00:00,217,0,74,291,0
연산터널→연산교차로,2023.10.19 00:00,137,184,63,384,0
교대→연산교차로,2023.10.19 01:00,109,0,176,285,0
부산시청→연산교차로,2023.10.19 01:00,171,110,69,350,0
사직운동장→연산교차로,2023.10.19 01:00,44,172,36,252,0
신리→연산교차로,2023.10.19 01:00,126,78,17,221,0
안락→연산교차로,2023.10.19 01:00,137,0,50,187,0
연산터널→연산교차로,2023.10.19 01:00,123,138,68,329,0
교대→연산교차로,2023.10.19 02:00,69,0,98,167,0
부산시청→연산교차로,2023.10.19 02:00,146,89,50,285,0
사직운동장→연산교차로,2023.10.19 02:00,42,169,20,231,0
신리→연산교차로,2023.10.19 02:00,97,49,13,159,0
안락→연산교차로,2023.10.19 02:00,129,0,23,152,0
연산터널→연산교차로,2023.10.19 02:00,97,122,50,269,0
교대→연산교차로,2023.10.19 03:00,46,0,105,151,0
부산시청→연산교차로,2023.10.19 03:00,137,69,40,246,0
사직운동장→연산교차로,2023.10.19 03:00,27,131,8,166,0
신리→연산교차로,2023.10.19 03:00,68,32,10,110,0
안락→연산교차로,2023.10.19 03:00,114,0,25,139,0
연산터널→연산교차로,2023.10.19 03:00,75,87,46,208,0
교대→연산교차로,2023.10.19 04:00,61,0,67,128,0
부산시청→연산교차로,2023.10.19 04:00,163,68,46,277,0
사직운동장→연산교차로,2023.10.19 04:00,26,131,13,170,0
신리→연산교차로,2023.10.19 04:00,91,42,11,144,0
안락→연산교차로,2023.10.19 04:00,161,0,30,191,0
연산터널→연산교차로,2023.10.19 04:00,69,106,25,200,0
교대→연산교차로,2023.10.19 05:00,83,0,126,209,0
부산시청→연산교차로,2023.10.19 05:00,224,173,72,469,0
사직운동장→연산교차로,2023.10.19 05:00,53,191,4,248,0
신리→연산교차로,2023.10.19 05:00,212,95,18,325,0
안락→연산교차로,2023.10.19 05:00,310,0,54,364,0
연산터널→연산교차로,2023.10.19 05:00,144,155,27,326,0
교대→연산교차로,2023.10.19 06:00,172,0,210,382,0
부산시청→연산교차로,2023.10.19 06:00,380,268,97,745,0
사직운동장→연산교차로,2023.10.19 06:00,107,294,48,449,0
신리→연산교차로,2023.10.19 06:00,331,191,18,540,0
안락→연산교차로,2023.10.19 06:00,453,0,102,555,0
연산터널→연산교차로,2023.10.19 06:00,228,219,44,491,0
교대→연산교차로,2023.10.19 07:00,265,0,387,652,0
부산시청→연산교차로,2023.10.19 07:00,557,390,220,1167,0
사직운동장→연산교차로,2023.10.19 07:00,172,499,80,751,0
신리→연산교차로,2023.10.19 07:00,462,314,28,804,0
안락→연산교차로,2023.10.19 07:00,647,0,79,726,0
연산터널→연산교차로,2023.10.19 07:00,281,364,35,680,0
교대→연산교차로,2023.10.19 08:00,305,0,482,787,0
부산시청→연산교차로,2023.10.19 08:00,608,439,322,1369,0
사직운동장→연산교차로,2023.10.19 08:00,192,650,65,907,0
신리→연산교차로,2023.10.19 08:00,527,344,28,899,0
안락→연산교차로,2023.10.19 08:00,596,0,92,688,0
연산터널→연산교차로,2023.10.19 08:00,323,384,25,732,0
교대→연산교차로,2023.10.19 09:00,285,0,471,756,0
부산시청→연산교차로,2023.10.19 09:00,559,385,262,1206,0
사직운동장→연산교차로,2023.10.19 09:00,181,550,89,820,0
신리→연산교차로,2023.10.19 09:00,449,317,43,809,0
안락→연산교차로,2023.10.19 09:00,581,0,104,685,0
연산터널→연산교차로,2023.10.19 09:00,289,377,54,720,0
교대→연산교차로,2023.10.19 10:00,282,0,416,698,0
부산시청→연산교차로,2023.10.19 10:00,592,355,280,1227,0
사직운동장→연산교차로,2023.10.19 10:00,203,568,76,847,0
신리→연산교차로,2023.10.19 10:00,424,277,57,758,0
안락→연산교차로,2023.10.19 10:00,515,0,137,652,0
연산터널→연산교차로,2023.10.19 10:00,313,298,47,658,0
교대→연산교차로,2023.10.19 11:00,307,0,432,739,0
부산시청→연산교차로,2023.10.19 11:00,593,375,255,1223,0
사직운동장→연산교차로,2023.10.19 11:00,178,591,90,859,0
신리→연산교차로,2023.10.19 11:00,458,266,48,772,0
안락→연산교차로,2023.10.19 11:00,509,0,155,664,0
연산터널→연산교차로,2023.10.19 11:00,282,285,62,629,0
교대→연산교차로,2023.10.19 12:00,274,0,406,680,0
부산시청→연산교차로,2023.10.19 12:00,549,371,363,1283,0
사직운동장→연산교차로,2023.10.19 12:00,185,544,78,807,0
신리→연산교차로,2023.10.19 12:00,395,204,57,656,0
안락→연산교차로,2023.10.19 12:00,467,0,148,615,0
연산터널→연산교차로,2023.10.19 12:00,258,280,60,598,0
교대→연산교차로,2023.10.19 13:00,319,0,441,760,0
부산시청→연산교차로,2023.10.19 13:00,515,465,297,1277,0
사직운동장→연산교차로,2023.10.19 13:00,199,542,90,831,0
신리→연산교차로,2023.10.19 13:00,439,271,50,760,0
안락→연산교차로,2023.10.19 13:00,431,0,116,547,0
연산터널→연산교차로,2023.10.19 13:00,227,270,38,535,0
교대→연산교차로,2023.10.19 14:00,327,0,433,760,0
부산시청→연산교차로,2023.10.19 14:00,595,458,260,1313,0
사직운동장→연산교차로,2023.10.19 14:00,214,566,86,866,0
신리→연산교차로,2023.10.19 14:00,444,299,48,791,0
안락→연산교차로,2023.10.19 14:00,399,0,127,526,0
연산터널→연산교차로,2023.10.19 14:00,248,251,49,548,0
교대→연산교차로,2023.10.19 15:00,343,0,445,788,0
부산시청→연산교차로,2023.10.19 15:00,620,437,261,1318,0
사직운동장→연산교차로,2023.10.19 15:00,246,651,80,977,0
신리→연산교차로,2023.10.19 15:00,463,267,50,780,0
안락→연산교차로,2023.10.19 15:00,424,0,108,532,0
연산터널→연산교차로,2023.10.19 15:00,250,265,35,550,0
교대→연산교차로,2023.10.19 16:00,308,0,481,789,0
부산시청→연산교차로,2023.10.19 16:00,660,510,301,1471,0
사직운동장→연산교차로,2023.10.19 16:00,227,664,72,963,0
신리→연산교차로,2023.10.19 16:00,513,298,48,859,0
안락→연산교차로,2023.10.19 16:00,432,0,113,545,0
연산터널→연산교차로,2023.10.19 16:00,244,291,45,580,0
교대→연산교차로,2023.10.19 17:00,365,0,472,837,0
부산시청→연산교차로,2023.10.19 17:00,650,550,304,1504,0
사직운동장→연산교차로,2023.10.19 17:00,238,668,56,962,0
신리→연산교차로,2023.10.19 17:00,502,273,57,832,0
안락→연산교차로,2023.10.19 17:00,442,0,101,543,0
연산터널→연산교차로,2023.10.19 17:00,236,272,38,546,0
교대→연산교차로,2023.10.19 18:00,362,0,592,954,0
부산시청→연산교차로,2023.10.19 18:00,594,538,336,1468,0
사직운동장→연산교차로,2023.10.19 18:00,218,637,57,912,0
신리→연산교차로,2023.10.19 18:00,487,262,42,791,0
안락→연산교차로,2023.10.19 18:00,439,0,103,542,0
연산터널→연산교차로,2023.10.19 18:00,204,289,44,537,0
교대→연산교차로,2023.10.19 19:00,312,0,438,750,0
부산시청→연산교차로,2023.10.19 19:00,524,395,261,1180,0
사직운동장→연산교차로,2023.10.19 19:00,203,558,72,833,0
신리→연산교차로,2023.10.19 19:00,361,197,41,599,0
안락→연산교차로,2023.10.19 19:00,416,0,91,507,0
연산터널→연산교차로,2023.10.19 19:00,222,241,65,528,0
교대→연산교차로,2023.10.19 20:00,307,0,335,642,0
부산시청→연산교차로,2023.10.19 20:00,464,351,218,1033,0
사직운동장→연산교차로,2023.10.19 20:00,146,460,66,672,0
신리→연산교차로,2023.10.19 20:00,301,161,41,503,0
안락→연산교차로,2023.10.19 20:00,405,0,87,492,0
연산터널→연산교차로,2023.10.19 20:00,179,247,47,473,0
교대→연산교차로,2023.10.19 21:00,279,0,343,622,0
부산시청→연산교차로,2023.10.19 21:00,479,335,199,1013,0
사직운동장→연산교차로,2023.10.19 21:00,168,406,65,639,0
신리→연산교차로,2023.10.19 21:00,321,190,31,542,0
안락→연산교차로,2023.10.19 21:00,405,0,99,504,0
연산터널→연산교차로,2023.10.19 21:00,204,234,57,495,0
교대→연산교차로,2023.10.19 22:00,245,0,252,497,0
부산시청→연산교차로,2023.10.19 22:00,405,273,169,847,0
사직운동장→연산교차로,2023.10.19 22:00,144,363,68,575,0
신리→연산교차로,2023.10.19 22:00,234,145,32,411,0
안락→연산교차로,2023.10.19 22:00,343,0,90,433,0
연산터널→연산교차로,2023.10.19 22:00,186,253,70,509,0
교대→연산교차로,2023.10.19 23:00,194,0,220,414,0
부산시청→연산교차로,2023.10.19 23:00,313,178,121,612,0
사직운동장→연산교차로,2023.10.19 23:00,114,272,55,441,0
신리→연산교차로,2023.10.19 23:00,209,111,23,343,0
안락→연산교차로,2023.10.19 23:00,276,0,69,345,0
연산터널→연산교차로,2023.10.19 23:00,141,229,71,441,0
교대→연산교차로,2023.10.20 00:00,162,0,187,349,0
부산시청→연산교차로,2023.10.20 00:00,239,153,123,515,0
사직운동장→연산교차로,2023.10.20 00:00,66,230,42,338,0
신리→연산교차로,2023.10.20 00:00,188,102,21,311,0
안락→연산교차로,2023.10.20 00:00,217,0,49,266,0
연산터널→연산교차로,2023.10.20 00:00,144,191,49,384,0
교대→연산교차로,2023.10.20 01:00,111,0,175,286,0
부산시청→연산교차로,2023.10.20 01:00,170,113,69,352,0
사직운동장→연산교차로,2023.10.20 01:00,38,160,33,231,0
신리→연산교차로,2023.10.20 01:00,100,68,22,190,0
안락→연산교차로,2023.10.20 01:00,153,0,46,199,0
연산터널→연산교차로,2023.10.20 01:00,123,138,63,324,0
교대→연산교차로,2023.10.20 02:00,73,0,140,213,0
부산시청→연산교차로,2023.10.20 02:00,151,64,55,270,0
사직운동장→연산교차로,2023.10.20 02:00,19,139,16,174,0
신리→연산교차로,2023.10.20 02:00,67,63,9,139,0
안락→연산교차로,2023.10.20 02:00,128,0,28,156,0
연산터널→연산교차로,2023.10.20 02:00,84,122,42,248,0
교대→연산교차로,2023.10.20 03:00,53,0,87,140,0
부산시청→연산교차로,2023.10.20 03:00,162,84,38,284,0
사직운동장→연산교차로,2023.10.20 03:00,30,110,15,155,0
신리→연산교차로,2023.10.20 03:00,78,30,6,114,0
안락→연산교차로,2023.10.20 03:00,126,0,20,146,0
연산터널→연산교차로,2023.10.20 03:00,67,101,35,203,0
교대→연산교차로,2023.10.20 04:00,50,0,84,134,0
부산시청→연산교차로,2023.10.20 04:00,149,69,51,269,0
사직운동장→연산교차로,2023.10.20 04:00,34,109,9,152,0
신리→연산교차로,2023.10.20 04:00,95,43,8,146,0
안락→연산교차로,2023.10.20 04:00,166,0,36,202,0
연산터널→연산교차로,2023.10.20 04:00,74,84,32,190,0
교대→연산교차로,2023.10.20 05:00,89,0,118,207,0
부산시청→연산교차로,2023.10.20 05:00,217,165,70,452,0
사직운동장→연산교차로,2023.10.20 05:00,40,190,13,243,0
신리→연산교차로,2023.10.20 05:00,203,86,8,297,0
안락→연산교차로,2023.10.20 05:00,315,0,60,375,0
연산터널→연산교차로,2023.10.20 05:00,141,151,20,312,0
교대→연산교차로,2023.10.20 06:00,160,0,200,360,0
부산시청→연산교차로,2023.10.20 06:00,361,260,118,739,0
사직운동장→연산교차로,2023.10.20 06:00,63,249,23,335,0
신리→연산교차로,2023.10.20 06:00,309,173,16,498,0
안락→연산교차로,2023.10.20 06:00,474,0,76,550,0
연산터널→연산교차로,2023.10.20 06:00,220,221,30,471,0
교대→연산교차로,2023.10.20 07:00,239,0,388,627,0
부산시청→연산교차로,2023.10.20 07:00,536,366,187,1089,0
사직운동장→연산교차로,2023.10.20 07:00,175,512,62,749,0
신리→연산교차로,2023.10.20 07:00,468,284,11,763,0
안락→연산교차로,2023.10.20 07:00,611,0,86,697,0
연산터널→연산교차로,2023.10.20 07:00,293,347,41,681,0
교대→연산교차로,2023.10.20 08:00,295,0,535,830,0
부산시청→연산교차로,2023.10.20 08:00,572,444,356,1372,0
사직운동장→연산교차로,2023.10.20 08:00,198,672,74,944,0
신리→연산교차로,2023.10.20 08:00,502,364,24,890,0
안락→연산교차로,2023.10.20 08:00,615,0,97,712,0
연산터널→연산교차로,2023.10.20 08:00,325,393,33,751,0
교대→연산교차로,2023.10.20 09:00,288,0,474,762,0
부산시청→연산교차로,2023.10.20 09:00,541,380,295,1216,0
사직운동장→연산교차로,2023.10.20 09:00,186,604,89,879,0
신리→연산교차로,2023.10.20 09:00,462,327,35,824,0
안락→연산교차로,2023.10.20 09:00,604,0,100,704,0
연산터널→연산교차로,2023.10.20 09:00,280,369,65,714,0
교대→연산교차로,2023.10.20 10:00,285,0,419,704,0
부산시청→연산교차로,2023.10.20 10:00,544,385,258,1187,0
사직운동장→연산교차로,2023.10.20 10:00,222,567,66,855,0
신리→연산교차로,2023.10.20 10:00,482,305,42,829,0
안락→연산교차로,2023.10.20 10:00,508,0,174,682,0
연산터널→연산교차로,2023.10.20 10:00,282,328,55,665,0
교대→연산교차로,2023.10.20 11:00,298,0,458,756,0
부산시청→연산교차로,2023.10.20 11:00,556,366,251,1173,0
사직운동장→연산교차로,2023.10.20 11:00,202,540,62,804,0
신리→연산교차로,2023.10.20 11:00,461,261,45,767,0
안락→연산교차로,2023.10.20 11:00,474,0,193,667,0
연산터널→연산교차로,2023.10.20 11:00,263,283,60,606,0
교대→연산교차로,2023.10.20 12:00,277,0,355,632,0
부산시청→연산교차로,2023.10.20 12:00,565,350,256,1171,0
사직운동장→연산교차로,2023.10.20 12:00,167,565,90,822,0
신리→연산교차로,2023.10.20 12:00,430,222,54,706,0
안락→연산교차로,2023.10.20 12:00,476,0,164,640,0
연산터널→연산교차로,2023.10.20 12:00,266,277,42,585,0
교대→연산교차로,2023.10.20 13:00,320,0,443,763,0
부산시청→연산교차로,2023.10.20 13:00,574,446,255,1275,0
사직운동장→연산교차로,2023.10.20 13:00,210,549,98,857,0
신리→연산교차로,2023.10.20 13:00,465,263,69,797,0
안락→연산교차로,2023.10.20 13:00,443,0,118,561,0
연산터널→연산교차로,2023.10.20 13:00,220,276,40,536,0
교대→연산교차로,2023.10.20 14:00,339,0,471,810,0
부산시청→연산교차로,2023.10.20 14:00,582,475,300,1357,0
사직운동장→연산교차로,2023.10.20 14:00,212,642,85,939,0
신리→연산교차로,2023.10.20 14:00,458,278,58,794,0
안락→연산교차로,2023.10.20 14:00,426,0,112,538,0
연산터널→연산교차로,2023.10.20 14:00,211,292,47,550,0
교대→연산교차로,2023.10.20 15:00,352,0,490,842,0
부산시청→연산교차로,2023.10.20 15:00,644,504,308,1456,0
사직운동장→연산교차로,2023.10.20 15:00,233,638,84,955,0
신리→연산교차로,2023.10.20 15:00,493,276,59,828,0
안락→연산교차로,2023.10.20 15:00,433,0,100,533,0
연산터널→연산교차로,2023.10.20 15:00,240,283,50,573,0
교대→연산교차로,2023.10.20 16:00,365,0,524,889,0
부산시청→연산교차로,2023.10.20 16:00,611,541,323,1475,0
사직운동장→연산교차로,2023.10.20 16:00,247,663,66,976,0
신리→연산교차로,2023.10.20 16:00,519,295,64,878,0
안락→연산교차로,2023.10.20 16:00,432,0,113,545,0
연산터널→연산교차로,2023.10.20 16:00,234,279,43,556,0
교대→연산교차로,2023.10.20 17:00,364,0,514,878,0
부산시청→연산교차로,2023.10.20 17:00,623,566,319,1508,0
사직운동장→연산교차로,2023.10.20 17:00,216,712,57,985,0
신리→연산교차로,2023.10.20 17:00,522,286,51,859,0
안락→연산교차로,2023.10.20 17:00,433,0,113,546,0
연산터널→연산교차로,2023.10.20 17:00,224,286,35,545,0
교대→연산교차로,2023.10.20 18:00,341,0,566,907,0
부산시청→연산교차로,2023.10.20 18:00,618,573,333,1524,0
사직운동장→연산교차로,2023.10.20 18:00,235,684,45,964,0
신리→연산교차로,2023.10.20 18:00,501,238,40,779,0
안락→연산교차로,2023.10.20 18:00,445,0,100,545,0
연산터널→연산교차로,2023.10.20 18:00,193,295,52,540,0
교대→연산교차로,2023.10.20 19:00,336,0,459,795,0
부산시청→연산교차로,2023.10.20 19:00,562,399,277,1238,0
사직운동장→연산교차로,2023.10.20 19:00,190,592,69,851,0
신리→연산교차로,2023.10.20 19:00,388,222,44,654,0
안락→연산교차로,2023.10.20 19:00,448,0,85,533,0
연산터널→연산교차로,2023.10.20 19:00,230,280,56,566,0
교대→연산교차로,2023.10.20 20:00,304,0,396,700,0
부산시청→연산교차로,2023.10.20 20:00,492,329,230,1051,0
사직운동장→연산교차로,2023.10.20 20:00,203,521,85,809,0
신리→연산교차로,2023.10.20 20:00,379,185,38,602,0
안락→연산교차로,2023.10.20 20:00,418,0,126,544,0
연산터널→연산교차로,2023.10.20 20:00,226,259,55,540,0
교대→연산교차로,2023.10.20 21:00,271,0,344,615,0
부산시청→연산교차로,2023.10.20 21:00,511,336,223,1070,0
사직운동장→연산교차로,2023.10.20 21:00,189,436,79,704,0
신리→연산교차로,2023.10.20 21:00,305,200,29,534,0
안락→연산교차로,2023.10.20 21:00,426,0,148,574,0
연산터널→연산교차로,2023.10.20 21:00,229,286,73,588,0
교대→연산교차로,2023.10.20 22:00,263,0,318,581,0
부산시청→연산교차로,2023.10.20 22:00,423,253,194,870,0
사직운동장→연산교차로,2023.10.20 22:00,154,392,89,635,0
신리→연산교차로,2023.10.20 22:00,289,191,36,516,0
안락→연산교차로,2023.10.20 22:00,366,0,116,482,0
연산터널→연산교차로,2023.10.20 22:00,231,288,59,578,0
교대→연산교차로,2023.10.20 23:00,212,0,255,467,0
부산시청→연산교차로,2023.10.20 23:00,366,216,154,736,0
사직운동장→연산교차로,2023.10.20 23:00,89,301,75,465,0
신리→연산교차로,2023.10.20 23:00,217,139,34,390,0
안락→연산교차로,2023.10.20 23:00,296,0,105,401,0
연산터널→연산교차로,2023.10.20 23:00,167,246,76,489,0
교대→연산교차로,2023.10.21 00:00,175,0,260,435,0
부산시청→연산교차로,2023.10.21 00:00,318,209,151,678,0
사직운동장→연산교차로,2023.10.21 00:00,104,302,58,464,0
신리→연산교차로,2023.10.21 00:00,223,150,15,388,0
안락→연산교차로,2023.10.21 00:00,283,0,79,362,0
연산터널→연산교차로,2023.10.21 00:00,156,195,35,386,0
교대→연산교차로,2023.10.21 01:00,148,0,258,406,0
부산시청→연산교차로,2023.10.21 01:00,250,177,96,523,0
사직운동장→연산교차로,2023.10.21 01:00,64,234,53,351,0
신리→연산교차로,2023.10.21 01:00,181,99,18,298,0
안락→연산교차로,2023.10.21 01:00,225,0,60,285,0
연산터널→연산교차로,2023.10.21 01:00,139,218,60,417,0
교대→연산교차로,2023.10.21 02:00,93,0,170,263,0
부산시청→연산교차로,2023.10.21 02:00,209,111,79,399,0
사직운동장→연산교차로,2023.10.21 02:00,51,160,25,236,0
신리→연산교차로,2023.10.21 02:00,110,71,13,194,0
안락→연산교차로,2023.10.21 02:00,144,0,50,194,0
연산터널→연산교차로,2023.10.21 02:00,108,142,34,284,0
교대→연산교차로,2023.10.21 03:00,105,0,159,264,0
부산시청→연산교차로,2023.10.21 03:00,215,111,57,383,0
사직운동장→연산교차로,2023.10.21 03:00,43,172,21,236,0
신리→연산교차로,2023.10.21 03:00,103,54,14,171,0
안락→연산교차로,2023.10.21 03:00,148,0,33,181,0
연산터널→연산교차로,2023.10.21 03:00,100,129,40,269,0
교대→연산교차로,2023.10.21 04:00,70,0,123,193,0
부산시청→연산교차로,2023.10.21 04:00,184,89,60,333,0
사직운동장→연산교차로,2023.10.21 04:00,39,149,10,198,0
신리→연산교차로,2023.10.21 04:00,96,58,8,162,0
안락→연산교차로,2023.10.21 04:00,169,0,42,211,0
연산터널→연산교차로,2023.10.21 04:00,97,119,30,246,0
교대→연산교차로,2023.10.21 05:00,97,0,148,245,0
부산시청→연산교차로,2023.10.21 05:00,221,155,70,446,0
사직운동장→연산교차로,2023.10.21 05:00,59,176,16,251,0
신리→연산교차로,2023.10.21 05:00,193,72,9,274,0
안락→연산교차로,2023.10.21 05:00,287,0,48,335,0
연산터널→연산교차로,2023.10.21 05:00,116,148,31,295,0
교대→연산교차로,2023.10.21 06:00,145,0,205,350,0
부산시청→연산교차로,2023.10.21 06:00,360,265,101,726,0
사직운동장→연산교차로,2023.10.21 06:00,72,246,31,349,0
신리→연산교차로,2023.10.21 06:00,293,142,10,445,0
안락→연산교차로,2023.10.21 06:00,370,0,83,453,0
연산터널→연산교차로,2023.10.21 06:00,200,184,27,411,0
교대→연산교차로,2023.10.21 07:00,168,0,187,355,0
부산시청→연산교차로,2023.10.21 07:00,387,273,156,816,0
사직운동장→연산교차로,2023.10.21 07:00,124,350,52,526,0
신리→연산교차로,2023.10.21 07:00,310,186,34,530,0
안락→연산교차로,2023.10.21 07:00,430,0,99,529,0
연산터널→연산교차로,2023.10.21 07:00,188,195,39,422,0
교대→연산교차로,2023.10.21 08:00,289,0,294,583,0
부산시청→연산교차로,2023.10.21 08:00,484,328,239,1051,0
사직운동장→연산교차로,2023.10.21 08:00,190,544,49,783,0
신리→연산교차로,2023.10.21 08:00,449,253,45,747,0
안락→연산교차로,2023.10.21 08:00,523,0,123,646,0
연산터널→연산교차로,2023.10.21 08:00,304,298,47,649,0
교대→연산교차로,2023.10.21 09:00,289,0,362,651,0
부산시청→연산교차로,2023.10.21 09:00,552,395,248,1195,0
사직운동장→연산교차로,2023.10.21 09:00,179,606,74,859,0
신리→연산교차로,2023.10.21 09:00,524,293,67,884,0
안락→연산교차로,2023.10.21 09:00,564,0,142,706,0
연산터널→연산교차로,2023.10.21 09:00,298,346,60,704,0
교대→연산교차로,2023.10.21 10:00,294,0,402,696,0
부산시청→연산교차로,2023.10.21 10:00,607,384,266,1257,0
사직운동장→연산교차로,2023.10.21 10:00,218,609,56,883,0
신리→연산교차로,2023.10.21 10:00,521,284,52,857,0
안락→연산교차로,2023.10.21 10:00,568,0,151,719,0
연산터널→연산교차로,2023.10.21 10:00,267,350,59,676,0
교대→연산교차로,2023.10.21 11:00,293,0,418,711,0
부산시청→연산교차로,2023.10.21 11:00,592,408,277,1277,0
사직운동장→연산교차로,2023.10.21 11:00,205,612,62,879,0
신리→연산교차로,2023.10.21 11:00,541,292,43,876,0
안락→연산교차로,2023.10.21 11:00,570,0,161,731,0
연산터널→연산교차로,2023.10.21 11:00,297,344,52,693,0
교대→연산교차로,2023.10.21 12:00,305,0,448,753,0
부산시청→연산교차로,2023.10.21 12:00,617,378,314,1309,0
사직운동장→연산교차로,2023.10.21 12:00,217,629,51,897,0
신리→연산교차로,2023.10.21 12:00,506,293,52,851,0
안락→연산교차로,2023.10.21 12:00,529,0,179,708,0
연산터널→연산교차로,2023.10.21 12:00,307,356,50,713,0
교대→연산교차로,2023.10.21 13:00,347,0,474,821,0
부산시청→연산교차로,2023.10.21 13:00,663,476,310,1449,0
사직운동장→연산교차로,2023.10.21 13:00,205,671,72,948,0
신리→연산교차로,2023.10.21 13:00,486,287,70,843,0
안락→연산교차로,2023.10.21 13:00,473,0,92,565,0
연산터널→연산교차로,2023.10.21 13:00,239,296,35,570,0
교대→연산교차로,2023.10.21 14:00,346,0,502,848,0
부산시청→연산교차로,2023.10.21 14:00,650,498,335,1483,0
사직운동장→연산교차로,2023.10.21 14:00,222,680,57,959,0
신리→연산교차로,2023.10.21 14:00,485,294,78,857,0
안락→연산교차로,2023.10.21 14:00,454,0,115,569,0
연산터널→연산교차로,2023.10.21 14:00,221,266,46,533,0
교대→연산교차로,2023.10.21 15:00,339,0,447,786,0
부산시청→연산교차로,2023.10.21 15:00,662,473,315,1450,0
사직운동장→연산교차로,2023.10.21 15:00,221,690,93,1004,0
신리→연산교차로,2023.10.21 15:00,466,269,56,791,0
안락→연산교차로,2023.10.21 15:00,441,0,87,528,0
연산터널→연산교차로,2023.10.21 15:00,242,275,42,559,0
교대→연산교차로,2023.10.21 16:00,358,0,425,783,0
부산시청→연산교차로,2023.10.21 16:00,647,486,305,1438,0
사직운동장→연산교차로,2023.10.21 16:00,236,666,73,975,0
신리→연산교차로,2023.10.21 16:00,447,305,56,808,0
안락→연산교차로,2023.10.21 16:00,459,0,98,557,0
연산터널→연산교차로,2023.10.21 16:00,223,273,40,536,0
교대→연산교차로,2023.10.21 17:00,337,0,461,798,0
부산시청→연산교차로,2023.10.21 17:00,649,519,295,1463,0
사직운동장→연산교차로,2023.10.21 17:00,238,677,75,990,0
신리→연산교차로,2023.10.21 17:00,446,329,48,823,0
안락→연산교차로,2023.10.21 17:00,451,0,94,545,0
연산터널→연산교차로,2023.10.21 17:00,228,290,38,556,0
교대→연산교차로,2023.10.21 18:00,323,0,430,753,0
부산시청→연산교차로,2023.10.21 18:00,570,447,266,1283,0
사직운동장→연산교차로,2023.10.21 18:00,244,572,77,893,0
신리→연산교차로,2023.10.21 18:00,377,275,36,688,0
안락→연산교차로,2023.10.21 18:00,456,0,83,539,0
연산터널→연산교차로,2023.10.21 18:00,214,291,62,567,0
교대→연산교차로,2023.10.21 19:00,310,0,386,696,0
부산시청→연산교차로,2023.10.21 19:00,462,340,245,1047,0
사직운동장→연산교차로,2023.10.21 19:00,202,535,87,824,0
신리→연산교차로,2023.10.21 19:00,345,242,39,626,0
안락→연산교차로,2023.10.21 19:00,434,0,105,539,0
연산터널→연산교차로,2023.10.21 19:00,223,286,53,562,0
교대→연산교차로,2023.10.21 20:00,300,0,309,609,0
부산시청→연산교차로,2023.10.21 20:00,498,333,189,1020,0
사직운동장→연산교차로,2023.10.21 20:00,183,440,67,690,0
신리→연산교차로,2023.10.21 20:00,338,242,38,618,0
안락→연산교차로,2023.10.21 20:00,403,0,132,535,0
연산터널→연산교차로,2023.10.21 20:00,222,261,46,529,0
교대→연산교차로,2023.10.21 21:00,255,0,280,535,0
부산시청→연산교차로,2023.10.21 21:00,477,319,200,996,0
사직운동장→연산교차로,2023.10.21 21:00,214,412,61,687,0
신리→연산교차로,2023.10.21 21:00,332,223,41,596,0
안락→연산교차로,2023.10.21 21:00,366,0,121,487,0
연산터널→연산교차로,2023.10.21 21:00,234,236,65,535,0
교대→연산교차로,2023.10.21 22:00,236,0,215,451,0
부산시청→연산교차로,2023.10.21 22:00,385,269,169,823,0
사직운동장→연산교차로,2023.10.21 22:00,187,382,38,607,0
신리→연산교차로,2023.10.21 22:00,279,187,28,494,0
안락→연산교차로,2023.10.21 22:00,326,0,103,429,0
연산터널→연산교차로,2023.10.21 22:00,168,235,53,456,0
교대→연산교차로,2023.10.21 23:00,227,0,232,459,0
부산시청→연산교차로,2023.10.21 23:00,384,209,117,710,0
사직운동장→연산교차로,2023.10.21 23:00,107,285,65,457,0
신리→연산교차로,2023.10.21 23:00,273,140,36,449,0
안락→연산교차로,2023.10.21 23:00,294,0,80,374,0
연산터널→연산교차로,2023.10.21 23:00,152,196,64,412,0
교대→연산교차로,2023.10.22 00:00,161,0,210,371,1
부산시청→연산교차로,2023.10.22 00:00,302,206,113,621,1
사직운동장→연산교차로,2023.10.22 00:00,73,226,46,345,1
신리→연산교차로,2023.10.22 00:00,256,123,14,393,1
안락→연산교차로,2023.10.22 00:00,235,0,69,304,1
연산터널→연산교차로,2023.10.22 00:00,132,182,42,356,1
교대→연산교차로,2023.10.22 01:00,119,0,239,358,1
부산시청→연산교차로,2023.10.22 01:00,261,161,84,506,1
사직운동장→연산교차로,2023.10.22 01:00,57,209,42,308,1
신리→연산교차로,2023.10.22 01:00,154,101,21,276,1
안락→연산교차로,2023.10.22 01:00,227,0,52,279,1
연산터널→연산교차로,2023.10.22 01:00,117,206,35,358,1
교대→연산교차로,2023.10.22 02:00,110,0,204,314,1
부산시청→연산교차로,2023.10.22 02:00,235,121,82,438,1
사직운동장→연산교차로,2023.10.22 02:00,56,162,18,236,1
신리→연산교차로,2023.10.22 02:00,132,96,22,250,1
안락→연산교차로,2023.10.22 02:00,156,0,38,194,1
연산터널→연산교차로,2023.10.22 02:00,117,150,53,320,1
교대→연산교차로,2023.10.22 03:00,99,0,162,261,1
부산시청→연산교차로,2023.10.22 03:00,177,114,72,363,1
사직운동장→연산교차로,2023.10.22 03:00,50,154,12,216,1
신리→연산교차로,2023.10.22 03:00,87,64,13,164,1
안락→연산교차로,2023.10.22 03:00,140,0,28,168,1
연산터널→연산교차로,2023.10.22 03:00,100,132,45,277,1
교대→연산교차로,2023.10.22 04:00,69,0,124,193,1
부산시청→연산교차로,2023.10.22 04:00,170,85,48,303,1
사직운동장→연산교차로,2023.10.22 04:00,30,101,5,136,1
신리→연산교차로,2023.10.22 04:00,77,46,9,132,1
안락→연산교차로,2023.10.22 04:00,144,0,42,186,1
연산터널→연산교차로,2023.10.22 04:00,88,105,24,217,1
교대→연산교차로,2023.10.22 05:00,65,0,104,169,1
부산시청→연산교차로,2023.10.22 05:00,182,121,52,355,1
사직운동장→연산교차로,2023.10.22 05:00,37,116,6,159,1
신리→연산교차로,2023.10.22 05:00,127,72,2,201,1
안락→연산교차로,2023.10.22 05:00,172,0,28,200,1
연산터널→연산교차로,2023.10.22 05:00,78,94,19,191,1
교대→연산교차로,2023.10.22 06:00,98,0,145,243,1
부산시청→연산교차로,2023.10.22 06:00,189,177,68,434,1
사직운동장→연산교차로,2023.10.22 06:00,47,145,33,225,1
신리→연산교차로,2023.10.22 06:00,167,98,7,272,1
안락→연산교차로,2023.10.22 06:00,243,0,58,301,1
연산터널→연산교차로,2023.10.22 06:00,126,112,20,258,1
교대→연산교차로,2023.10.22 07:00,119,0,160,279,1
부산시청→연산교차로,2023.10.22 07:00,270,201,91,562,1
사직운동장→연산교차로,2023.10.22 07:00,62,217,47,326,1
신리→연산교차로,2023.10.22 07:00,220,97,17,334,1
안락→연산교차로,2023.10.22 07:00,265,0,62,327,1
연산터널→연산교차로,2023.10.22 07:00,147,122,26,295,1
교대→연산교차로,2023.10.22 08:00,187,0,195,382,1
부산시청→연산교차로,2023.10.22 08:00,354,239,139,732,1
사직운동장→연산교차로,2023.10.22 08:00,120,304,49,473,1
신리→연산교차로,2023.10.22 08:00,292,151,22,465,1
안락→연산교차로,2023.10.22 08:00,333,0,71,404,1
연산터널→연산교차로,2023.10.22 08:00,182,171,21,374,1
교대→연산교차로,2023.10.22 09:00,245,0,238,483,1
부산시청→연산교차로,2023.10.22 09:00,384,313,192,889,1
사직운동장→연산교차로,2023.10.22 09:00,137,367,55,559,1
신리→연산교차로,2023.10.22 09:00,401,222,16,639,1
안락→연산교차로,2023.10.22 09:00,441,0,113,554,1
연산터널→연산교차로,2023.10.22 09:00,256,203,28,487,1
교대→연산교차로,2023.10.22 10:00,235,0,280,515,1
부산시청→연산교차로,2023.10.22 10:00,455,331,195,981,1
사직운동장→연산교차로,2023.10.22 10:00,159,527,55,741,1
신리→연산교차로,2023.10.22 10:00,433,203,22,658,1
안락→연산교차로,2023.10.22 10:00,447,0,100,547,1
연산터널→연산교차로,2023.10.22 10:00,263,247,45,555,1
교대→연산교차로,2023.10.22 11:00,252,0,362,614,1
부산시청→연산교차로,2023.10.22 11:00,512,342,177,1031,1
사직운동장→연산교차로,2023.10.22 11:00,191,501,60,752,1
신리→연산교차로,2023.10.22 11:00,449,206,30,685,1
안락→연산교차로,2023.10.22 11:00,484,0,127,611,1
연산터널→연산교차로,2023.10.22 11:00,264,266,40,570,1
교대→연산교차로,2023.10.22 12:00,281,0,368,649,1
부산시청→연산교차로,2023.10.22 12:00,527,347,193,1067,1
사직운동장→연산교차로,2023.10.22 12:00,183,493,78,754,1
신리→연산교차로,2023.10.22 12:00,434,229,43,706,1
안락→연산교차로,2023.10.22 12:00,479,0,125,604,1
연산터널→연산교차로,2023.10.22 12:00,240,268,41,549,1
교대→연산교차로,2023.10.22 13:00,255,0,341,596,1
부산시청→연산교차로,2023.10.22 13:00,541,365,200,1106,1
사직운동장→연산교차로,2023.10.22 13:00,196,560,69,825,1
신리→연산교차로,2023.10.22 13:00,420,213,30,663,1
안락→연산교차로,2023.10.22 13:00,529,0,163,692,1
연산터널→연산교차로,2023.10.22 13:00,256,275,49,580,1
교대→연산교차로,2023.10.22 14:00,295,0,335,630,1
부산시청→연산교차로,2023.10.22 14:00,526,362,217,1105,1
사직운동장→연산교차로,2023.10.22 14:00,185,531,55,771,1
신리→연산교차로,2023.10.22 14:00,454,248,28,730,1
안락→연산교차로,2023.10.22 14:00,503,0,153,656,1
연산터널→연산교차로,2023.10.22 14:00,271,252,49,572,1
교대→연산교차로,2023.10.22 15:00,298,0,363,661,1
부산시청→연산교차로,2023.10.22 15:00,519,328,218,1065,1
사직운동장→연산교차로,2023.10.22 15:00,196,534,67,797,1
신리→연산교차로,2023.10.22 15:00,408,234,40,682,1
안락→연산교차로,2023.10.22 15:00,546,0,148,694,1
연산터널→연산교차로,2023.10.22 15:00,260,237,36,533,1
교대→연산교차로,2023.10.22 16:00,294,0,345,639,1
부산시청→연산교차로,2023.10.22 16:00,555,368,237,1160,1
사직운동장→연산교차로,2023.10.22 16:00,183,556,65,804,1
신리→연산교차로,2023.10.22 16:00,437,209,33,679,1
안락→연산교차로,2023.10.22 16:00,585,0,124,709,1
연산터널→연산교차로,2023.10.22 16:00,210,255,51,516,1
교대→연산교차로,2023.10.22 17:00,289,0,351,640,1
부산시청→연산교차로,2023.10.22 17:00,507,366,226,1099,1
사직운동장→연산교차로,2023.10.22 17:00,181,538,53,772,1
신리→연산교차로,2023.10.22 17:00,373,206,36,615,1
안락→연산교차로,2023.10.22 17:00,533,0,119,652,1
연산터널→연산교차로,2023.10.22 17:00,248,241,45,534,1
교대→연산교차로,2023.10.22 18:00,310,0,305,615,1
부산시청→연산교차로,2023.10.22 18:00,478,330,177,985,1
사직운동장→연산교차로,2023.10.22 18:00,233,526,59,818,1
신리→연산교차로,2023.10.22 18:00,370,183,40,593,1
안락→연산교차로,2023.10.22 18:00,460,0,132,592,1
연산터널→연산교차로,2023.10.22 18:00,218,232,47,497,1
교대→연산교차로,2023.10.22 19:00,273,0,270,543,1
부산시청→연산교차로,2023.10.22 19:00,406,284,169,859,1
사직운동장→연산교차로,2023.10.22 19:00,164,393,55,612,1
신리→연산교차로,2023.10.22 19:00,293,159,28,480,1
안락→연산교차로,2023.10.22 19:00,403,0,99,502,1
연산터널→연산교차로,2023.10.22 19:00,205,256,55,516,1
교대→연산교차로,2023.10.22 20:00,254,0,281,535,1
부산시청→연산교차로,2023.10.22 20:00,442,282,165,889,1
사직운동장→연산교차로,2023.10.22 20:00,144,360,63,567,1
신리→연산교차로,2023.10.22 20:00,321,176,20,517,1
안락→연산교차로,2023.10.22 20:00,393,0,100,493,1
연산터널→연산교차로,2023.10.22 20:00,215,236,35,486,1
교대→연산교차로,2023.10.22 21:00,261,0,226,487,1
부산시청→연산교차로,2023.10.22 21:00,425,257,143,825,1
사직운동장→연산교차로,2023.10.22 21:00,123,323,56,502,1
신리→연산교차로,2023.10.22 21:00,267,161,19,447,1
안락→연산교차로,2023.10.22 21:00,316,0,76,392,1
연산터널→연산교차로,2023.10.22 21:00,157,180,52,389,1
교대→연산교차로,2023.10.22 22:00,180,0,203,383,1
부산시청→연산교차로,2023.10.22 22:00,306,196,109,611,1
사직운동장→연산교차로,2023.10.22 22:00,80,249,52,381,1
신리→연산교차로,2023.10.22 22:00,238,117,23,378,1
안락→연산교차로,2023.10.22 22:00,255,0,66,321,1
연산터널→연산교차로,2023.10.22 22:00,136,183,64,383,1
교대→연산교차로,2023.10.22 23:00,147,0,186,333,1
부산시청→연산교차로,2023.10.22 23:00,222,142,82,446,1
사직운동장→연산교차로,2023.10.22 23:00,59,190,42,291,1
신리→연산교차로,2023.10.22 23:00,161,93,18,272,1
안락→연산교차로,2023.10.22 23:00,221,0,53,274,1
연산터널→연산교차로,2023.10.22 23:00,116,140,61,317,1
교대→연산교차로,2023.10.23 00:00,96,0,140,236,0
부산시청→연산교차로,2023.10.23 00:00,211,128,83,422,0
사직운동장→연산교차로,2023.10.23 00:00,51,156,36,243,0
신리→연산교차로,2023.10.23 00:00,132,88,17,237,0
안락→연산교차로,2023.10.23 00:00,171,0,39,210,0
연산터널→연산교차로,2023.10.23 00:00,107,133,57,297,0
교대→연산교차로,2023.10.23 01:00,86,0,91,177,0
부산시청→연산교차로,2023.10.23 01:00,144,88,51,283,0
사직운동장→연산교차로,2023.10.23 01:00,23,123,20,166,0
신리→연산교차로,2023.10.23 01:00,95,33,11,139,0
안락→연산교차로,2023.10.23 01:00,141,0,44,185,0
연산터널→연산교차로,2023.10.23 01:00,78,99,40,217,0
교대→연산교차로,2023.10.23 02:00,56,0,92,148,0
부산시청→연산교차로,2023.10.23 02:00,116,59,42,217,0
사직운동장→연산교차로,2023.10.23 02:00,28,95,10,133,0
신리→연산교차로,2023.10.23 02:00,69,42,10,121,0
안락→연산교차로,2023.10.23 02:00,131,0,20,151,0
연산터널→연산교차로,2023.10.23 02:00,69,80,41,190,0
교대→연산교차로,2023.10.23 03:00,39,0,67,106,0
부산시청→연산교차로,2023.10.23 03:00,132,49,38,219,0
사직운동장→연산교차로,2023.10.23 03:00,15,75,4,94,0
신리→연산교차로,2023.10.23 03:00,63,22,7,92,0
안락→연산교차로,2023.10.23 03:00,91,0,19,110,0
연산터널→연산교차로,2023.10.23 03:00,56,71,44,171,0
교대→연산교차로,2023.10.23 04:00,42,0,75,117,0
부산시청→연산교차로,2023.10.23 04:00,142,65,34,241,0
사직운동장→연산교차로,2023.10.23 04:00,27,85,3,115,0
신리→연산교차로,2023.10.23 04:00,75,37,7,119,0
안락→연산교차로,2023.10.23 04:00,152,0,32,184,0
연산터널→연산교차로,2023.10.23 04:00,49,72,19,140,0
교대→연산교차로,2023.10.23 05:00,89,0,102,191,0
부산시청→연산교차로,2023.10.23 05:00,216,169,68,453,0
사직운동장→연산교차로,2023.10.23 05:00,43,160,7,210,0
신리→연산교차로,2023.10.23 05:00,216,89,5,310,0
안락→연산교차로,2023.10.23 05:00,324,0,51,375,0
연산터널→연산교차로,2023.10.23 05:00,107,113,15,235,0
교대→연산교차로,2023.10.23 06:00,161,0,228,389,0
부산시청→연산교차로,2023.10.23 06:00,353,261,115,729,0
사직운동장→연산교차로,2023.10.23 06:00,83,268,29,380,0
신리→연산교차로,2023.10.23 06:00,368,190,22,580,0
안락→연산교차로,2023.10.23 06:00,494,0,92,586,0
연산터널→연산교차로,2023.10.23 06:00,217,238,37,492,0
교대→연산교차로,2023.10.23 07:00,254,0,422,676,0
부산시청→연산교차로,2023.10.23 07:00,589,400,236,1225,0
사직운동장→연산교차로,2023.10.23 07:00,168,531,48,747,0
신리→연산교차로,2023.10.23 07:00,440,337,27,804,0
안락→연산교차로,2023.10.23 07:00,649,0,85,734,0
연산터널→연산교차로,2023.10.23 07:00,315,371,32,718,0
교대→연산교차로,2023.10.23 08:00,326,0,485,811,0
부산시청→연산교차로,2023.10.23 08:00,596,436,316,1348,0
사직운동장→연산교차로,2023.10.23 08:00,193,668,57,918,0
신리→연산교차로,2023.10.23 08:00,507,358,25,890,0
안락→연산교차로,2023.10.23 08:00,627,0,100,727,0
연산터널→연산교차로,2023.10.23 08:00,322,373,32,727,0
교대→연산교차로,2023.10.23 09:00,301,0,503,804,0
부산시청→연산교차로,2023.10.23 09:00,547,387,297,1231,0
사직운동장→연산교차로,2023.10.23 09:00,198,606,86,890,0
신리→연산교차로,2023.10.23 09:00,511,308,48,867,0
안락→연산교차로,2023.10.23 09:00,570,0,129,699,0
연산터널→연산교차로,2023.10.23 09:00,295,361,39,695,0
교대→연산교차로,2023.10.23 10:00,292,0,449,741,0
부산시청→연산교차로,2023.10.23 10:00,545,345,246,1136,0
사직운동장→연산교차로,2023.10.23 10:00,196,572,70,838,0
신리→연산교차로,2023.10.23 10:00,455,271,38,764,0
안락→연산교차로,2023.10.23 10:00,537,0,140,677,0
연산터널→연산교차로,2023.10.23 10:00,279,308,36,623,0
교대→연산교차로,2023.10.23 11:00,287,0,417,704,0
부산시청→연산교차로,2023.10.23 11:00,582,375,279,1236,0
사직운동장→연산교차로,2023.10.23 11:00,188,563,67,818,0
신리→연산교차로,2023.10.23 11:00,451,219,60,730,0
안락→연산교차로,2023.10.23 11:00,521,0,147,668,0
연산터널→연산교차로,2023.10.23 11:00,268,326,60,654,0
교대→연산교차로,2023.10.23 12:00,302,0,341,643,0
부산시청→연산교차로,2023.10.23 12:00,506,365,222,1093,0
사직운동장→연산교차로,2023.10.23 12:00,197,554,86,837,0
신리→연산교차로,2023.10.23 12:00,391,220,51,662,0
안락→연산교차로,2023.10.23 12:00,476,0,157,633,0
연산터널→연산교차로,2023.10.23 12:00,241,300,49,590,0
교대→연산교차로,2023.10.23 13:00,321,0,425,746,0
부산시청→연산교차로,2023.10.23 13:00,558,433,286,1277,0
사직운동장→연산교차로,2023.10.23 13:00,189,550,90,829,0
신리→연산교차로,2023.10.23 13:00,432,236,55,723,0
안락→연산교차로,2023.10.23 13:00,447,0,140,587,0
연산터널→연산교차로,2023.10.23 13:00,254,250,40,544,0
교대→연산교차로,2023.10.23 14:00,311,0,456,767,0
부산시청→연산교차로,2023.10.23 14:00,598,430,310,1338,0
사직운동장→연산교차로,2023.10.23 14:00,221,619,78,918,0
신리→연산교차로,2023.10.23 14:00,468,271,60,799,0
안락→연산교차로,2023.10.23 14:00,434,0,99,533,0
연산터널→연산교차로,2023.10.23 14:00,250,273,43,566,0
교대→연산교차로,2023.10.23 15:00,352,0,530,882,0
부산시청→연산교차로,2023.10.23 15:00,586,495,332,1413,0
사직운동장→연산교차로,2023.10.23 15:00,226,612,102,940,0
신리→연산교차로,2023.10.23 15:00,450,311,59,820,0
안락→연산교차로,2023.10.23 15:00,438,0,110,548,0
연산터널→연산교차로,2023.10.23 15:00,246,266,54,566,0
교대→연산교차로,2023.10.23 16:00,348,0,499,847,0
부산시청→연산교차로,2023.10.23 16:00,629,539,301,1469,0
사직운동장→연산교차로,2023.10.23 16:00,233,702,75,1010,0
신리→연산교차로,2023.10.23 16:00,494,276,62,832,0
안락→연산교차로,2023.10.23 16:00,430,0,117,547,0
연산터널→연산교차로,2023.10.23 16:00,252,279,45,576,0
교대→연산교차로,2023.10.23 17:00,355,0,526,881,0
부산시청→연산교차로,2023.10.23 17:00,647,536,324,1507,0
사직운동장→연산교차로,2023.10.23 17:00,234,694,47,975,0
신리→연산교차로,2023.10.23 17:00,516,286,56,858,0
안락→연산교차로,2023.10.23 17:00,446,0,120,566,0
연산터널→연산교차로,2023.10.23 17:00,241,279,32,552,0
교대→연산교차로,2023.10.23 18:00,347,0,574,921,0
부산시청→연산교차로,2023.10.23 18:00,591,541,327,1459,0
사직운동장→연산교차로,2023.10.23 18:00,263,668,51,982,0
신리→연산교차로,2023.10.23 18:00,506,236,53,795,0
안락→연산교차로,2023.10.23 18:00,461,0,83,544,0
연산터널→연산교차로,2023.10.23 18:00,227,292,38,557,0
교대→연산교차로,2023.10.23 19:00,330,0,381,711,0
부산시청→연산교차로,2023.10.23 19:00,560,390,279,1229,0
사직운동장→연산교차로,2023.10.23 19:00,198,533,63,794,0
신리→연산교차로,2023.10.23 19:00,367,226,49,642,0
안락→연산교차로,2023.10.23 19:00,407,0,97,504,0
연산터널→연산교차로,2023.10.23 19:00,203,257,52,512,0
교대→연산교차로,2023.10.23 20:00,274,0,330,604,0
부산시청→연산교차로,2023.10.23 20:00,449,383,217,1049,0
사직운동장→연산교차로,2023.10.23 20:00,162,459,76,697,0
신리→연산교차로,2023.10.23 20:00,296,205,30,531,0
안락→연산교차로,2023.10.23 20:00,392,0,124,516,0
연산터널→연산교차로,2023.10.23 20:00,197,260,54,511,0
교대→연산교차로,2023.10.23 21:00,256,0,264,520,0
부산시청→연산교차로,2023.10.23 21:00,464,268,189,921,0
사직운동장→연산교차로,2023.10.23 21:00,156,390,77,623,0
신리→연산교차로,2023.10.23 21:00,279,160,30,469,0
안락→연산교차로,2023.10.23 21:00,362,0,82,444,0
연산터널→연산교차로,2023.10.23 21:00,201,253,53,507,0
교대→연산교차로,2023.10.23 22:00,201,0,225,426,0
부산시청→연산교차로,2023.10.23 22:00,384,232,168,784,0
사직운동장→연산교차로,2023.10.23 22:00,125,343,70,538,0
신리→연산교차로,2023.10.23 22:00,227,176,30,433,0
안락→연산교차로,2023.10.23 22:00,320,0,76,396,0
연산터널→연산교차로,2023.10.23 22:00,186,239,60,485,0
교대→연산교차로,2023.10.23 23:00,162,0,187,349,0
부산시청→연산교차로,2023.10.23 23:00,286,163,104,553,0
사직운동장→연산교차로,2023.10.23 23:00,99,240,67,406,0
신리→연산교차로,2023.10.23 23:00,191,99,25,315,0
안락→연산교차로,2023.10.23 23:00,237,0,73,310,0
연산터널→연산교차로,2023.10.23 23:00,150,188,85,423,0
교대→연산교차로,2023.10.24 00:00,117,0,153,270,0
부산시청→연산교차로,2023.10.24 00:00,210,138,84,432,0
사직운동장→연산교차로,2023.10.24 00:00,53,199,35,287,0
신리→연산교차로,2023.10.24 00:00,118,90,19,227,0
안락→연산교차로,2023.10.24 00:00,167,0,44,211,0
연산터널→연산교차로,2023.10.24 00:00,100,135,61,296,0
교대→연산교차로,2023.10.24 01:00,89,0,123,212,0
부산시청→연산교차로,2023.10.24 01:00,164,76,67,307,0
사직운동장→연산교차로,2023.10.24 01:00,46,169,26,241,0
신리→연산교차로,2023.10.24 01:00,94,59,21,174,0
안락→연산교차로,2023.10.24 01:00,114,0,34,148,0
연산터널→연산교차로,2023.10.24 01:00,98,123,43,264,0
교대→연산교차로,2023.10.24 02:00,70,0,103,173,0
부산시청→연산교차로,2023.10.24 02:00,137,64,53,254,0
사직운동장→연산교차로,2023.10.24 02:00,37,144,12,193,0
신리→연산교차로,2023.10.24 02:00,68,45,7,120,0
안락→연산교차로,2023.10.24 02:00,114,0,31,145,0
연산터널→연산교차로,2023.10.24 02:00,93,113,42,248,0
교대→연산교차로,2023.10.24 03:00,55,0,103,158,0
부산시청→연산교차로,2023.10.24 03:00,149,69,39,257,0
사직운동장→연산교차로,2023.10.24 03:00,40,129,5,174,0
신리→연산교차로,2023.10.24 03:00,75,42,3,120,0
안락→연산교차로,2023.10.24 03:00,108,0,23,131,0
연산터널→연산교차로,2023.10.24 03:00,57,76,32,165,0
교대→연산교차로,2023.10.24 04:00,43,0,82,125,0
부산시청→연산교차로,2023.10.24 04:00,141,59,50,250,0
사직운동장→연산교차로,2023.10.24 04:00,28,107,6,141,0
신리→연산교차로,2023.10.24 04:00,87,42,11,140,0
안락→연산교차로,2023.10.24 04:00,175,0,31,206,0
연산터널→연산교차로,2023.10.24 04:00,74,79,35,188,0
교대→연산교차로,2023.10.24 05:00,94,0,120,214,0
부산시청→연산교차로,2023.10.24 05:00,226,182,68,476,0
사직운동장→연산교차로,2023.10.24 05:00,51,182,10,243,0
신리→연산교차로,2023.10.24 05:00,220,90,13,323,0
안락→연산교차로,2023.10.24 05:00,289,0,55,344,0
연산터널→연산교차로,2023.10.24 05:00,123,142,18,283,0
교대→연산교차로,2023.10.24 06:00,180,0,226,406,0
부산시청→연산교차로,2023.10.24 06:00,391,294,108,793,0
사직운동장→연산교차로,2023.10.24 06:00,95,310,32,437,0
신리→연산교차로,2023.10.24 06:00,337,197,22,556,0
안락→연산교차로,2023.10.24 06:00,477,0,79,556,0
연산터널→연산교차로,2023.10.24 06:00,254,223,31,508,0
교대→연산교차로,2023.10.24 07:00,234,0,391,625,0
부산시청→연산교차로,2023.10.24 07:00,558,383,279,1220,0
사직운동장→연산교차로,2023.10.24 07:00,167,542,67,776,0
신리→연산교차로,2023.10.24 07:00,500,292,23,815,0
안락→연산교차로,2023.10.24 07:00,616,0,98,714,0
연산터널→연산교차로,2023.10.24 07:00,292,377,43,712,0
교대→연산교차로,2023.10.24 08:00,313,0,494,807,0
부산시청→연산교차로,2023.10.24 08:00,609,433,322,1364,0
사직운동장→연산교차로,2023.10.24 08:00,206,669,69,944,0
신리→연산교차로,2023.10.24 08:00,523,334,35,892,0
안락→연산교차로,2023.10.24 08:00,592,0,99,691,0
연산터널→연산교차로,2023.10.24 08:00,312,387,33,732,0
교대→연산교차로,2023.10.24 09:00,294,0,480,774,0
부산시청→연산교차로,2023.10.24 09:00,528,379,323,1230,0
사직운동장→연산교차로,2023.10.24 09:00,193,568,116,877,0
신리→연산교차로,2023.10.24 09:00,464,317,40,821,0
안락→연산교차로,2023.10.24 09:00,544,0,109,653,0
연산터널→연산교차로,2023.10.24 09:00,275,353,47,675,0
교대→연산교차로,2023.10.24 10:00,288,0,441,729,0
부산시청→연산교차로,2023.10.24 10:00,547,364,237,1148,0
사직운동장→연산교차로,2023.10.24 10:00,211,571,83,865,0
신리→연산교차로,2023.10.24 10:00,506,243,48,797,0
안락→연산교차로,2023.10.24 10:00,527,0,117,644,0
연산터널→연산교차로,2023.10.24 10:00,259,320,48,627,0
교대→연산교차로,2023.10.24 11:00,288,0,424,712,0
부산시청→연산교차로,2023.10.24 11:00,588,369,260,1217,0
사직운동장→연산교차로,2023.10.24 11:00,214,544,79,837,0
신리→연산교차로,2023.10.24 11:00,470,264,52,786,0
안락→연산교차로,2023.10.24 11:00,522,0,146,668,0
연산터널→연산교차로,2023.10.24 11:00,269,297,42,608,0
교대→연산교차로,2023.10.24 12:00,273,0,393,666,0
부산시청→연산교차로,2023.10.24 12:00,556,342,286,1184,0
사직운동장→연산교차로,2023.10.24 12:00,198,570,84,852,0
신리→연산교차로,2023.10.24 12:00,431,233,44,708,0
안락→연산교차로,2023.10.24 12:00,457,0,155,612,0
연산터널→연산교차로,2023.10.24 12:00,287,271,42,600,0
교대→연산교차로,2023.10.24 13:00,331,0,433,764,0
부산시청→연산교차로,2023.10.24 13:00,544,411,278,1233,0
사직운동장→연산교차로,2023.10.24 13:00,220,595,96,911,0
신리→연산교차로,2023.10.24 13:00,435,266,41,742,0
안락→연산교차로,2023.10.24 13:00,413,0,137,550,0
연산터널→연산교차로,2023.10.24 13:00,258,269,43,570,0
교대→연산교차로,2023.10.24 14:00,333,0,468,801,0
부산시청→연산교차로,2023.10.24 14:00,544,417,314,1275,0
사직운동장→연산교차로,2023.10.24 14:00,202,635,97,934,0
신리→연산교차로,2023.10.24 14:00,499,272,53,824,0
안락→연산교차로,2023.10.24 14:00,406,0,125,531,0
연산터널→연산교차로,2023.10.24 14:00,231,270,35,536,0
교대→연산교차로,2023.10.24 15:00,339,0,480,819,0
부산시청→연산교차로,2023.10.24 15:00,596,460,290,1346,0
사직운동장→연산교차로,2023.10.24 15:00,232,624,92,948,0
신리→연산교차로,2023.10.24 15:00,469,267,64,800,0
안락→연산교차로,2023.10.24 15:00,437,0,121,558,0
연산터널→연산교차로,2023.10.24 15:00,240,269,54,563,0
교대→연산교차로,2023.10.24 16:00,361,0,489,850,0
부산시청→연산교차로,2023.10.24 16:00,599,501,339,1439,0
사직운동장→연산교차로,2023.10.24 16:00,230,664,72,966,0
신리→연산교차로,2023.10.24 16:00,550,280,66,896,0
안락→연산교차로,2023.10.24 16:00,432,0,76,508,0
연산터널→연산교차로,2023.10.24 16:00,251,281,43,575,0
교대→연산교차로,2023.10.24 17:00,357,0,519,876,0
부산시청→연산교차로,2023.10.24 17:00,573,517,369,1459,0
사직운동장→연산교차로,2023.10.24 17:00,253,674,61,988,0
신리→연산교차로,2023.10.24 17:00,488,317,39,844,0
안락→연산교차로,2023.10.24 17:00,455,0,102,557,0
연산터널→연산교차로,2023.10.24 17:00,221,284,46,551,0
교대→연산교차로,2023.10.24 18:00,361,0,549,910,0
부산시청→연산교차로,2023.10.24 18:00,561,509,341,1411,0
사직운동장→연산교차로,2023.10.24 18:00,229,698,44,971,0
신리→연산교차로,2023.10.24 18:00,526,263,39,828,0
안락→연산교차로,2023.10.24 18:00,447,0,84,531,0
연산터널→연산교차로,2023.10.24 18:00,221,268,51,540,0
교대→연산교차로,2023.10.24 19:00,331,0,445,776,0
부산시청→연산교차로,2023.10.24 19:00,518,414,288,1220,0
사직운동장→연산교차로,2023.10.24 19:00,181,557,74,812,0
신리→연산교차로,2023.10.24 19:00,345,211,34,590,0
안락→연산교차로,2023.10.24 19:00,417,0,84,501,0
연산터널→연산교차로,2023.10.24 19:00,211,260,54,525,0
교대→연산교차로,2023.10.24 20:00,297,0,322,619,0
부산시청→연산교차로,2023.10.24 20:00,485,350,237,1072,0
사직운동장→연산교차로,2023.10.24 20:00,167,508,89,764,0
신리→연산교차로,2023.10.24 20:00,311,167,38,516,0
안락→연산교차로,2023.10.24 20:00,398,0,88,486,0
연산터널→연산교차로,2023.10.24 20:00,208,268,51,527,0
교대→연산교차로,2023.10.24 21:00,267,0,301,568,0
부산시청→연산교차로,2023.10.24 21:00,479,307,208,994,0
사직운동장→연산교차로,2023.10.24 21:00,162,432,76,670,0
신리→연산교차로,2023.10.24 21:00,287,188,38,513,0
안락→연산교차로,2023.10.24 21:00,374,0,100,474,0
연산터널→연산교차로,2023.10.24 21:00,188,272,65,525,0
교대→연산교차로,2023.10.24 22:00,235,0,248,483,0
부산시청→연산교차로,2023.10.24 22:00,412,264,143,819,0
사직운동장→연산교차로,2023.10.24 22:00,138,347,96,581,0
신리→연산교차로,2023.10.24 22:00,259,170,32,461,0
안락→연산교차로,2023.10.24 22:00,351,0,97,448,0
연산터널→연산교차로,2023.10.24 22:00,185,260,73,518,0
교대→연산교차로,2023.10.24 23:00,162,0,204,366,0
부산시청→연산교차로,2023.10.24 23:00,310,198,116,624,0
사직운동장→연산교차로,2023.10.24 23:00,85,272,68,425,0
신리→연산교차로,2023.10.24 23:00,199,112,29,340,0
안락→연산교차로,2023.10.24 23:00,250,0,77,327,0
연산터널→연산교차로,2023.10.24 23:00,147,196,68,411,0
교대→연산교차로,2023.10.25 00:00,134,0,200,334,0
부산시청→연산교차로,2023.10.25 00:00,239,146,118,503,0
사직운동장→연산교차로,2023.10.25 00:00,65,238,32,335,0
신리→연산교차로,2023.10.25 00:00,154,102,34,290,0
안락→연산교차로,2023.10.25 00:00,193,0,60,253,0
연산터널→연산교차로,2023.10.25 00:00,154,177,72,403,0
교대→연산교차로,2023.10.25 01:00,98,0,170,268,0
부산시청→연산교차로,2023.10.25 01:00,184,107,63,354,0
사직운동장→연산교차로,2023.10.25 01:00,56,177,24,257,0
신리→연산교차로,2023.10.25 01:00,91,65,23,179,0
안락→연산교차로,2023.10.25 01:00,122,0,36,158,0
연산터널→연산교차로,2023.10.25 01:00,117,129,75,321,0
교대→연산교차로,2023.10.25 02:00,60,0,113,173,0
부산시청→연산교차로,2023.10.25 02:00,154,77,42,273,0
사직운동장→연산교차로,2023.10.25 02:00,29,121,15,165,0
신리→연산교차로,2023.10.25 02:00,82,41,12,135,0
안락→연산교차로,2023.10.25 02:00,101,0,31,132,0
연산터널→연산교차로,2023.10.25 02:00,69,99,35,203,0
교대→연산교차로,2023.10.25 03:00,53,0,104,157,0
부산시청→연산교차로,2023.10.25 03:00,138,80,35,253,0
사직운동장→연산교차로,2023.10.25 03:00,29,114,9,152,0
신리→연산교차로,2023.10.25 03:00,62,32,15,109,0
안락→연산교차로,2023.10.25 03:00,95,0,24,119,0
연산터널→연산교차로,2023.10.25 03:00,74,100,49,223,0
교대→연산교차로,2023.10.25 04:00,57,0,96,153,0
부산시청→연산교차로,2023.10.25 04:00,160,81,46,287,0
사직운동장→연산교차로,2023.10.25 04:00,27,129,8,164,0
신리→연산교차로,2023.10.25 04:00,89,35,13,137,0
안락→연산교차로,2023.10.25 04:00,160,0,32,192,0
연산터널→연산교차로,2023.10.25 04:00,87,90,30,207,0
교대→연산교차로,2023.10.25 05:00,93,0,125,218,0
부산시청→연산교차로,2023.10.25 05:00,235,161,67,463,0
사직운동장→연산교차로,2023.10.25 05:00,33,194,8,235,0
신리→연산교차로,2023.10.25 05:00,189,95,13,297,0
안락→연산교차로,2023.10.25 05:00,307,0,61,368,0
연산터널→연산교차로,2023.10.25 05:00,139,141,28,308,0
교대→연산교차로,2023.10.25 06:00,164,0,231,395,0
부산시청→연산교차로,2023.10.25 06:00,375,266,113,754,0
사직운동장→연산교차로,2023.10.25 06:00,82,280,28,390,0
신리→연산교차로,2023.10.25 06:00,357,168,18,543,0
안락→연산교차로,2023.10.25 06:00,472,0,94,566,0
연산터널→연산교차로,2023.10.25 06:00,251,232,35,518,0
교대→연산교차로,2023.10.25 07:00,243,0,368,611,0
부산시청→연산교차로,2023.10.25 07:00,588,392,287,1267,0
사직운동장→연산교차로,2023.10.25 07:00,200,516,76,792,0
신리→연산교차로,2023.10.25 07:00,473,301,32,806,0
안락→연산교차로,2023.10.25 07:00,621,0,84,705,0
연산터널→연산교차로,2023.10.25 07:00,294,362,37,693,0
교대→연산교차로,2023.10.25 08:00,306,0,486,792,0
부산시청→연산교차로,2023.10.25 08:00,617,439,316,1372,0
사직운동장→연산교차로,2023.10.25 08:00,191,669,58,918,0
신리→연산교차로,2023.10.25 08:00,512,348,20,880,0
안락→연산교차로,2023.10.25 08:00,606,0,93,699,0
연산터널→연산교차로,2023.10.25 08:00,335,368,36,739,0
교대→연산교차로,2023.10.25 09:00,292,0,471,763,0
부산시청→연산교차로,2023.10.25 09:00,536,411,309,1256,0
사직운동장→연산교차로,2023.10.25 09:00,182,632,96,910,0
신리→연산교차로,2023.10.25 09:00,473,324,45,842,0
안락→연산교차로,2023.10.25 09:00,573,0,79,652,0
연산터널→연산교차로,2023.10.25 09:00,283,362,43,688,0
교대→연산교차로,2023.10.25 10:00,282,0,476,758,0
부산시청→연산교차로,2023.10.25 10:00,547,372,282,1201,0
사직운동장→연산교차로,2023.10.25 10:00,203,585,77,865,0
신리→연산교차로,2023.10.25 10:00,488,278,58,824,0
안락→연산교차로,2023.10.25 10:00,558,0,127,685,0
연산터널→연산교차로,2023.10.25 10:00,280,340,39,659,0
교대→연산교차로,2023.10.25 11:00,268,0,437,705,0
부산시청→연산교차로,2023.10.25 11:00,562,382,240,1184,0
사직운동장→연산교차로,2023.10.25 11:00,196,579,68,843,0
신리→연산교차로,2023.10.25 11:00,435,238,55,728,0
안락→연산교차로,2023.10.25 11:00,517,0,143,660,0
연산터널→연산교차로,2023.10.25 11:00,239,301,39,579,0
교대→연산교차로,2023.10.25 12:00,298,0,359,657,0
부산시청→연산교차로,2023.10.25 12:00,541,357,256,1154,0
사직운동장→연산교차로,2023.10.25 12:00,181,547,89,817,0
신리→연산교차로,2023.10.25 12:00,444,237,38,719,0
안락→연산교차로,2023.10.25 12:00,479,0,172,651,0
연산터널→연산교차로,2023.10.25 12:00,262,283,49,594,0
교대→연산교차로,2023.10.25 13:00,327,0,428,755,0
부산시청→연산교차로,2023.10.25 13:00,555,411,238,1204,0
사직운동장→연산교차로,2023.10.25 13:00,192,614,112,918,0
신리→연산교차로,2023.10.25 13:00,419,252,51,722,0
안락→연산교차로,2023.10.25 13:00,435,0,104,539,0
연산터널→연산교차로,2023.10.25 13:00,255,272,34,561,0
교대→연산교차로,2023.10.25 14:00,341,0,493,834,0
부산시청→연산교차로,2023.10.25 14:00,585,437,287,1309,0
사직운동장→연산교차로,2023.10.25 14:00,211,647,78,936,0
신리→연산교차로,2023.10.25 14:00,457,295,57,809,0
안락→연산교차로,2023.10.25 14:00,419,0,104,523,0
연산터널→연산교차로,2023.10.25 14:00,232,276,44,552,0
교대→연산교차로,2023.10.25 15:00,338,0,465,803,0
부산시청→연산교차로,2023.10.25 15:00,540,466,296,1302,0
사직운동장→연산교차로,2023.10.25 15:00,206,640,109,955,0
신리→연산교차로,2023.10.25 15:00,476,285,53,814,0
안락→연산교차로,2023.10.25 15:00,415,0,123,538,0
연산터널→연산교차로,2023.10.25 15:00,245,278,42,565,0
교대→연산교차로,2023.10.25 16:00,347,0,463,810,0
부산시청→연산교차로,2023.10.25 16:00,626,525,316,1467,0
사직운동장→연산교차로,2023.10.25 16:00,229,697,69,995,0
신리→연산교차로,2023.10.25 16:00,500,295,52,847,0
안락→연산교차로,2023.10.25 16:00,431,0,114,545,0
연산터널→연산교차로,2023.10.25 16:00,262,252,35,549,0
교대→연산교차로,2023.10.25 17:00,356,0,529,885,0
부산시청→연산교차로,2023.10.25 17:00,625,557,340,1522,0
사직운동장→연산교차로,2023.10.25 17:00,233,678,63,974,0
신리→연산교차로,2023.10.25 17:00,502,278,40,820,0
안락→연산교차로,2023.10.25 17:00,431,0,119,550,0
연산터널→연산교차로,2023.10.25 17:00,243,287,43,573,0
교대→연산교차로,2023.10.25 18:00,358,0,569,927,0
부산시청→연산교차로,2023.10.25 18:00,587,586,325,1498,0
사직운동장→연산교차로,2023.10.25 18:00,257,644,48,949,0
신리→연산교차로,2023.10.25 18:00,510,272,48,830,0
안락→연산교차로,2023.10.25 18:00,461,0,82,543,0
연산터널→연산교차로,2023.10.25 18:00,221,270,34,525,0
교대→연산교차로,2023.10.25 19:00,330,0,435,765,0
부산시청→연산교차로,2023.10.25 19:00,506,381,273,1160,0
사직운동장→연산교차로,2023.10.25 19:00,189,531,60,780,0
신리→연산교차로,2023.10.25 19:00,330,209,39,578,0
안락→연산교차로,2023.10.25 19:00,433,0,98,531,0
연산터널→연산교차로,2023.10.25 19:00,204,271,44,519,0
교대→연산교차로,2023.10.25 20:00,310,0,382,692,0
부산시청→연산교차로,2023.10.25 20:00,473,367,218,1058,0
사직운동장→연산교차로,2023.10.25 20:00,154,527,93,774,0
신리→연산교차로,2023.10.25 20:00,317,202,28,547,0
안락→연산교차로,2023.10.25 20:00,407,0,108,515,0
연산터널→연산교차로,2023.10.25 20:00,196,262,61,519,0
교대→연산교차로,2023.10.25 21:00,277,0,284,561,0
부산시청→연산교차로,2023.10.25 21:00,485,333,211,1029,0
사직운동장→연산교차로,2023.10.25 21:00,151,455,73,679,0
신리→연산교차로,2023.10.25 21:00,332,168,37,537,0
안락→연산교차로,2023.10.25 21:00,388,0,93,481,0
연산터널→연산교차로,2023.10.25 21:00,209,270,59,538,0
교대→연산교차로,2023.10.25 22:00,229,0,245,474,0
부산시청→연산교차로,2023.10.25 22:00,408,227,153,788,0
사직운동장→연산교차로,2023.10.25 22:00,125,328,64,517,0
신리→연산교차로,2023.10.25 22:00,256,146,24,426,0
안락→연산교차로,2023.10.25 22:00,331,0,78,409,0
연산터널→연산교차로,2023.10.25 22:00,183,238,53,474,0
교대→연산교차로,2023.10.25 23:00,199,0,224,423,0
부산시청→연산교차로,2023.10.25 23:00,298,185,118,601,0
사직운동장→연산교차로,2023.10.25 23:00,102,260,48,410,0
신리→연산교차로,2023.10.25 23:00,205,127,26,358,0
안락→연산교차로,2023.10.25 23:00,256,0,74,330,0
연산터널→연산교차로,2023.10.25 23:00,146,170,65,381,0
교대→연산교차로,2023.10.26 00:00,130,0,231,361,0
부산시청→연산교차로,2023.10.26 00:00,266,158,102,526,0
사직운동장→연산교차로,2023.10.26 00:00,51,232,39,322,0
신리→연산교차로,2023.10.26 00:00,170,93,29,292,0
안락→연산교차로,2023.10.26 00:00,219,0,57,276,0
연산터널→연산교차로,2023.10.26 00:00,157,167,68,392,0
교대→연산교차로,2023.10.26 01:00,111,0,167,278,0
부산시청→연산교차로,2023.10.26 01:00,174,108,74,356,0
사직운동장→연산교차로,2023.10.26 01:00,54,177,24,255,0
신리→연산교차로,2023.10.26 01:00,100,48,14,162,0
안락→연산교차로,2023.10.26 01:00,147,0,37,184,0
연산터널→연산교차로,2023.10.26 01:00,112,137,43,292,0
교대→연산교차로,2023.10.26 02:00,75,0,121,196,0
부산시청→연산교차로,2023.10.26 02:00,158,80,68,306,0
사직운동장→연산교차로,2023.10.26 02:00,40,125,7,172,0
신리→연산교차로,2023.10.26 02:00,82,51,21,154,0
안락→연산교차로,2023.10.26 02:00,117,0,38,155,0
연산터널→연산교차로,2023.10.26 02:00,89,118,47,254,0
교대→연산교차로,2023.10.26 03:00,56,0,97,153,0
부산시청→연산교차로,2023.10.26 03:00,152,79,49,280,0
사직운동장→연산교차로,2023.10.26 03:00,27,113,5,145,0
신리→연산교차로,2023.10.26 03:00,50,40,15,105,0
안락→연산교차로,2023.10.26 03:00,110,0,29,139,0
연산터널→연산교차로,2023.10.26 03:00,85,99,60,244,0
교대→연산교차로,2023.10.26 04:00,55,0,83,138,0
부산시청→연산교차로,2023.10.26 04:00,136,89,42,267,0
사직운동장→연산교차로,2023.10.26 04:00,36,109,4,149,0
신리→연산교차로,2023.10.26 04:00,89,47,10,146,0
안락→연산교차로,2023.10.26 04:00,159,0,39,198,0
연산터널→연산교차로,2023.10.26 04:00,86,91,34,211,0
교대→연산교차로,2023.10.26 05:00,95,0,117,212,0
부산시청→연산교차로,2023.10.26 05:00,227,172,77,476,0
사직운동장→연산교차로,2023.10.26 05:00,50,173,8,231,0
신리→연산교차로,2023.10.26 05:00,204,93,11,308,0
안락→연산교차로,2023.10.26 05:00,314,0,36,350,0
연산터널→연산교차로,2023.10.26 05:00,128,145,19,292,0
교대→연산교차로,2023.10.26 06:00,185,0,225,410,0
부산시청→연산교차로,2023.10.26 06:00,382,286,119,787,0
사직운동장→연산교차로,2023.10.26 06:00,110,293,27,430,0
신리→연산교차로,2023.10.26 06:00,338,175,19,532,0
안락→연산교차로,2023.10.26 06:00,478,0,104,582,0
연산터널→연산교차로,2023.10.26 06:00,219,218,29,466,0
교대→연산교차로,2023.10.26 07:00,240,0,389,629,0
부산시청→연산교차로,2023.10.26 07:00,563,402,213,1178,0
사직운동장→연산교차로,2023.10.26 07:00,178,526,79,783,0
신리→연산교차로,2023.10.26 07:00,479,302,20,801,0
안락→연산교차로,2023.10.26 07:00,633,0,91,724,0
연산터널→연산교차로,2023.10.26 07:00,290,378,40,708,0
교대→연산교차로,2023.10.26 08:00,291,0,507,798,0
부산시청→연산교차로,2023.10.26 08:00,606,441,304,1351,0
사직운동장→연산교차로,2023.10.26 08:00,199,634,67,900,0
신리→연산교차로,2023.10.26 08:00,507,355,25,887,0
안락→연산교차로,2023.10.26 08:00,614,0,112,726,0
연산터널→연산교차로,2023.10.26 08:00,304,388,34,726,0
교대→연산교차로,2023.10.26 09:00,261,0,461,722,0
부산시청→연산교차로,2023.10.26 09:00,546,385,312,1243,0
사직운동장→연산교차로,2023.10.26 09:00,195,574,93,862,0
신리→연산교차로,2023.10.26 09:00,426,301,49,776,0
안락→연산교차로,2023.10.26 09:00,562,0,98,660,0
연산터널→연산교차로,2023.10.26 09:00,282,349,41,672,0
교대→연산교차로,2023.10.26 10:00,296,0,452,748,0
부산시청→연산교차로,2023.10.26 10:00,550,367,233,1150,0
사직운동장→연산교차로,2023.10.26 10:00,209,542,76,827,0
신리→연산교차로,2023.10.26 10:00,465,253,55,773,0
안락→연산교차로,2023.10.26 10:00,530,0,147,677,0
연산터널→연산교차로,2023.10.26 10:00,275,319,42,636,0
교대→연산교차로,2023.10.26 11:00,281,0,405,686,0
부산시청→연산교차로,2023.10.26 11:00,566,378,277,1221,0
사직운동장→연산교차로,2023.10.26 11:00,171,575,85,831,0
신리→연산교차로,2023.10.26 11:00,451,271,48,770,0
안락→연산교차로,2023.10.26 11:00,511,0,167,678,0
연산터널→연산교차로,2023.10.26 11:00,252,277,40,569,0
교대→연산교차로,2023.10.26 12:00,298,0,376,674,0
부산시청→연산교차로,2023.10.26 12:00,562,341,224,1127,0
사직운동장→연산교차로,2023.10.26 12:00,181,539,88,808,0
신리→연산교차로,2023.10.26 12:00,429,218,54,701,0
안락→연산교차로,2023.10.26 12:00,452,0,145,597,0
연산터널→연산교차로,2023.10.26 12:00,245,259,36,540,0
교대→연산교차로,2023.10.26 13:00,353,0,405,758,0
부산시청→연산교차로,2023.10.26 13:00,558,425,265,1248,0
사직운동장→연산교차로,2023.10.26 13:00,201,571,94,866,0
신리→연산교차로,2023.10.26 13:00,426,252,56,734,0
안락→연산교차로,2023.10.26 13:00,443,0,125,568,0
연산터널→연산교차로,2023.10.26 13:00,239,275,35,549,0
교대→연산교차로,2023.10.26 14:00,305,0,442,747,0
부산시청→연산교차로,2023.10.26 14:00,586,443,271,1300,0
사직운동장→연산교차로,2023.10.26 14:00,189,589,86,864,0
신리→연산교차로,2023.10.26 14:00,449,268,50,767,0
안락→연산교차로,2023.10.26 14:00,413,0,120,533,0
연산터널→연산교차로,2023.10.26 14:00,223,291,40,554,0
교대→연산교차로,2023.10.26 15:00,351,0,486,837,0
부산시청→연산교차로,2023.10.26 15:00,577,437,285,1299,0
사직운동장→연산교차로,2023.10.26 15:00,213,646,88,947,0
신리→연산교차로,2023.10.26 15:00,440,269,52,761,0
안락→연산교차로,2023.10.26 15:00,431,0,120,551,0
연산터널→연산교차로,2023.10.26 15:00,237,272,43,552,0
교대→연산교차로,2023.10.26 16:00,343,0,447,790,0
부산시청→연산교차로,2023.10.26 16:00,608,526,317,1451,0
사직운동장→연산교차로,2023.10.26 16:00,250,665,65,980,0
신리→연산교차로,2023.10.26 16:00,485,315,56,856,0
안락→연산교차로,2023.10.26 16:00,445,0,117,562,0
연산터널→연산교차로,2023.10.26 16:00,236,287,30,553,0
교대→연산교차로,2023.10.26 17:00,351,0,502,853,0
부산시청→연산교차로,2023.10.26 17:00,610,533,307,1450,0
사직운동장→연산교차로,2023.10.26 17:00,242,702,68,1012,0
신리→연산교차로,2023.10.26 17:00,507,302,50,859,0
안락→연산교차로,2023.10.26 17:00,455,0,81,536,0
연산터널→연산교차로,2023.10.26 17:00,231,284,32,547,0
교대→연산교차로,2023.10.26 18:00,358,0,550,908,0
부산시청→연산교차로,2023.10.26 18:00,612,555,342,1509,0
사직운동장→연산교차로,2023.10.26 18:00,232,655,58,945,0
신리→연산교차로,2023.10.26 18:00,488,249,39,776,0
안락→연산교차로,2023.10.26 18:00,447,0,81,528,0
연산터널→연산교차로,2023.10.26 18:00,209,278,45,532,0
교대→연산교차로,2023.10.26 19:00,329,0,389,718,0
부산시청→연산교차로,2023.10.26 19:00,537,395,262,1194,0
사직운동장→연산교차로,2023.10.26 19:00,205,572,72,849,0
신리→연산교차로,2023.10.26 19:00,363,194,47,604,0
안락→연산교차로,2023.10.26 19:00,417,0,107,524,0
연산터널→연산교차로,2023.10.26 19:00,221,284,43,548,0
교대→연산교차로,2023.10.26 20:00,312,0,323,635,0
부산시청→연산교차로,2023.10.26 20:00,502,353,227,1082,0
사직운동장→연산교차로,2023.10.26 20:00,167,532,68,767,0
신리→연산교차로,2023.10.26 20:00,295,191,37,523,0
안락→연산교차로,2023.10.26 20:00,393,0,106,499,0
연산터널→연산교차로,2023.10.26 20:00,216,285,57,558,0
교대→연산교차로,2023.10.26 21:00,274,0,313,587,0
부산시청→연산교차로,2023.10.26 21:00,519,318,193,1030,0
사직운동장→연산교차로,2023.10.26 21:00,160,423,85,668,0
신리→연산교차로,2023.10.26 21:00,296,178,35,509,0
안락→연산교차로,2023.10.26 21:00,382,0,114,496,0
연산터널→연산교차로,2023.10.26 21:00,215,238,56,509,0
교대→연산교차로,2023.10.26 22:00,249,0,231,480,0
부산시청→연산교차로,2023.10.26 22:00,386,268,179,833,0
사직운동장→연산교차로,2023.10.26 22:00,128,333,89,550,0
신리→연산교차로,2023.10.26 22:00,242,162,28,432,0
안락→연산교차로,2023.10.26 22:00,358,0,94,452,0
연산터널→연산교차로,2023.10.26 22:00,192,218,55,465,0
교대→연산교차로,2023.10.26 23:00,175,0,189,364,0
부산시청→연산교차로,2023.10.26 23:00,344,199,118,661,0
사직운동장→연산교차로,2023.10.26 23:00,92,280,46,418,0
신리→연산교차로,2023.10.26 23:00,195,121,20,336,0
안락→연산교차로,2023.10.26 23:00,241,0,80,321,0
연산터널→연산교차로,2023.10.26 23:00,169,200,59,428,0
교대→연산교차로,2023.10.27 00:00,131,0,193,324,0
부산시청→연산교차로,2023.10.27 00:00,263,164,99,526,0
사직운동장→연산교차로,2023.10.27 00:00,55,211,50,316,0
신리→연산교차로,2023.10.27 00:00,157,115,12,284,0
안락→연산교차로,2023.10.27 00:00,209,0,57,266,0
연산터널→연산교차로,2023.10.27 00:00,154,186,63,403,0
교대→연산교차로,2023.10.27 01:00,97,0,157,254,0
부산시청→연산교차로,2023.10.27 01:00,160,106,68,334,0
사직운동장→연산교차로,2023.10.27 01:00,48,171,21,240,0
신리→연산교차로,2023.10.27 01:00,100,74,13,187,0
안락→연산교차로,2023.10.27 01:00,138,0,28,166,0
연산터널→연산교차로,2023.10.27 01:00,84,106,38,228,0
교대→연산교차로,2023.10.27 02:00,77,0,101,178,0
부산시청→연산교차로,2023.10.27 02:00,156,82,56,294,0
사직운동장→연산교차로,2023.10.27 02:00,36,156,17,209,0
신리→연산교차로,2023.10.27 02:00,82,65,11,158,0
안락→연산교차로,2023.10.27 02:00,107,0,24,131,0
연산터널→연산교차로,2023.10.27 02:00,89,112,59,260,0
교대→연산교차로,2023.10.27 03:00,54,0,101,155,0
부산시청→연산교차로,2023.10.27 03:00,148,70,55,273,0
사직운동장→연산교차로,2023.10.27 03:00,21,132,9,162,0
신리→연산교차로,2023.10.27 03:00,65,27,7,99,0
안락→연산교차로,2023.10.27 03:00,110,0,27,137,0
연산터널→연산교차로,2023.10.27 03:00,77,114,40,231,0
교대→연산교차로,2023.10.27 04:00,39,0,97,136,0
부산시청→연산교차로,2023.10.27 04:00,174,74,54,302,0
사직운동장→연산교차로,2023.10.27 04:00,37,126,7,170,0
신리→연산교차로,2023.10.27 04:00,99,43,10,152,0
안락→연산교차로,2023.10.27 04:00,151,0,31,182,0
연산터널→연산교차로,2023.10.27 04:00,87,84,48,219,0
교대→연산교차로,2023.10.27 05:00,85,0,126,211,0
부산시청→연산교차로,2023.10.27 05:00,223,163,70,456,0
사직운동장→연산교차로,2023.10.27 05:00,53,167,6,226,0
신리→연산교차로,2023.10.27 05:00,213,95,14,322,0
안락→연산교차로,2023.10.27 05:00,303,0,60,363,0
연산터널→연산교차로,2023.10.27 05:00,122,134,25,281,0
교대→연산교차로,2023.10.27 06:00,158,0,234,392,0
부산시청→연산교차로,2023.10.27 06:00,327,280,116,723,0
사직운동장→연산교차로,2023.10.27 06:00,85,297,27,409,0
신리→연산교차로,2023.10.27 06:00,326,159,16,501,0
안락→연산교차로,2023.10.27 06:00,427,0,99,526,0
연산터널→연산교차로,2023.10.27 06:00,220,214,36,470,0
교대→연산교차로,2023.10.27 07:00,235,0,367,602,0
부산시청→연산교차로,2023.10.27 07:00,536,367,223,1126,0
사직운동장→연산교차로,2023.10.27 07:00,177,489,66,732,0
신리→연산교차로,2023.10.27 07:00,471,308,27,806,0
안락→연산교차로,2023.10.27 07:00,608,0,94,702,0
연산터널→연산교차로,2023.10.27 07:00,309,373,42,724,0
교대→연산교차로,2023.10.27 08:00,319,0,516,835,0
부산시청→연산교차로,2023.10.27 08:00,585,447,352,1384,0
사직운동장→연산교차로,2023.10.27 08:00,207,653,63,923,0
신리→연산교차로,2023.10.27 08:00,487,342,31,860,0
안락→연산교차로,2023.10.27 08:00,632,0,97,729,0
연산터널→연산교차로,2023.10.27 08:00,318,366,36,720,0
교대→연산교차로,2023.10.27 09:00,277,0,455,732,0
부산시청→연산교차로,2023.10.27 09:00,546,362,291,1199,0
사직운동장→연산교차로,2023.10.27 09:00,184,580,84,848,0
신리→연산교차로,2023.10.27 09:00,469,315,47,831,0
안락→연산교차로,2023.10.27 09:00,580,0,102,682,0
연산터널→연산교차로,2023.10.27 09:00,297,352,39,688,0
교대→연산교차로,2023.10.27 10:00,296,0,440,736,0
부산시청→연산교차로,2023.10.27 10:00,557,359,271,1187,0
사직운동장→연산교차로,2023.10.27 10:00,232,560,74,866,0
신리→연산교차로,2023.10.27 10:00,451,290,60,801,0
안락→연산교차로,2023.10.27 10:00,546,0,160,706,0
연산터널→연산교차로,2023.10.27 10:00,305,325,55,685,0
교대→연산교차로,2023.10.27 11:00,281,0,451,732,0
부산시청→연산교차로,2023.10.27 11:00,613,381,266,1260,0
사직운동장→연산교차로,2023.10.27 11:00,206,538,76,820,0
신리→연산교차로,2023.10.27 11:00,436,253,56,745,0
안락→연산교차로,2023.10.27 11:00,479,0,162,641,0
연산터널→연산교차로,2023.10.27 11:00,281,310,62,653,0
교대→연산교차로,2023.10.27 12:00,306,0,322,628,0
부산시청→연산교차로,2023.10.27 12:00,558,319,246,1123,0
사직운동장→연산교차로,2023.10.27 12:00,189,581,62,832,0
신리→연산교차로,2023.10.27 12:00,400,263,51,714,0
안락→연산교차로,2023.10.27 12:00,495,0,144,639,0
연산터널→연산교차로,2023.10.27 12:00,256,300,51,607,0
교대→연산교차로,2023.10.27 13:00,306,0,470,776,0
부산시청→연산교차로,2023.10.27 13:00,540,392,295,1227,0
사직운동장→연산교차로,2023.10.27 13:00,202,603,95,900,0
신리→연산교차로,2023.10.27 13:00,428,279,64,771,0
안락→연산교차로,2023.10.27 13:00,448,0,125,573,0
연산터널→연산교차로,2023.10.27 13:00,242,270,45,557,0
교대→연산교차로,2023.10.27 14:00,313,0,461,774,0
부산시청→연산교차로,2023.10.27 14:00,568,425,321,1314,0
사직운동장→연산교차로,2023.10.27 14:00,223,653,119,995,0
신리→연산교차로,2023.10.27 14:00,462,292,68,822,0
안락→연산교차로,2023.10.27 14:00,437,0,132,569,0
연산터널→연산교차로,2023.10.27 14:00,235,287,40,562,0
교대→연산교차로,2023.10.27 15:00,356,0,489,845,0
부산시청→연산교차로,2023.10.27 15:00,571,455,314,1340,0
사직운동장→연산교차로,2023.10.27 15:00,231,648,84,963,0
신리→연산교차로,2023.10.27 15:00,504,294,62,860,0
안락→연산교차로,2023.10.27 15:00,432,0,128,560,0
연산터널→연산교차로,2023.10.27 15:00,233,282,46,561,0
교대→연산교차로,2023.10.27 16:00,354,0,504,858,0
부산시청→연산교차로,2023.10.27 16:00,617,522,316,1455,0
사직운동장→연산교차로,2023.10.27 16:00,235,669,61,965,0
신리→연산교차로,2023.10.27 16:00,528,305,64,897,0
안락→연산교차로,2023.10.27 16:00,442,0,104,546,0
연산터널→연산교차로,2023.10.27 16:00,246,285,41,572,0
교대→연산교차로,2023.10.27 17:00,364,0,576,940,0
부산시청→연산교차로,2023.10.27 17:00,592,561,316,1469,0
사직운동장→연산교차로,2023.10.27 17:00,240,678,52,970,0
신리→연산교차로,2023.10.27 17:00,516,293,51,860,0
안락→연산교차로,2023.10.27 17:00,470,0,94,564,0
연산터널→연산교차로,2023.10.27 17:00,224,278,50,552,0
교대→연산교차로,2023.10.27 18:00,360,0,516,876,0
부산시청→연산교차로,2023.10.27 18:00,575,542,344,1461,0
사직운동장→연산교차로,2023.10.27 18:00,242,693,42,977,0
신리→연산교차로,2023.10.27 18:00,541,247,42,830,0
안락→연산교차로,2023.10.27 18:00,451,0,68,519,0
연산터널→연산교차로,2023.10.27 18:00,221,285,58,564,0
교대→연산교차로,2023.10.27 19:00,353,0,469,822,0
부산시청→연산교차로,2023.10.27 19:00,528,409,260,1197,0
사직운동장→연산교차로,2023.10.27 19:00,210,579,79,868,0
신리→연산교차로,2023.10.27 19:00,395,237,37,669,0
안락→연산교차로,2023.10.27 19:00,422,0,112,534,0
연산터널→연산교차로,2023.10.27 19:00,194,299,52,545,0
교대→연산교차로,2023.10.27 20:00,349,0,378,727,0
부산시청→연산교차로,2023.10.27 20:00,464,330,253,1047,0
사직운동장→연산교차로,2023.10.27 20:00,187,550,101,838,0
신리→연산교차로,2023.10.27 20:00,346,185,47,578,0
안락→연산교차로,2023.10.27 20:00,404,0,115,519,0
연산터널→연산교차로,2023.10.27 20:00,199,293,49,541,0
교대→연산교차로,2023.10.27 21:00,302,0,347,649,0
부산시청→연산교차로,2023.10.27 21:00,543,335,214,1092,0
사직운동장→연산교차로,2023.10.27 21:00,186,478,94,758,0
신리→연산교차로,2023.10.27 21:00,349,198,36,583,0
안락→연산교차로,2023.10.27 21:00,422,0,140,562,0
연산터널→연산교차로,2023.10.27 21:00,227,287,69,583,0
교대→연산교차로,2023.10.27 22:00,284,0,306,590,0
부산시청→연산교차로,2023.10.27 22:00,421,286,185,892,0
사직운동장→연산교차로,2023.10.27 22:00,159,381,93,633,0
신리→연산교차로,2023.10.27 22:00,274,180,25,479,0
안락→연산교차로,2023.10.27 22:00,385,0,114,499,0
연산터널→연산교차로,2023.10.27 22:00,220,269,68,557,0
교대→연산교차로,2023.10.27 23:00,240,0,267,507,0
부산시청→연산교차로,2023.10.27 23:00,382,242,137,761,0
사직운동장→연산교차로,2023.10.27 23:00,118,344,78,540,0
신리→연산교차로,2023.10.27 23:00,229,144,36,409,0
안락→연산교차로,2023.10.27 23:00,310,0,87,397,0
연산터널→연산교차로,2023.10.27 23:00,167,233,72,472,0
교대→연산교차로,2023.10.28 00:00,184,0,248,432,0
부산시청→연산교차로,2023.10.28 00:00,353,202,138,693,0
사직운동장→연산교차로,2023.10.28 00:00,93,288,40,421,0
신리→연산교차로,2023.10.28 00:00,216,140,29,385,0
안락→연산교차로,2023.10.28 00:00,254,0,95,349,0
연산터널→연산교차로,2023.10.28 00:00,160,219,59,438,0
교대→연산교차로,2023.10.28 01:00,140,0,244,384,0
부산시청→연산교차로,2023.10.28 01:00,230,149,78,457,0
사직운동장→연산교차로,2023.10.28 01:00,70,219,34,323,0
신리→연산교차로,2023.10.28 01:00,168,80,9,257,0
안락→연산교차로,2023.10.28 01:00,195,0,73,268,0
연산터널→연산교차로,2023.10.28 01:00,129,175,30,334,0
교대→연산교차로,2023.10.28 02:00,114,0,191,305,0
부산시청→연산교차로,2023.10.28 02:00,237,125,79,441,0
사직운동장→연산교차로,2023.10.28 02:00,55,169,26,250,0
신리→연산교차로,2023.10.28 02:00,109,84,11,204,0
안락→연산교차로,2023.10.28 02:00,199,0,47,246,0
연산터널→연산교차로,2023.10.28 02:00,114,160,44,318,0
교대→연산교차로,2023.10.28 03:00,85,0,186,271,0
부산시청→연산교차로,2023.10.28 03:00,192,105,72,369,0
사직운동장→연산교차로,2023.10.28 03:00,30,140,24,194,0
신리→연산교차로,2023.10.28 03:00,94,58,13,165,0
안락→연산교차로,2023.10.28 03:00,165,0,41,206,0
연산터널→연산교차로,2023.10.28 03:00,87,136,46,269,0
교대→연산교차로,2023.10.28 04:00,86,0,136,222,0
부산시청→연산교차로,2023.10.28 04:00,198,107,51,356,0
사직운동장→연산교차로,2023.10.28 04:00,35,132,9,176,0
신리→연산교차로,2023.10.28 04:00,100,63,5,168,0
안락→연산교차로,2023.10.28 04:00,175,0,29,204,0
연산터널→연산교차로,2023.10.28 04:00,81,111,20,212,0
교대→연산교차로,2023.10.28 05:00,113,0,129,242,0
부산시청→연산교차로,2023.10.28 05:00,217,168,75,460,0
사직운동장→연산교차로,2023.10.28 05:00,48,151,5,204,0
신리→연산교차로,2023.10.28 05:00,175,70,3,248,0
안락→연산교차로,2023.10.28 05:00,308,0,56,364,0
연산터널→연산교차로,2023.10.28 05:00,107,119,28,254,0
교대→연산교차로,2023.10.28 06:00,154,0,189,343,0
부산시청→연산교차로,2023.10.28 06:00,326,269,104,699,0
사직운동장→연산교차로,2023.10.28 06:00,93,257,30,380,0
신리→연산교차로,2023.10.28 06:00,271,135,18,424,0
안락→연산교차로,2023.10.28 06:00,368,0,81,449,0
연산터널→연산교차로,2023.10.28 06:00,180,152,28,360,0
교대→연산교차로,2023.10.28 07:00,183,0,180,363,0
부산시청→연산교차로,2023.10.28 07:00,416,269,167,852,0
사직운동장→연산교차로,2023.10.28 07:00,121,340,56,517,0
신리→연산교차로,2023.10.28 07:00,334,192,26,552,0
안락→연산교차로,2023.10.28 07:00,388,0,90,478,0
연산터널→연산교차로,2023.10.28 07:00,196,175,30,401,0
교대→연산교차로,2023.10.28 08:00,248,0,337,585,0
부산시청→연산교차로,2023.10.28 08:00,493,356,241,1090,0
사직운동장→연산교차로,2023.10.28 08:00,189,560,64,813,0
신리→연산교차로,2023.10.28 08:00,458,273,33,764,0
안락→연산교차로,2023.10.28 08:00,554,0,142,696,0
연산터널→연산교차로,2023.10.28 08:00,282,292,58,632,0
교대→연산교차로,2023.10.28 09:00,270,0,354,624,0
부산시청→연산교차로,2023.10.28 09:00,541,354,246,1141,0
사직운동장→연산교차로,2023.10.28 09:00,196,606,80,882,0
신리→연산교차로,2023.10.28 09:00,461,310,43,814,0
안락→연산교차로,2023.10.28 09:00,583,0,150,733,0
연산터널→연산교차로,2023.10.28 09:00,301,337,59,697,0
교대→연산교차로,2023.10.28 10:00,289,0,418,707,0
부산시청→연산교차로,2023.10.28 10:00,546,388,259,1193,0
사직운동장→연산교차로,2023.10.28 10:00,217,597,51,865,0
신리→연산교차로,2023.10.28 10:00,512,310,58,880,0
안락→연산교차로,2023.10.28 10:00,537,0,141,678,0
연산터널→연산교차로,2023.10.28 10:00,307,327,58,692,0
교대→연산교차로,2023.10.28 11:00,304,0,466,770,0
부산시청→연산교차로,2023.10.28 11:00,632,396,262,1290,0
사직운동장→연산교차로,2023.10.28 11:00,209,596,56,861,0
신리→연산교차로,2023.10.28 11:00,495,316,55,866,0
안락→연산교차로,2023.10.28 11:00,589,0,145,734,0
연산터널→연산교차로,2023.10.28 11:00,304,339,51,694,0
교대→연산교차로,2023.10.28 12:00,298,0,391,689,0
부산시청→연산교차로,2023.10.28 12:00,656,386,283,1325,0
사직운동장→연산교차로,2023.10.28 12:00,218,612,50,880,0
신리→연산교차로,2023.10.28 12:00,485,315,38,838,0
안락→연산교차로,2023.10.28 12:00,571,0,172,743,0
연산터널→연산교차로,2023.10.28 12:00,287,335,55,677,0
교대→연산교차로,2023.10.28 13:00,356,0,452,808,0
부산시청→연산교차로,2023.10.28 13:00,616,482,319,1417,0
사직운동장→연산교차로,2023.10.28 13:00,230,659,64,953,0
신리→연산교차로,2023.10.28 13:00,475,328,37,840,0
안락→연산교차로,2023.10.28 13:00,451,0,129,580,0
연산터널→연산교차로,2023.10.28 13:00,271,264,42,577,0
교대→연산교차로,2023.10.28 14:00,351,0,495,846,0
부산시청→연산교차로,2023.10.28 14:00,635,492,303,1430,0
사직운동장→연산교차로,2023.10.28 14:00,250,640,65,955,0
신리→연산교차로,2023.10.28 14:00,436,282,52,770,0
안락→연산교차로,2023.10.28 14:00,447,0,104,551,0
연산터널→연산교차로,2023.10.28 14:00,240,271,50,561,0
교대→연산교차로,2023.10.28 15:00,344,0,463,807,0
부산시청→연산교차로,2023.10.28 15:00,635,530,288,1453,0
사직운동장→연산교차로,2023.10.28 15:00,231,657,85,973,0
신리→연산교차로,2023.10.28 15:00,483,287,60,830,0
안락→연산교차로,2023.10.28 15:00,434,0,127,561,0
연산터널→연산교차로,2023.10.28 15:00,224,301,47,572,0
교대→연산교차로,2023.10.28 16:00,357,0,449,806,0
부산시청→연산교차로,2023.10.28 16:00,615,529,297,1441,0
사직운동장→연산교차로,2023.10.28 16:00,224,665,45,934,0
신리→연산교차로,2023.10.28 16:00,465,270,42,777,0
안락→연산교차로,2023.10.28 16:00,449,0,98,547,0
연산터널→연산교차로,2023.10.28 16:00,227,294,30,551,0
교대→연산교차로,2023.10.28 17:00,357,0,474,831,0
부산시청→연산교차로,2023.10.28 17:00,602,477,289,1368,0
사직운동장→연산교차로,2023.10.28 17:00,248,663,51,962,0
신리→연산교차로,2023.10.28 17:00,409,259,65,733,0
안락→연산교차로,2023.10.28 17:00,469,0,102,571,0
연산터널→연산교차로,2023.10.28 17:00,228,273,55,556,0
교대→연산교차로,2023.10.28 18:00,322,0,388,710,0
부산시청→연산교차로,2023.10.28 18:00,549,362,230,1141,0
사직운동장→연산교차로,2023.10.28 18:00,220,657,52,929,0
신리→연산교차로,2023.10.28 18:00,406,221,38,665,0
안락→연산교차로,2023.10.28 18:00,441,0,102,543,0
연산터널→연산교차로,2023.10.28 18:00,234,271,50,555,0
교대→연산교차로,2023.10.28 19:00,326,0,393,719,0
부산시청→연산교차로,2023.10.28 19:00,505,329,222,1056,0
사직운동장→연산교차로,2023.10.28 19:00,195,484,84,763,0
신리→연산교차로,2023.10.28 19:00,361,235,43,639,0
안락→연산교차로,2023.10.28 19:00,419,0,119,538,0
연산터널→연산교차로,2023.10.28 19:00,238,250,58,546,0
교대→연산교차로,2023.10.28 20:00,288,0,313,601,0
부산시청→연산교차로,2023.10.28 20:00,463,328,221,1012,0
사직운동장→연산교차로,2023.10.28 20:00,158,446,100,704,0
신리→연산교차로,2023.10.28 20:00,354,200,32,586,0
안락→연산교차로,2023.10.28 20:00,414,0,95,509,0
연산터널→연산교차로,2023.10.28 20:00,217,229,70,516,0
교대→연산교차로,2023.10.28 21:00,281,0,279,560,0
부산시청→연산교차로,2023.10.28 21:00,523,303,196,1022,0
사직운동장→연산교차로,2023.10.28 21:00,144,414,88,646,0
신리→연산교차로,2023.10.28 21:00,351,208,23,582,0
안락→연산교차로,2023.10.28 21:00,385,0,111,496,0
연산터널→연산교차로,2023.10.28 21:00,243,258,58,559,0
교대→연산교차로,2023.10.28 22:00,256,0,272,528,0
부산시청→연산교차로,2023.10.28 22:00,399,283,137,819,0
사직운동장→연산교차로,2023.10.28 22:00,133,382,78,593,0
신리→연산교차로,2023.10.28 22:00,302,163,23,488,0
안락→연산교차로,2023.10.28 22:00,343,0,96,439,0
연산터널→연산교차로,2023.10.28 22:00,208,236,55,499,0
교대→연산교차로,2023.10.28 23:00,204,0,255,459,0
부산시청→연산교차로,2023.10.28 23:00,327,205,156,688,0
사직운동장→연산교차로,2023.10.28 23:00,93,333,75,501,0
신리→연산교차로,2023.10.28 23:00,231,152,25,408,0
안락→연산교차로,2023.10.28 23:00,276,0,85,361,0
연산터널→연산교차로,2023.10.28 23:00,163,225,60,448,0
교대→연산교차로,2023.10.29 00:00,165,0,226,391,1
부산시청→연산교차로,2023.10.29 00:00,323,190,130,643,1
사직운동장→연산교차로,2023.10.29 00:00,78,237,46,361,1
신리→연산교차로,2023.10.29 00:00,229,121,21,371,1
안락→연산교차로,2023.10.29 00:00,245,0,72,317,1
연산터널→연산교차로,2023.10.29 00:00,134,198,50,382,1
교대→연산교차로,2023.10.29 01:00,132,0,239,371,1
부산시청→연산교차로,2023.10.29 01:00,269,168,89,526,1
사직운동장→연산교차로,2023.10.29 01:00,61,211,40,312,1
신리→연산교차로,2023.10.29 01:00,166,104,14,284,1
안락→연산교차로,2023.10.29 01:00,232,0,62,294,1
연산터널→연산교차로,2023.10.29 01:00,123,174,43,340,1
교대→연산교차로,2023.10.29 02:00,98,0,201,299,1
부산시청→연산교차로,2023.10.29 02:00,211,147,98,456,1
사직운동장→연산교차로,2023.10.29 02:00,59,190,17,266,1
신리→연산교차로,2023.10.29 02:00,144,84,13,241,1
안락→연산교차로,2023.10.29 02:00,196,0,50,246,1
연산터널→연산교차로,2023.10.29 02:00,116,139,40,295,1
교대→연산교차로,2023.10.29 03:00,87,0,171,258,1
부산시청→연산교차로,2023.10.29 03:00,205,110,64,379,1
사직운동장→연산교차로,2023.10.29 03:00,45,154,14,213,1
신리→연산교차로,2023.10.29 03:00,93,58,9,160,1
안락→연산교차로,2023.10.29 03:00,150,0,43,193,1
연산터널→연산교차로,2023.10.29 03:00,85,138,35,258,1
교대→연산교차로,2023.10.29 04:00,77,0,125,202,1
부산시청→연산교차로,2023.10.29 04:00,176,89,63,328,1
사직운동장→연산교차로,2023.10.29 04:00,32,93,6,131,1
신리→연산교차로,2023.10.29 04:00,107,34,4,145,1
안락→연산교차로,2023.10.29 04:00,123,0,33,156,1
연산터널→연산교차로,2023.10.29 04:00,67,115,24,206,1
교대→연산교차로,2023.10.29 05:00,67,0,106,173,1
부산시청→연산교차로,2023.10.29 05:00,168,111,53,332,1
사직운동장→연산교차로,2023.10.29 05:00,31,129,5,165,1
신리→연산교차로,2023.10.29 05:00,127,47,6,180,1
안락→연산교차로,2023.10.29 05:00,183,0,39,222,1
연산터널→연산교차로,2023.10.29 05:00,70,100,21,191,1
교대→연산교차로,2023.10.29 06:00,95,0,138,233,1
부산시청→연산교차로,2023.10.29 06:00,195,186,61,442,1
사직운동장→연산교차로,2023.10.29 06:00,41,163,38,242,1
신리→연산교차로,2023.10.29 06:00,193,81,12,286,1
안락→연산교차로,2023.10.29 06:00,229,0,45,274,1
연산터널→연산교차로,2023.10.29 06:00,130,124,29,283,1
교대→연산교차로,2023.10.29 07:00,134,0,158,292,1
부산시청→연산교차로,2023.10.29 07:00,239,197,108,544,1
사직운동장→연산교차로,2023.10.29 07:00,70,206,37,313,1
신리→연산교차로,2023.10.29 07:00,229,94,16,339,1
안락→연산교차로,2023.10.29 07:00,251,0,67,318,1
연산터널→연산교차로,2023.10.29 07:00,137,140,23,300,1
교대→연산교차로,2023.10.29 08:00,191,0,181,372,1
부산시청→연산교차로,2023.10.29 08:00,301,243,123,667,1
사직운동장→연산교차로,2023.10.29 08:00,108,316,47,471,1
신리→연산교차로,2023.10.29 08:00,280,144,23,447,1
안락→연산교차로,2023.10.29 08:00,340,0,73,413,1
연산터널→연산교차로,2023.10.29 08:00,201,169,27,397,1
교대→연산교차로,2023.10.29 09:00,217,0,240,457,1
부산시청→연산교차로,2023.10.29 09:00,398,311,135,844,1
사직운동장→연산교차로,2023.10.29 09:00,125,388,43,556,1
신리→연산교차로,2023.10.29 09:00,382,212,17,611,1
안락→연산교차로,2023.10.29 09:00,446,0,113,559,1
연산터널→연산교차로,2023.10.29 09:00,282,237,31,550,1
교대→연산교차로,2023.10.29 10:00,261,0,281,542,1
부산시청→연산교차로,2023.10.29 10:00,477,321,177,975,1
사직운동장→연산교차로,2023.10.29 10:00,166,503,60,729,1
신리→연산교차로,2023.10.29 10:00,419,228,24,671,1
안락→연산교차로,2023.10.29 10:00,485,0,118,603,1
연산터널→연산교차로,2023.10.29 10:00,280,225,26,531,1
교대→연산교차로,2023.10.29 11:00,256,0,295,551,1
부산시청→연산교차로,2023.10.29 11:00,539,356,180,1075,1
사직운동장→연산교차로,2023.10.29 11:00,211,525,63,799,1
신리→연산교차로,2023.10.29 11:00,473,225,26,724,1
안락→연산교차로,2023.10.29 11:00,533,0,141,674,1
연산터널→연산교차로,2023.10.29 11:00,295,239,39,573,1
교대→연산교차로,2023.10.29 12:00,261,0,327,588,1
부산시청→연산교차로,2023.10.29 12:00,534,349,194,1077,1
사직운동장→연산교차로,2023.10.29 12:00,174,548,68,790,1
신리→연산교차로,2023.10.29 12:00,480,248,16,744,1
안락→연산교차로,2023.10.29 12:00,503,0,149,652,1
연산터널→연산교차로,2023.10.29 12:00,267,275,37,579,1
교대→연산교차로,2023.10.29 13:00,306,0,325,631,1
부산시청→연산교차로,2023.10.29 13:00,562,366,214,1142,1
사직운동장→연산교차로,2023.10.29 13:00,181,579,56,816,1
신리→연산교차로,2023.10.29 13:00,429,273,37,739,1
안락→연산교차로,2023.10.29 13:00,521,0,159,680,1
연산터널→연산교차로,2023.10.29 13:00,266,284,38,588,1
교대→연산교차로,2023.10.29 14:00,283,0,312,595,1
부산시청→연산교차로,2023.10.29 14:00,548,362,218,1128,1
사직운동장→연산교차로,2023.10.29 14:00,196,574,63,833,1
신리→연산교차로,2023.10.29 14:00,432,262,49,743,1
안락→연산교차로,2023.10.29 14:00,557,0,166,723,1
연산터널→연산교차로,2023.10.29 14:00,275,287,40,602,1
교대→연산교차로,2023.10.29 15:00,300,0,327,627,1
부산시청→연산교차로,2023.10.29 15:00,531,348,226,1105,1
사직운동장→연산교차로,2023.10.29 15:00,248,561,64,873,1
신리→연산교차로,2023.10.29 15:00,415,230,19,664,1
안락→연산교차로,2023.10.29 15:00,534,0,120,654,1
연산터널→연산교차로,2023.10.29 15:00,247,252,42,541,1
교대→연산교차로,2023.10.29 16:00,303,0,342,645,1
부산시청→연산교차로,2023.10.29 16:00,579,375,244,1198,1
사직운동장→연산교차로,2023.10.29 16:00,218,584,59,861,1
신리→연산교차로,2023.10.29 16:00,402,194,39,635,1
안락→연산교차로,2023.10.29 16:00,554,0,131,685,1
연산터널→연산교차로,2023.10.29 16:00,242,310,37,589,1
교대→연산교차로,2023.10.29 17:00,311,0,317,628,1
부산시청→연산교차로,2023.10.29 17:00,565,367,229,1161,1
사직운동장→연산교차로,2023.10.29 17:00,227,578,56,861,1
신리→연산교차로,2023.10.29 17:00,397,229,36,662,1
안락→연산교차로,2023.10.29 17:00,531,0,130,661,1
연산터널→연산교차로,2023.10.29 17:00,229,249,46,524,1
교대→연산교차로,2023.10.29 18:00,292,0,310,602,1
부산시청→연산교차로,2023.10.29 18:00,501,351,198,1050,1
사직운동장→연산교차로,2023.10.29 18:00,228,539,57,824,1
신리→연산교차로,2023.10.29 18:00,334,194,35,563,1
안락→연산교차로,2023.10.29 18:00,498,0,116,614,1
연산터널→연산교차로,2023.10.29 18:00,223,207,44,474,1
교대→연산교차로,2023.10.29 19:00,287,0,287,574,1
부산시청→연산교차로,2023.10.29 19:00,433,299,195,927,1
사직운동장→연산교차로,2023.10.29 19:00,193,427,63,683,1
신리→연산교차로,2023.10.29 19:00,305,161,33,499,1
안락→연산교차로,2023.10.29 19:00,468,0,140,608,1
연산터널→연산교차로,2023.10.29 19:00,219,226,50,495,1
교대→연산교차로,2023.10.29 20:00,272,0,296,568,1
부산시청→연산교차로,2023.10.29 20:00,402,293,184,879,1
사직운동장→연산교차로,2023.10.29 20:00,146,377,55,578,1
신리→연산교차로,2023.10.29 20:00,315,165,24,504,1
안락→연산교차로,2023.10.29 20:00,377,0,99,476,1
연산터널→연산교차로,2023.10.29 20:00,188,206,41,435,1
교대→연산교차로,2023.10.29 21:00,214,0,215,429,1
부산시청→연산교차로,2023.10.29 21:00,402,261,137,800,1
사직운동장→연산교차로,2023.10.29 21:00,134,342,40,516,1
신리→연산교차로,2023.10.29 21:00,309,166,29,504,1
안락→연산교차로,2023.10.29 21:00,322,0,83,405,1
연산터널→연산교차로,2023.10.29 21:00,166,193,44,403,1
교대→연산교차로,2023.10.29 22:00,200,0,202,402,1
부산시청→연산교차로,2023.10.29 22:00,337,201,98,636,1
사직운동장→연산교차로,2023.10.29 22:00,80,278,51,409,1
신리→연산교차로,2023.10.29 22:00,218,121,20,359,1
안락→연산교차로,2023.10.29 22:00,292,0,80,372,1
연산터널→연산교차로,2023.10.29 22:00,142,185,46,373,1
교대→연산교차로,2023.10.29 23:00,130,0,143,273,1
부산시청→연산교차로,2023.10.29 23:00,223,130,95,448,1
사직운동장→연산교차로,2023.10.29 23:00,62,218,40,320,1
신리→연산교차로,2023.10.29 23:00,174,94,21,289,1
안락→연산교차로,2023.10.29 23:00,183,0,47,230,1
연산터널→연산교차로,2023.10.29 23:00,121,155,63,339,1
교대→연산교차로,2023.10.30 00:00,110,0,146,256,0
부산시청→연산교차로,2023.10.30 00:00,204,128,77,409,0
사직운동장→연산교차로,2023.10.30 00:00,45,156,32,233,0
신리→연산교차로,2023.10.30 00:00,131,61,18,210,0
안락→연산교차로,2023.10.30 00:00,156,0,51,207,0
연산터널→연산교차로,2023.10.30 00:00,87,132,50,269,0
교대→연산교차로,2023.10.30 01:00,77,0,118,195,0
부산시청→연산교차로,2023.10.30 01:00,145,89,54,288,0
사직운동장→연산교차로,2023.10.30 01:00,33,123,10,166,0
신리→연산교차로,2023.10.30 01:00,78,48,21,147,0
안락→연산교차로,2023.10.30 01:00,101,0,28,129,0
연산터널→연산교차로,2023.10.30 01:00,73,97,46,216,0
교대→연산교차로,2023.10.30 02:00,49,0,100,149,0
부산시청→연산교차로,2023.10.30 02:00,122,71,42,235,0
사직운동장→연산교차로,2023.10.30 02:00,22,90,7,119,0
신리→연산교차로,2023.10.30 02:00,66,34,11,111,0
안락→연산교차로,2023.10.30 02:00,95,0,17,112,0
연산터널→연산교차로,2023.10.30 02:00,54,75,28,157,0
교대→연산교차로,2023.10.30 03:00,46,0,62,108,0
부산시청→연산교차로,2023.10.30 03:00,125,60,44,229,0
사직운동장→연산교차로,2023.10.30 03:00,22,95,4,121,0
신리→연산교차로,2023.10.30 03:00,64,34,7,105,0
안락→연산교차로,2023.10.30 03:00,107,0,18,125,0
연산터널→연산교차로,2023.10.30 03:00,45,84,37,166,0
교대→연산교차로,2023.10.30 04:00,45,0,51,96,0
부산시청→연산교차로,2023.10.30 04:00,152,63,40,255,0
사직운동장→연산교차로,2023.10.30 04:00,28,85,3,116,0
신리→연산교차로,2023.10.30 04:00,97,51,5,153,0
안락→연산교차로,2023.10.30 04:00,140,0,22,162,0
연산터널→연산교차로,2023.10.30 04:00,64,75,21,160,0
교대→연산교차로,2023.10.30 05:00,88,0,110,198,0
부산시청→연산교차로,2023.10.30 05:00,214,180,89,483,0
사직운동장→연산교차로,2023.10.30 05:00,53,147,1,201,0
신리→연산교차로,2023.10.30 05:00,202,77,8,287,0
안락→연산교차로,2023.10.30 05:00,315,0,45,360,0
연산터널→연산교차로,2023.10.30 05:00,105,153,22,280,0
교대→연산교차로,2023.10.30 06:00,182,0,226,408,0
부산시청→연산교차로,2023.10.30 06:00,374,297,139,810,0
사직운동장→연산교차로,2023.10.30 06:00,84,286,27,397,0
신리→연산교차로,2023.10.30 06:00,340,169,18,527,0
안락→연산교차로,2023.10.30 06:00,453,0,91,544,0
연산터널→연산교차로,2023.10.30 06:00,207,232,41,480,0
교대→연산교차로,2023.10.30 07:00,245,0,399,644,0
부산시청→연산교차로,2023.10.30 07:00,581,409,239,1229,0
사직운동장→연산교차로,2023.10.30 07:00,180,516,78,774,0
신리→연산교차로,2023.10.30 07:00,475,336,18,829,0
안락→연산교차로,2023.10.30 07:00,634,0,84,718,0
연산터널→연산교차로,2023.10.30 07:00,294,369,35,698,0
교대→연산교차로,2023.10.30 08:00,320,0,502,822,0
부산시청→연산교차로,2023.10.30 08:00,618,452,320,1390,0
사직운동장→연산교차로,2023.10.30 08:00,215,668,65,948,0
신리→연산교차로,2023.10.30 08:00,522,350,26,898,0
안락→연산교차로,2023.10.30 08:00,616,0,99,715,0
연산터널→연산교차로,2023.10.30 08:00,314,381,31,726,0
교대→연산교차로,2023.10.30 09:00,295,0,474,769,0
부산시청→연산교차로,2023.10.30 09:00,556,385,281,1222,0
사직운동장→연산교차로,2023.10.30 09:00,173,593,116,882,0
신리→연산교차로,2023.10.30 09:00,480,335,46,861,0
안락→연산교차로,2023.10.30 09:00,582,0,109,691,0
연산터널→연산교차로,2023.10.30 09:00,309,353,44,706,0
교대→연산교차로,2023.10.30 10:00,279,0,448,727,0
부산시청→연산교차로,2023.10.30 10:00,558,386,281,1225,0
사직운동장→연산교차로,2023.10.30 10:00,197,567,81,845,0
신리→연산교차로,2023.10.30 10:00,468,289,54,811,0
안락→연산교차로,2023.10.30 10:00,526,0,155,681,0
연산터널→연산교차로,2023.10.30 10:00,312,324,61,697,0
교대→연산교차로,2023.10.30 11:00,301,0,418,719,0
부산시청→연산교차로,2023.10.30 11:00,586,379,255,1220,0
사직운동장→연산교차로,2023.10.30 11:00,213,581,75,869,0
신리→연산교차로,2023.10.30 11:00,458,260,42,760,0
안락→연산교차로,2023.10.30 11:00,476,0,165,641,0
연산터널→연산교차로,2023.10.30 11:00,278,305,49,632,0
교대→연산교차로,2023.10.30 12:00,281,0,328,609,0
부산시청→연산교차로,2023.10.30 12:00,524,344,220,1088,0
사직운동장→연산교차로,2023.10.30 12:00,201,521,83,805,0
신리→연산교차로,2023.10.30 12:00,404,247,45,696,0
안락→연산교차로,2023.10.30 12:00,457,0,166,623,0
연산터널→연산교차로,2023.10.30 12:00,249,292,44,585,0
교대→연산교차로,2023.10.30 13:00,296,0,394,690,0
부산시청→연산교차로,2023.10.30 13:00,559,423,252,1234,0
사직운동장→연산교차로,2023.10.30 13:00,205,582,93,880,0
신리→연산교차로,2023.10.30 13:00,412,276,51,739,0
안락→연산교차로,2023.10.30 13:00,421,0,141,562,0
연산터널→연산교차로,2023.10.30 13:00,267,240,37,544,0
교대→연산교차로,2023.10.30 14:00,351,0,481,832,0
부산시청→연산교차로,2023.10.30 14:00,568,470,288,1326,0
사직운동장→연산교차로,2023.10.30 14:00,202,655,97,954,0
신리→연산교차로,2023.10.30 14:00,468,252,57,777,0
안락→연산교차로,2023.10.30 14:00,434,0,129,563,0
연산터널→연산교차로,2023.10.30 14:00,236,276,39,551,0
교대→연산교차로,2023.10.30 15:00,341,0,495,836,0
부산시청→연산교차로,2023.10.30 15:00,585,482,313,1380,0
사직운동장→연산교차로,2023.10.30 15:00,227,616,98,941,0
신리→연산교차로,2023.10.30 15:00,461,301,58,820,0
안락→연산교차로,2023.10.30 15:00,424,0,142,566,0
연산터널→연산교차로,2023.10.30 15:00,237,286,37,560,0
교대→연산교차로,2023.10.30 16:00,358,0,503,861,0
부산시청→연산교차로,2023.10.30 16:00,614,522,297,1433,0
사직운동장→연산교차로,2023.10.30 16:00,222,673,81,976,0
신리→연산교차로,2023.10.30 16:00,496,286,58,840,0
안락→연산교차로,2023.10.30 16:00,427,0,135,562,0
연산터널→연산교차로,2023.10.30 16:00,240,290,36,566,0
교대→연산교차로,2023.10.30 17:00,354,0,536,890,0
부산시청→연산교차로,2023.10.30 17:00,620,551,325,1496,0
사직운동장→연산교차로,2023.10.30 17:00,247,700,56,1003,0
신리→연산교차로,2023.10.30 17:00,513,283,58,854,0
안락→연산교차로,2023.10.30 17:00,441,0,123,564,0
연산터널→연산교차로,2023.10.30 17:00,224,277,28,529,0
교대→연산교차로,2023.10.30 18:00,358,0,534,892,0
부산시청→연산교차로,2023.10.30 18:00,584,544,309,1437,0
사직운동장→연산교차로,2023.10.30 18:00,252,663,54,969,0
신리→연산교차로,2023.10.30 18:00,471,255,45,771,0
안락→연산교차로,2023.10.30 18:00,447,0,105,552,0
연산터널→연산교차로,2023.10.30 18:00,223,276,46,545,0
교대→연산교차로,2023.10.30 19:00,316,0,404,720,0
부산시청→연산교차로,2023.10.30 19:00,529,405,278,1212,0
사직운동장→연산교차로,2023.10.30 19:00,171,551,70,792,0
신리→연산교차로,2023.10.30 19:00,317,180,44,541,0
안락→연산교차로,2023.10.30 19:00,369,0,108,477,0
연산터널→연산교차로,2023.10.30 19:00,209,255,56,520,0
교대→연산교차로,2023.10.30 20:00,289,0,343,632,0
부산시청→연산교차로,2023.10.30 20:00,470,352,212,1034,0
사직운동장→연산교차로,2023.10.30 20:00,149,453,94,696,0
신리→연산교차로,2023.10.30 20:00,289,190,36,515,0
안락→연산교차로,2023.10.30 20:00,398,0,108,506,0
연산터널→연산교차로,2023.10.30 20:00,213,270,63,546,0
교대→연산교차로,2023.10.30 21:00,264,0,330,594,0
부산시청→연산교차로,2023.10.30 21:00,452,267,194,913,0
사직운동장→연산교차로,2023.10.30 21:00,146,410,81,637,0
신리→연산교차로,2023.10.30 21:00,253,164,37,454,0
안락→연산교차로,2023.10.30 21:00,386,0,113,499,0
연산터널→연산교차로,2023.10.30 21:00,213,265,62,540,0
교대→연산교차로,2023.10.30 22:00,214,0,227,441,0
부산시청→연산교차로,2023.10.30 22:00,381,237,152,770,0
사직운동장→연산교차로,2023.10.30 22:00,143,327,66,536,0
신리→연산교차로,2023.10.30 22:00,210,137,28,375,0
안락→연산교차로,2023.10.30 22:00,351,0,99,450,0
연산터널→연산교차로,2023.10.30 22:00,181,234,52,467,0
교대→연산교차로,2023.10.30 23:00,169,0,189,358,0
부산시청→연산교차로,2023.10.30 23:00,326,188,110,624,0
사직운동장→연산교차로,2023.10.30 23:00,100,258,56,414,0
신리→연산교차로,2023.10.30 23:00,167,94,26,287,0
안락→연산교차로,2023.10.30 23:00,252,0,64,316,0
연산터널→연산교차로,2023.10.30 23:00,146,190,74,410,0
교대→연산교차로,2023.10.31 00:00,120,0,184,304,0
부산시청→연산교차로,2023.10.31 00:00,233,148,95,476,0
사직운동장→연산교차로,2023.10.31 00:00,53,197,27,277,0
신리→연산교차로,2023.10.31 00:00,122,90,22,234,0
안락→연산교차로,2023.10.31 00:00,186,0,50,236,0
연산터널→연산교차로,2023.10.31 00:00,108,154,55,317,0
교대→연산교차로,2023.10.31 01:00,104,0,139,243,0
부산시청→연산교차로,2023.10.31 01:00,172,94,72,338,0
사직운동장→연산교차로,2023.10.31 01:00,35,142,24,201,0
신리→연산교차로,2023.10.31 01:00,117,56,19,192,0
안락→연산교차로,2023.10.31 01:00,151,0,45,196,0
연산터널→연산교차로,2023.10.31 01:00,99,117,62,278,0
교대→연산교차로,2023.10.31 02:00,58,0,102,160,0
부산시청→연산교차로,2023.10.31 02:00,140,69,56,265,0
사직운동장→연산교차로,2023.10.31 02:00,28,125,8,161,0
신리→연산교차로,2023.10.31 02:00,61,30,7,98,0
안락→연산교차로,2023.10.31 02:00,94,0,29,123,0
연산터널→연산교차로,2023.10.31 02:00,79,100,33,212,0
교대→연산교차로,2023.10.31 03:00,55,0,103,158,0
부산시청→연산교차로,2023.10.31 03:00,138,63,39,240,0
사직운동장→연산교차로,2023.10.31 03:00,27,146,6,179,0
신리→연산교차로,2023.10.31 03:00,59,44,12,115,0
안락→연산교차로,2023.10.31 03:00,101,0,19,120,0
연산터널→연산교차로,2023.10.31 03:00,77,89,38,204,0
교대→연산교차로,2023.10.31 04:00,46,0,83,129,0
부산시청→연산교차로,2023.10.31 04:00,154,86,46,286,0
사직운동장→연산교차로,2023.10.31 04:00,34,111,7,152,0
신리→연산교차로,2023.10.31 04:00,89,42,7,138,0
안락→연산교차로,2023.10.31 04:00,158,0,27,185,0
연산터널→연산교차로,2023.10.31 04:00,72,80,37,189,0
교대→연산교차로,2023.10.31 05:00,86,0,112,198,0
부산시청→연산교차로,2023.10.31 05:00,208,186,70,464,0
사직운동장→연산교차로,2023.10.31 05:00,42,167,5,214,0
신리→연산교차로,2023.10.31 05:00,203,85,15,303,0
안락→연산교차로,2023.10.31 05:00,302,0,59,361,0
연산터널→연산교차로,2023.10.31 05:00,130,137,27,294,0
교대→연산교차로,2023.10.31 06:00,184,0,223,407,0
부산시청→연산교차로,2023.10.31 06:00,372,290,122,784,0
사직운동장→연산교차로,2023.10.31 06:00,76,302,34,412,0
신리→연산교차로,2023.10.31 06:00,350,162,24,536,0
안락→연산교차로,2023.10.31 06:00,477,0,102,579,0
연산터널→연산교차로,2023.10.31 06:00,206,198,43,447,0
교대→연산교차로,2023.10.31 07:00,254,0,394,648,0
부산시청→연산교차로,2023.10.31 07:00,526,397,219,1142,0
사직운동장→연산교차로,2023.10.31 07:00,172,518,79,769,0
신리→연산교차로,2023.10.31 07:00,483,302,24,809,0
안락→연산교차로,2023.10.31 07:00,601,0,93,694,0
연산터널→연산교차로,2023.10.31 07:00,300,380,38,718,0
교대→연산교차로,2023.10.31 08:00,320,0,518,838,0
부산시청→연산교차로,2023.10.31 08:00,613,442,313,1368,0
사직운동장→연산교차로,2023.10.31 08:00,191,663,71,925,0
신리→연산교차로,2023.10.31 08:00,514,354,21,889,0
안락→연산교차로,2023.10.31 08:00,618,0,100,718,0
연산터널→연산교차로,2023.10.31 08:00,337,370,28,735,0
교대→연산교차로,2023.10.31 09:00,260,0,497,757,0
부산시청→연산교차로,2023.10.31 09:00,539,365,272,1176,0
사직운동장→연산교차로,2023.10.31 09:00,184,569,79,832,0
신리→연산교차로,2023.10.31 09:00,489,322,40,851,0
안락→연산교차로,2023.10.31 09:00,570,0,95,665,0
연산터널→연산교차로,2023.10.31 09:00,273,369,44,686,0
교대→연산교차로,2023.10.31 10:00,253,0,448,701,0
부산시청→연산교차로,2023.10.31 10:00,547,347,274,1168,0
사직운동장→연산교차로,2023.10.31 10:00,194,563,50,807,0
신리→연산교차로,2023.10.31 10:00,479,260,60,799,0
안락→연산교차로,2023.10.31 10:00,528,0,119,647,0
연산터널→연산교차로,2023.10.31 10:00,296,321,48,665,0
교대→연산교차로,2023.10.31 11:00,279,0,416,695,0
부산시청→연산교차로,2023.10.31 11:00,534,324,250,1108,0
사직운동장→연산교차로,2023.10.31 11:00,179,565,86,830,0
신리→연산교차로,2023.10.31 11:00,413,268,49,730,0
안락→연산교차로,2023.10.31 11:00,517,0,168,685,0
연산터널→연산교차로,2023.10.31 11:00,271,273,43,587,0
교대→연산교차로,2023.10.31 12:00,278,0,334,612,0
부산시청→연산교차로,2023.10.31 12:00,568,343,250,1161,0
사직운동장→연산교차로,2023.10.31 12:00,186,555,68,809,0
신리→연산교차로,2023.10.31 12:00,383,219,56,658,0
안락→연산교차로,2023.10.31 12:00,464,0,156,620,0
연산터널→연산교차로,2023.10.31 12:00,248,299,41,588,0
교대→연산교차로,2023.10.31 13:00,303,0,412,715,0
부산시청→연산교차로,2023.10.31 13:00,544,428,281,1253,0
사직운동장→연산교차로,2023.10.31 13:00,209,581,97,887,0
신리→연산교차로,2023.10.31 13:00,454,266,47,767,0
안락→연산교차로,2023.10.31 13:00,430,0,139,569,0
연산터널→연산교차로,2023.10.31 13:00,247,256,33,536,0
교대→연산교차로,2023.10.31 14:00,327,0,512,839,0
부산시청→연산교차로,2023.10.31 14:00,589,460,317,1366,0
사직운동장→연산교차로,2023.10.31 14:00,226,574,84,884,0
신리→연산교차로,2023.10.31 14:00,437,251,58,746,0
안락→연산교차로,2023.10.31 14:00,422,0,136,558,0
연산터널→연산교차로,2023.10.31 14:00,219,272,58,549,0
교대→연산교차로,2023.10.31 15:00,347,0,451,798,0
부산시청→연산교차로,2023.10.31 15:00,607,443,281,1331,0
사직운동장→연산교차로,2023.10.31 15:00,226,611,83,920,0
신리→연산교차로,2023.10.31 15:00,435,289,52,776,0
안락→연산교차로,2023.10.31 15:00,441,0,112,553,0
연산터널→연산교차로,2023.10.31 15:00,257,303,34,594,0
교대→연산교차로,2023.10.31 16:00,354,0,429,783,0
부산시청→연산교차로,2023.10.31 16:00,643,503,293,1439,0
사직운동장→연산교차로,2023.10.31 16:00,231,627,72,930,0
신리→연산교차로,2023.10.31 16:00,491,294,53,838,0
안락→연산교차로,2023.10.31 16:00,448,0,126,574,0
연산터널→연산교차로,2023.10.31 16:00,219,284,45,548,0
교대→연산교차로,2023.10.31 17:00,346,0,534,880,0
부산시청→연산교차로,2023.10.31 17:00,609,564,298,1471,0
사직운동장→연산교차로,2023.10.31 17:00,244,665,56,965,0
신리→연산교차로,2023.10.31 17:00,531,271,42,844,0
안락→연산교차로,2023.10.31 17:00,443,0,114,557,0
연산터널→연산교차로,2023.10.31 17:00,237,259,50,546,0
교대→연산교차로,2023.10.31 18:00,357,0,521,878,0
부산시청→연산교차로,2023.10.31 18:00,566,587,339,1492,0
사직운동장→연산교차로,2023.10.31 18:00,245,663,43,951,0
신리→연산교차로,2023.10.31 18:00,490,270,49,809,0
안락→연산교차로,2023.10.31 18:00,453,0,89,542,0
연산터널→연산교차로,2023.10.31 18:00,208,280,51,539,0
교대→연산교차로,2023.10.31 19:00,343,0,413,756,0
부산시청→연산교차로,2023.10.31 19:00,537,392,271,1200,0
사직운동장→연산교차로,2023.10.31 19:00,194,526,74,794,0
신리→연산교차로,2023.10.31 19:00,353,221,37,611,0
안락→연산교차로,2023.10.31 19:00,406,0,103,509,0
연산터널→연산교차로,2023.10.31 19:00,228,261,52,541,0
교대→연산교차로,2023.10.31 20:00,297,0,339,636,0
부산시청→연산교차로,2023.10.31 20:00,474,344,243,1061,0
사직운동장→연산교차로,2023.10.31 20:00,188,481,87,756,0
신리→연산교차로,2023.10.31 20:00,319,178,35,532,0
안락→연산교차로,2023.10.31 20:00,392,0,108,500,0
연산터널→연산교차로,2023.10.31 20:00,213,268,55,536,0
교대→연산교차로,2023.10.31 21:00,263,0,303,566,0
부산시청→연산교차로,2023.10.31 21:00,464,295,197,956,0
사직운동장→연산교차로,2023.10.31 21:00,153,431,89,673,0
신리→연산교차로,2023.10.31 21:00,288,172,25,485,0
안락→연산교차로,2023.10.31 21:00,378,0,120,498,0
연산터널→연산교차로,2023.10.31 21:00,220,243,63,526,0
교대→연산교차로,2023.10.31 22:00,233,0,265,498,0
부산시청→연산교차로,2023.10.31 22:00,376,256,151,783,0
사직운동장→연산교차로,2023.10.31 22:00,130,319,72,521,0
신리→연산교차로,2023.10.31 22:00,239,154,30,423,0
안락→연산교차로,2023.10.31 22:00,352,0,107,459,0
연산터널→연산교차로,2023.10.31 22:00,192,211,56,459,0
교대→연산교차로,2023.10.31 23:00,192,0,191,383,0
부산시청→연산교차로,2023.10.31 23:00,309,182,119,610,0
사직운동장→연산교차로,2023.10.31 23:00,118,274,62,454,0
신리→연산교차로,2023.10.31 23:00,172,106,23,301,0
안락→연산교차로,2023.10.31 23:00,255,0,80,335,0
연산터널→연산교차로,2023.10.31 23:00,127,191,49,367,0